Transaldolase deficiency	source	native	name	p_value	significant	description	term_size	query_size	intersection_size	effective_domain_size	precision	recall	query	parents	intersections
0	GO:CC	GO:0098798	mitochondrial protein-containing complex	1.3004599572897897e-36	True	"""A protein complex that is part of a mitochondrion."" [GOC:dos]"	295	97	36	17376	0.3711340206185567	0.1220338983050847	query_1	['GO:0005739', 'GO:0032991']	['PPIF', 'SPG7', 'LYRM4', 'HSPA9', 'MCUB', 'DLAT', 'PDHA2', 'PDHX', 'PDHB', 'PMPCA', 'PHB2', 'SDHD', 'DBT', 'MCU', 'BCKDK', 'BCKDHB', 'PDHA1', 'VDAC1', 'AFG3L2', 'ISCU', 'PDK1', 'SDHB', 'NFS1', 'NDUFAB1', 'SDHA', 'MICU1', 'SMDT1', 'SDHC', 'DLD', 'PDK2', 'NDUFV3', 'MICU2', 'MFN1', 'PMPCB', 'PHB1', 'BCKDHA']
1	GO:CC	GO:0005759	mitochondrial matrix	9.010598960572883e-26	True	"""The gel-like material, with considerable fine structure, that lies in the matrix space, or lumen, of a mitochondrion. It contains the enzymes of the tricarboxylic acid cycle and, in some organisms, the enzymes concerned with fatty acid oxidation."" [GOC:as, ISBN:0198506732]"	462	97	33	17376	0.3402061855670103	0.0714285714285714	query_1	['GO:0005739', 'GO:0070013']	['PPIF', 'PDK4', 'GCSH', 'PPM1K', 'LYRM4', 'MAIP1', 'OTC', 'DLST', 'HSPA9', 'DLAT', 'PDHA2', 'PDHX', 'PDHB', 'PMPCA', 'MCAT', 'DBT', 'BCKDK', 'BCKDHB', 'PDHA1', 'HSPD1', 'PDK3', 'VDAC1', 'RAD51', 'ISCU', 'PDK1', 'NFS1', 'NDUFAB1', 'SMDT1', 'DLD', 'PDK2', 'PMPCB', 'OGDH', 'BCKDHA']
2	GO:CC	GO:1990204	oxidoreductase complex	2.249461713244081e-25	True	"""Any protein complex that possesses oxidoreductase activity."" [GOC:bhm, PMID:18982432]"	125	97	22	17376	0.2268041237113402	0.176	query_1	['GO:1902494']	['GCSH', 'DLST', 'DLAT', 'PDHA2', 'PDHX', 'PDHB', 'SDHD', 'DBT', 'BCKDK', 'BCKDHB', 'PDHA1', 'GPD1', 'PDK1', 'SDHB', 'NDUFAB1', 'SDHA', 'SDHC', 'DLD', 'PDK2', 'NDUFV3', 'OGDH', 'BCKDHA']
3	REAC	REAC:R-HSA-71406	Pyruvate metabolism and Citric Acid (TCA) cycle	1.1439504962907647e-23	True	Pyruvate metabolism and Citric Acid (TCA) cycle	53	97	17	17376	0.1752577319587628	0.320754716981132	query_1	['REAC:R-HSA-1428517']	['PDK4', 'DLST', 'DLAT', 'PDHA2', 'PDHX', 'PDHB', 'SDHD', 'PDHA1', 'PDK3', 'VDAC1', 'PDK1', 'SDHB', 'SDHA', 'SDHC', 'DLD', 'PDK2', 'OGDH']
4	REAC	REAC:R-HSA-8949664	Processing of SMDT1	3.726820456208632e-23	True	Processing of SMDT1	15	97	12	17376	0.1237113402061855	0.8	query_1	['REAC:R-HSA-8949215']	['SPG7', 'MAIP1', 'MCUB', 'PMPCA', 'PHB2', 'MCU', 'AFG3L2', 'MICU1', 'SMDT1', 'MICU2', 'PMPCB', 'PHB1']
5	REAC	REAC:R-HSA-8949215	Mitochondrial calcium ion transport	5.318682383145492e-23	True	Mitochondrial calcium ion transport	21	97	13	17376	0.134020618556701	0.6190476190476191	query_1	['REAC:R-HSA-382551']	['SPG7', 'MAIP1', 'MCUB', 'PMPCA', 'PHB2', 'MCU', 'VDAC1', 'AFG3L2', 'MICU1', 'SMDT1', 'MICU2', 'PMPCB', 'PHB1']
6	GO:CC	GO:0005739	mitochondrion	5.527958293360905e-23	True	"""A semiautonomous, self replicating organelle that occurs in varying numbers, shapes, and sizes in the cytoplasm of virtually all eukaryotic cells. It is notably the site of tissue respiration."" [GOC:giardia, ISBN:0198506732]"	1577	97	48	17376	0.4948453608247423	0.030437539632213	query_1	['GO:0005737', 'GO:0043231']	['PPIF', 'PDK4', 'GCSH', 'SPG7', 'PPM1K', 'LYRM4', 'MAIP1', 'OTC', 'DLST', 'HSPA9', 'MCUB', 'DLAT', 'PDHA2', 'PDHX', 'PDHB', 'PMPCA', 'PHB2', 'MCAT', 'SDHD', 'DBT', 'MCU', 'BCKDK', 'BCKDHB', 'PDHA1', 'HSPD1', 'PDK3', 'VDAC1', 'RAD51', 'AFG3L2', 'ISCU', 'PDK1', 'SDHB', 'NFS1', 'NDUFAB1', 'SDHA', 'MICU1', 'SMDT1', 'SDHC', 'DLD', 'PDK2', 'NDUFV3', 'MICU2', 'MFN1', 'ABHD6', 'PMPCB', 'OGDH', 'PHB1', 'BCKDHA']
7	REAC	REAC:R-HSA-389661	Glyoxylate metabolism and glycine degradation	1.2832539312911471e-20	True	Glyoxylate metabolism and glycine degradation	29	97	13	17376	0.134020618556701	0.4482758620689655	query_1	['REAC:R-HSA-71291']	['GCSH', 'DLST', 'DLAT', 'PDHA2', 'PDHX', 'PDHB', 'DBT', 'BCKDHB', 'PDHA1', 'NDUFAB1', 'DLD', 'OGDH', 'BCKDHA']
8	GO:BP	GO:0006086	acetyl-CoA biosynthetic process from pyruvate	4.73867157726767e-19	True	"""The chemical reactions and pathways resulting in the formation of acetyl-CoA from pyruvate."" [GOC:dph, GOC:go_curators, GOC:tb]"	11	97	10	17376	0.1030927835051546	0.9090909090909092	query_1	['GO:0006085', 'GO:0006090']	['PDK4', 'DLAT', 'PDHA2', 'PDHX', 'PDHB', 'PDHA1', 'PDK3', 'PDK1', 'DLD', 'PDK2']
9	GO:CC	GO:0031974	membrane-enclosed lumen	2.4204421884819866e-18	True	"""The enclosed volume within a sealed membrane or between two sealed membranes. Encompasses the volume enclosed by the membranes of a particular organelle, e.g. endoplasmic reticulum lumen, or the space between the two lipid bilayers of a double membrane surrounding an organelle, e.g. nuclear envelope lumen."" [GOC:add, GOC:mah]"	5406	97	74	17376	0.7628865979381443	0.0136884942656307	query_1	['GO:0110165']	['PPIF', 'RBBP8', 'UBE2I', 'PDK4', 'GCSH', 'PPM1K', 'LYRM4', 'MAIP1', 'CDK5RAP3', 'NBN', 'OTC', 'ATF7IP', 'DLST', 'HSPA9', 'MCUB', 'TP53BP1', 'RAD50', 'ZNF45', 'ZNF350', 'XRCC6', 'PAXIP1', 'DLAT', 'PDHA2', 'PDHX', 'SETDB2', 'PDHB', 'H2AX', 'DDRGK1', 'MDC1', 'PMPCA', 'PHB2', 'MCAT', 'DBT', 'BRCA2', 'SIL1', 'SETDB1', 'BCKDK', 'BCKDHB', 'PDHA1', 'SUMO1', 'HSPD1', 'RPA1', 'PDK3', 'ARL14EP', 'FLYWCH1', 'BLM', 'PIAS1', 'MRE11', 'VDAC1', 'RAD51', 'HDAC6', 'ISCU', 'PDK1', 'SDHB', 'FAF2', 'NFS1', 'CBX5', 'NDUFAB1', 'BRCA1', 'SDHA', 'MICU1', 'STAT5A', 'SMDT1', 'DLD', 'PDK2', 'MBD1', 'TRIM28', 'BARD1', 'MICU2', 'PMPCB', 'OGDH', 'PHB1', 'STAT5B', 'BCKDHA']
10	GO:CC	GO:0043233	organelle lumen	2.4204421884819866e-18	True	"""The internal volume enclosed by the membranes of a particular organelle; includes the volume enclosed by a single organelle membrane, e.g. endoplasmic reticulum lumen, or the volume enclosed by the innermost of the two lipid bilayers of an organelle envelope, e.g. nuclear lumen."" [GOC:jl, GOC:mah]"	5406	97	74	17376	0.7628865979381443	0.0136884942656307	query_1	['GO:0031974', 'GO:0043226']	['PPIF', 'RBBP8', 'UBE2I', 'PDK4', 'GCSH', 'PPM1K', 'LYRM4', 'MAIP1', 'CDK5RAP3', 'NBN', 'OTC', 'ATF7IP', 'DLST', 'HSPA9', 'MCUB', 'TP53BP1', 'RAD50', 'ZNF45', 'ZNF350', 'XRCC6', 'PAXIP1', 'DLAT', 'PDHA2', 'PDHX', 'SETDB2', 'PDHB', 'H2AX', 'DDRGK1', 'MDC1', 'PMPCA', 'PHB2', 'MCAT', 'DBT', 'BRCA2', 'SIL1', 'SETDB1', 'BCKDK', 'BCKDHB', 'PDHA1', 'SUMO1', 'HSPD1', 'RPA1', 'PDK3', 'ARL14EP', 'FLYWCH1', 'BLM', 'PIAS1', 'MRE11', 'VDAC1', 'RAD51', 'HDAC6', 'ISCU', 'PDK1', 'SDHB', 'FAF2', 'NFS1', 'CBX5', 'NDUFAB1', 'BRCA1', 'SDHA', 'MICU1', 'STAT5A', 'SMDT1', 'DLD', 'PDK2', 'MBD1', 'TRIM28', 'BARD1', 'MICU2', 'PMPCB', 'OGDH', 'PHB1', 'STAT5B', 'BCKDHA']
11	GO:CC	GO:0070013	intracellular organelle lumen	2.4204421884819866e-18	True	"""An organelle lumen that is part of an intracellular organelle."" [GOC:mah]"	5406	97	74	17376	0.7628865979381443	0.0136884942656307	query_1	['GO:0043229', 'GO:0043233']	['PPIF', 'RBBP8', 'UBE2I', 'PDK4', 'GCSH', 'PPM1K', 'LYRM4', 'MAIP1', 'CDK5RAP3', 'NBN', 'OTC', 'ATF7IP', 'DLST', 'HSPA9', 'MCUB', 'TP53BP1', 'RAD50', 'ZNF45', 'ZNF350', 'XRCC6', 'PAXIP1', 'DLAT', 'PDHA2', 'PDHX', 'SETDB2', 'PDHB', 'H2AX', 'DDRGK1', 'MDC1', 'PMPCA', 'PHB2', 'MCAT', 'DBT', 'BRCA2', 'SIL1', 'SETDB1', 'BCKDK', 'BCKDHB', 'PDHA1', 'SUMO1', 'HSPD1', 'RPA1', 'PDK3', 'ARL14EP', 'FLYWCH1', 'BLM', 'PIAS1', 'MRE11', 'VDAC1', 'RAD51', 'HDAC6', 'ISCU', 'PDK1', 'SDHB', 'FAF2', 'NFS1', 'CBX5', 'NDUFAB1', 'BRCA1', 'SDHA', 'MICU1', 'STAT5A', 'SMDT1', 'DLD', 'PDK2', 'MBD1', 'TRIM28', 'BARD1', 'MICU2', 'PMPCB', 'OGDH', 'PHB1', 'STAT5B', 'BCKDHA']
12	GO:CC	GO:0032991	protein-containing complex	4.511067631261535e-18	True	"""A stable assembly of two or more macromolecules, i.e. proteins, nucleic acids, carbohydrates or lipids, in which at least one component is a protein and the constituent parts function together."" [GOC:dos, GOC:mah]"	5470	97	74	17376	0.7628865979381443	0.0135283363802559	query_1	['GO:0005575']	['PPIF', 'RBBP8', 'SNX6', 'UBE2I', 'GCSH', 'SPG7', 'SNX1', 'LYRM4', 'ADSL', 'CDK5RAP3', 'NBN', 'ATF7IP', 'DLST', 'HSPA9', 'MCUB', 'TP53BP1', 'RAD50', 'ZNF350', 'XRCC6', 'PAXIP1', 'DLAT', 'PDHA2', 'PDHX', 'PDHB', 'H2AX', 'UFL1', 'PMPCA', 'PHB2', 'METTL21C', 'SDHD', 'DBT', 'BRCA2', 'MCU', 'BCKDK', 'BCKDHB', 'PDHA1', 'SUMO1', 'HSPD1', 'RPA1', 'FLYWCH1', 'BLM', 'MRE11', 'VDAC1', 'RAD51', 'AFG3L2', 'HDAC6', 'ISCU', 'GPD1', 'PDK1', 'SDHB', 'FAF2', 'NFS1', 'CBX5', 'NDUFAB1', 'BRCA1', 'SDHA', 'MICU1', 'STAT5A', 'SMDT1', 'SDHC', 'DLD', 'PDK2', 'NDUFV3', 'TRIM28', 'BARD1', 'MICU2', 'MFN1', 'ABHD6', 'PMPCB', 'OGDH', 'GJA10', 'PHB1', 'STAT5B', 'BCKDHA']
13	REAC	REAC:R-HSA-1428517	The citric acid (TCA) cycle and respiratory electron transport	7.881862162680592e-18	True	The citric acid (TCA) cycle and respiratory electron transport	172	97	19	17376	0.1958762886597938	0.1104651162790697	query_1	['REAC:R-HSA-1430728']	['PDK4', 'DLST', 'DLAT', 'PDHA2', 'PDHX', 'PDHB', 'SDHD', 'PDHA1', 'PDK3', 'VDAC1', 'PDK1', 'SDHB', 'NDUFAB1', 'SDHA', 'SDHC', 'DLD', 'PDK2', 'NDUFV3', 'OGDH']
14	REAC	REAC:R-HSA-204174	Regulation of pyruvate dehydrogenase (PDH) complex	8.691453022967659e-18	True	Regulation of pyruvate dehydrogenase (PDH) complex	16	97	10	17376	0.1030927835051546	0.625	query_1	['REAC:R-HSA-70268']	['PDK4', 'DLAT', 'PDHA2', 'PDHX', 'PDHB', 'PDHA1', 'PDK3', 'PDK1', 'DLD', 'PDK2']
15	GO:CC	GO:0045254	pyruvate dehydrogenase complex	2.0789415649500918e-17	True	"""Complex that carries out the oxidative decarboxylation of pyruvate to form acetyl-CoA; comprises subunits possessing three catalytic activities: pyruvate dehydrogenase (E1), dihydrolipoamide S-acetyltransferase (E2), and dihydrolipoamide dehydrogenase (E3)."" [ISBN:0716720094]"	8	97	8	17376	0.0824742268041237	1.0	query_1	['GO:0005737', 'GO:1990204']	['DLAT', 'PDHA2', 'PDHX', 'PDHB', 'PDHA1', 'PDK1', 'DLD', 'PDK2']
16	GO:CC	GO:0005967	mitochondrial pyruvate dehydrogenase complex	2.0789415649500918e-17	True	"""Complex that carries out the oxidative decarboxylation of pyruvate to form acetyl-CoA in eukaryotes; includes subunits possessing three catalytic activities: pyruvate dehydrogenase (E1), dihydrolipoamide S-acetyltransferase (E2), and dihydrolipoamide dehydrogenase (E3). The This Eukaryotic form usually contains more subunits than its bacterial counterpart; for example, one known complex contains 30 E1 dimers, 60 E2 monomers, and 6 E3 dimers as well as a few copies of pyruvate dehydrogenase kinase and pyruvate dehydrogenase phosphatase."" [GOC:mtg_sensu, ISBN:0471331309, ISBN:0716720094]"	8	97	8	17376	0.0824742268041237	1.0	query_1	['GO:0005759', 'GO:0045254', 'GO:0098798']	['DLAT', 'PDHA2', 'PDHX', 'PDHB', 'PDHA1', 'PDK1', 'DLD', 'PDK2']
17	REAC	REAC:R-HSA-70268	Pyruvate metabolism	2.3998989594795744e-16	True	Pyruvate metabolism	30	97	11	17376	0.1134020618556701	0.3666666666666666	query_1	['REAC:R-HSA-71406']	['PDK4', 'DLAT', 'PDHA2', 'PDHX', 'PDHB', 'PDHA1', 'PDK3', 'VDAC1', 'PDK1', 'DLD', 'PDK2']
18	GO:CC	GO:0098800	inner mitochondrial membrane protein complex	2.891217340426698e-16	True	"""Any protein complex that is part of the inner mitochondrial membrane."" [GOC:dos]"	154	97	17	17376	0.1752577319587628	0.1103896103896103	query_1	['GO:0005743', 'GO:0098796', 'GO:0098798']	['PPIF', 'SPG7', 'HSPA9', 'MCUB', 'PHB2', 'SDHD', 'MCU', 'AFG3L2', 'SDHB', 'NDUFAB1', 'SDHA', 'MICU1', 'SMDT1', 'SDHC', 'NDUFV3', 'MICU2', 'PHB1']
19	GO:BP	GO:0006085	acetyl-CoA biosynthetic process	4.0758066637265893e-16	True	"""The chemical reactions and pathways resulting in the formation of acetyl-CoA, a derivative of coenzyme A in which the sulfhydryl group is acetylated."" [GOC:go_curators]"	17	97	10	17376	0.1030927835051546	0.5882352941176471	query_1	['GO:0006084', 'GO:0071616']	['PDK4', 'DLAT', 'PDHA2', 'PDHX', 'PDHB', 'PDHA1', 'PDK3', 'PDK1', 'DLD', 'PDK2']
20	REAC	REAC:R-HSA-5693532	DNA Double-Strand Break Repair	2.2020071692285e-15	True	DNA Double-Strand Break Repair	168	97	17	17376	0.1752577319587628	0.1011904761904761	query_1	['REAC:R-HSA-73894']	['RBBP8', 'UBE2I', 'NBN', 'TP53BP1', 'RAD50', 'XRCC6', 'PAXIP1', 'H2AX', 'MDC1', 'BRCA2', 'SUMO1', 'RPA1', 'BLM', 'MRE11', 'RAD51', 'BRCA1', 'BARD1']
21	GO:BP	GO:0006084	acetyl-CoA metabolic process	8.474420118016745e-15	True	"""The chemical reactions and pathways involving acetyl-CoA, a derivative of coenzyme A in which the sulfhydryl group is acetylated; it is a metabolite derived from several pathways (e.g. glycolysis, fatty acid oxidation, amino-acid catabolism) and is further metabolized by the tricarboxylic acid cycle. It is a key intermediate in lipid and terpenoid biosynthesis."" [ISBN:0198547684]"	32	97	11	17376	0.1134020618556701	0.34375	query_1	['GO:0006637']	['PDK4', 'DLST', 'DLAT', 'PDHA2', 'PDHX', 'PDHB', 'PDHA1', 'PDK3', 'PDK1', 'DLD', 'PDK2']
22	GO:BP	GO:0006851	mitochondrial calcium ion transmembrane transport	2.3656950774621862e-14	True	"""The process in which a calcium ion (Ca2+) is transported across a mitochondrial membrane, into or out of the mitochondrion."" [GOC:ai]"	16	97	9	17376	0.0927835051546391	0.5625	query_1	['GO:0070588']	['MAIP1', 'MCUB', 'MCU', 'VDAC1', 'AFG3L2', 'MICU1', 'SMDT1', 'MICU2', 'PMPCB']
23	GO:BP	GO:0036444	calcium import into the mitochondrion	5.4251793496278316e-14	True	"""A process in which a calcium ion (Ca2+) is transported from the cytosol into the mitochondrial matrix."" [GOC:vw]"	11	97	8	17376	0.0824742268041237	0.7272727272727273	query_1	['GO:0006851']	['MAIP1', 'MCUB', 'MCU', 'VDAC1', 'AFG3L2', 'MICU1', 'SMDT1', 'MICU2']
24	GO:CC	GO:1902494	catalytic complex	6.206941155832521e-14	True	"""A protein complex which is capable of catalytic activity."" [GOC:bhm, GOC:TermGenie, PMID:8077207]"	1713	97	39	17376	0.4020618556701031	0.0227670753064798	query_1	['GO:0032991']	['PPIF', 'UBE2I', 'GCSH', 'SPG7', 'LYRM4', 'DLST', 'TP53BP1', 'XRCC6', 'PAXIP1', 'DLAT', 'PDHA2', 'PDHX', 'PDHB', 'PMPCA', 'SDHD', 'DBT', 'BRCA2', 'BCKDK', 'BCKDHB', 'PDHA1', 'BLM', 'RAD51', 'AFG3L2', 'HDAC6', 'GPD1', 'PDK1', 'SDHB', 'CBX5', 'NDUFAB1', 'BRCA1', 'SDHA', 'SDHC', 'DLD', 'PDK2', 'NDUFV3', 'BARD1', 'PMPCB', 'OGDH', 'BCKDHA']
25	REAC	REAC:R-HSA-9709570	Impaired BRCA2 binding to RAD51	1.2179412057182338e-13	True	Impaired BRCA2 binding to RAD51	35	97	10	17376	0.1030927835051546	0.2857142857142857	query_1	['REAC:R-HSA-9701190']	['RBBP8', 'NBN', 'RAD50', 'BRCA2', 'RPA1', 'BLM', 'MRE11', 'RAD51', 'BRCA1', 'BARD1']
26	REAC	REAC:R-HSA-9709603	Impaired BRCA2 binding to PALB2	1.6125846081068848e-13	True	Impaired BRCA2 binding to PALB2	24	97	9	17376	0.0927835051546391	0.375	query_1	['REAC:R-HSA-9701190']	['RBBP8', 'NBN', 'RAD50', 'BRCA2', 'BLM', 'MRE11', 'RAD51', 'BRCA1', 'BARD1']
27	REAC	REAC:R-HSA-9701193	Defective homologous recombination repair (HRR) due to PALB2 loss of function	1.7915513214513216e-13	True	Defective homologous recombination repair (HRR) due to PALB2 loss of function	25	97	9	17376	0.0927835051546391	0.36	query_1	['REAC:R-HSA-9675136']	['RBBP8', 'NBN', 'RAD50', 'BRCA2', 'BLM', 'MRE11', 'RAD51', 'BRCA1', 'BARD1']
28	REAC	REAC:R-HSA-9701192	Defective homologous recombination repair (HRR) due to BRCA1 loss of function	1.7915513214513216e-13	True	Defective homologous recombination repair (HRR) due to BRCA1 loss of function	25	97	9	17376	0.0927835051546391	0.36	query_1	['REAC:R-HSA-9675136']	['RBBP8', 'NBN', 'RAD50', 'BRCA2', 'BLM', 'MRE11', 'RAD51', 'BRCA1', 'BARD1']
29	REAC	REAC:R-HSA-9704646	Defective HDR through Homologous Recombination Repair (HRR) due to PALB2 loss of BRCA2/RAD51/RAD51C binding function	1.7915513214513216e-13	True	Defective HDR through Homologous Recombination Repair (HRR) due to PALB2 loss of BRCA2/RAD51/RAD51C binding function	25	97	9	17376	0.0927835051546391	0.36	query_1	['REAC:R-HSA-9701193']	['RBBP8', 'NBN', 'RAD50', 'BRCA2', 'BLM', 'MRE11', 'RAD51', 'BRCA1', 'BARD1']
30	REAC	REAC:R-HSA-9704331	Defective HDR through Homologous Recombination Repair (HRR) due to PALB2 loss of BRCA1 binding function	1.7915513214513216e-13	True	Defective HDR through Homologous Recombination Repair (HRR) due to PALB2 loss of BRCA1 binding function	25	97	9	17376	0.0927835051546391	0.36	query_1	['REAC:R-HSA-9701193']	['RBBP8', 'NBN', 'RAD50', 'BRCA2', 'BLM', 'MRE11', 'RAD51', 'BRCA1', 'BARD1']
31	GO:CC	GO:0005743	mitochondrial inner membrane	1.9083518099908772e-13	True	"""The inner, i.e. lumen-facing, lipid bilayer of the mitochondrial envelope. It is highly folded to form cristae."" [GOC:ai]"	465	97	22	17376	0.2268041237113402	0.0473118279569892	query_1	['GO:0019866', 'GO:0031966']	['PPIF', 'SPG7', 'MAIP1', 'OTC', 'HSPA9', 'MCUB', 'PMPCA', 'PHB2', 'SDHD', 'MCU', 'HSPD1', 'AFG3L2', 'SDHB', 'NDUFAB1', 'SDHA', 'MICU1', 'SMDT1', 'SDHC', 'NDUFV3', 'MICU2', 'PMPCB', 'PHB1']
32	GO:CC	GO:0031966	mitochondrial membrane	1.9083518099908772e-13	True	"""Either of the lipid bilayers that surround the mitochondrion and form the mitochondrial envelope."" [GOC:mah, NIF_Subcellular:sao1045389829]"	710	97	26	17376	0.268041237113402	0.0366197183098591	query_1	['GO:0005740', 'GO:0031090']	['PPIF', 'SPG7', 'MAIP1', 'OTC', 'HSPA9', 'MCUB', 'PMPCA', 'PHB2', 'SDHD', 'MCU', 'HSPD1', 'VDAC1', 'AFG3L2', 'SDHB', 'NDUFAB1', 'SDHA', 'MICU1', 'SMDT1', 'SDHC', 'NDUFV3', 'MICU2', 'MFN1', 'ABHD6', 'PMPCB', 'OGDH', 'PHB1']
33	GO:BP	GO:0006099	tricarboxylic acid cycle	2.906514532037235e-13	True	"""A nearly universal metabolic pathway in which the acetyl group of acetyl coenzyme A is effectively oxidized to two CO2 and four pairs of electrons are transferred to coenzymes. The acetyl group combines with oxaloacetate to form citrate, which undergoes successive transformations to isocitrate, 2-oxoglutarate, succinyl-CoA, succinate, fumarate, malate, and oxaloacetate again, thus completing the cycle. In eukaryotes the tricarboxylic acid is confined to the mitochondria. See also glyoxylate cycle."" [ISBN:0198506732]"	31	97	10	17376	0.1030927835051546	0.3225806451612903	query_1	['GO:0009060', 'GO:0044238']	['DLST', 'DLAT', 'PDHA2', 'PDHB', 'SDHD', 'PDHA1', 'SDHB', 'SDHA', 'SDHC', 'OGDH']
34	GO:CC	GO:0045240	dihydrolipoyl dehydrogenase complex	3.166241767151438e-13	True	"""A protein complex that possesses alpha-ketoglutarate dehydrogenase activity."" [GOC:mah]"	10	97	7	17376	0.0721649484536082	0.7	query_1	['GO:0045239', 'GO:1990204']	['DLST', 'DBT', 'BCKDK', 'BCKDHB', 'DLD', 'OGDH', 'BCKDHA']
35	REAC	REAC:R-HSA-5693616	Presynaptic phase of homologous DNA pairing and strand exchange	3.2980674526571954e-13	True	Presynaptic phase of homologous DNA pairing and strand exchange	40	97	10	17376	0.1030927835051546	0.25	query_1	['REAC:R-HSA-5693579']	['RBBP8', 'NBN', 'RAD50', 'BRCA2', 'RPA1', 'BLM', 'MRE11', 'RAD51', 'BRCA1', 'BARD1']
36	REAC	REAC:R-HSA-5693567	HDR through Homologous Recombination (HRR) or Single Strand Annealing (SSA)	3.427962477708699e-13	True	HDR through Homologous Recombination (HRR) or Single Strand Annealing (SSA)	132	97	14	17376	0.1443298969072164	0.106060606060606	query_1	['REAC:R-HSA-5693538']	['RBBP8', 'UBE2I', 'NBN', 'TP53BP1', 'RAD50', 'H2AX', 'MDC1', 'BRCA2', 'RPA1', 'BLM', 'MRE11', 'RAD51', 'BRCA1', 'BARD1']
37	REAC	REAC:R-HSA-9701190	Defective homologous recombination repair (HRR) due to BRCA2 loss of function	3.427962477708699e-13	True	Defective homologous recombination repair (HRR) due to BRCA2 loss of function	41	97	10	17376	0.1030927835051546	0.2439024390243902	query_1	['REAC:R-HSA-9675136']	['RBBP8', 'NBN', 'RAD50', 'BRCA2', 'RPA1', 'BLM', 'MRE11', 'RAD51', 'BRCA1', 'BARD1']
38	REAC	REAC:R-HSA-5693554	Resolution of D-loop Structures through Synthesis-Dependent Strand Annealing (SDSA)	3.427962477708699e-13	True	Resolution of D-loop Structures through Synthesis-Dependent Strand Annealing (SDSA)	27	97	9	17376	0.0927835051546391	0.3333333333333333	query_1	['REAC:R-HSA-5693537']	['RBBP8', 'NBN', 'RAD50', 'BRCA2', 'BLM', 'MRE11', 'RAD51', 'BRCA1', 'BARD1']
39	REAC	REAC:R-HSA-9675136	Diseases of DNA Double-Strand Break Repair	3.427962477708699e-13	True	Diseases of DNA Double-Strand Break Repair	41	97	10	17376	0.1030927835051546	0.2439024390243902	query_1	['REAC:R-HSA-9675135']	['RBBP8', 'NBN', 'RAD50', 'BRCA2', 'RPA1', 'BLM', 'MRE11', 'RAD51', 'BRCA1', 'BARD1']
40	REAC	REAC:R-HSA-5362517	Signaling by Retinoic Acid	4.2547657485701444e-13	True	Signaling by Retinoic Acid	42	97	10	17376	0.1030927835051546	0.238095238095238	query_1	['REAC:R-HSA-9006931']	['PDK4', 'DLAT', 'PDHA2', 'PDHX', 'PDHB', 'PDHA1', 'PDK3', 'PDK1', 'DLD', 'PDK2']
41	GO:BP	GO:0009152	purine ribonucleotide biosynthetic process	4.3877814728299933e-13	True	"""The chemical reactions and pathways resulting in the formation of a purine ribonucleotide, a compound consisting of ribonucleoside (a purine base linked to a ribose sugar) esterified with a phosphate group at either the 3' or 5'-hydroxyl group of the sugar."" [GOC:go_curators, ISBN:0198506732]"	204	97	17	17376	0.1752577319587628	0.0833333333333333	query_1	['GO:0006164', 'GO:0009150', 'GO:0009260']	['PDK4', 'ADSL', 'DLAT', 'PDHA2', 'PDHX', 'PDHB', 'SDHD', 'PDHA1', 'PDK3', 'PDK1', 'SDHB', 'NDUFAB1', 'SDHA', 'SDHC', 'DLD', 'PDK2', 'NDUFV3']
42	GO:CC	GO:0070533	BRCA1-C complex	4.786444543978245e-13	True	"""A protein complex that contains the BRCA1-BARD1 heterodimer, CtIP and Mre11/Rad50/NBS1 (M/R/N) complex, and binds to DNA at DNA damage sites. BRCA1-C binding ta damaged DNA is required for DNA damage-induced Chk1 phosphorylation and the G2/M transition checkpoint."" [GOC:mah, PMID:15485915, PMID:16391231]"	6	97	6	17376	0.0618556701030927	1.0	query_1	['GO:0140513']	['RBBP8', 'NBN', 'RAD50', 'MRE11', 'BRCA1', 'BARD1']
43	REAC	REAC:R-HSA-5693579	Homologous DNA Pairing and Strand Exchange	5.256026200369157e-13	True	Homologous DNA Pairing and Strand Exchange	43	97	10	17376	0.1030927835051546	0.2325581395348837	query_1	['REAC:R-HSA-5685942']	['RBBP8', 'NBN', 'RAD50', 'BRCA2', 'RPA1', 'BLM', 'MRE11', 'RAD51', 'BRCA1', 'BARD1']
44	REAC	REAC:R-HSA-5693538	Homology Directed Repair	5.402990244638001e-13	True	Homology Directed Repair	138	97	14	17376	0.1443298969072164	0.1014492753623188	query_1	['REAC:R-HSA-5693532']	['RBBP8', 'UBE2I', 'NBN', 'TP53BP1', 'RAD50', 'H2AX', 'MDC1', 'BRCA2', 'RPA1', 'BLM', 'MRE11', 'RAD51', 'BRCA1', 'BARD1']
45	GO:BP	GO:0006790	sulfur compound metabolic process	5.639642066672963e-13	True	"""The chemical reactions and pathways involving the nonmetallic element sulfur or compounds that contain sulfur, such as the amino acids methionine and cysteine or the tripeptide glutathione."" [GOC:ai]"	289	97	19	17376	0.1958762886597938	0.0657439446366782	query_1	['GO:0044237']	['PDK4', 'LYRM4', 'DLST', 'HSPA9', 'DLAT', 'PDHA2', 'PDHX', 'PDHB', 'PDHA1', 'PDK3', 'ISCU', 'PDK1', 'NFS1', 'NDUFAB1', 'STAT5A', 'DLD', 'PDK2', 'OGDH', 'STAT5B']
46	GO:CC	GO:0005740	mitochondrial envelope	6.643818334633989e-13	True	"""The double lipid bilayer enclosing the mitochondrion and separating its contents from the cell cytoplasm; includes the intermembrane space."" [GOC:ai, GOC:pz]"	755	97	26	17376	0.268041237113402	0.0344370860927152	query_1	['GO:0005739', 'GO:0031967']	['PPIF', 'SPG7', 'MAIP1', 'OTC', 'HSPA9', 'MCUB', 'PMPCA', 'PHB2', 'SDHD', 'MCU', 'HSPD1', 'VDAC1', 'AFG3L2', 'SDHB', 'NDUFAB1', 'SDHA', 'MICU1', 'SMDT1', 'SDHC', 'NDUFV3', 'MICU2', 'MFN1', 'ABHD6', 'PMPCB', 'OGDH', 'PHB1']
47	GO:BP	GO:0006163	purine nucleotide metabolic process	7.085831114745189e-13	True	"""The chemical reactions and pathways involving a purine nucleotide, a compound consisting of nucleoside (a purine base linked to a deoxyribose or ribose sugar) esterified with a phosphate group at either the 3' or 5'-hydroxyl group of the sugar."" [GOC:go_curators, ISBN:0198506732]"	440	97	22	17376	0.2268041237113402	0.05	query_1	['GO:0009117', 'GO:0072521']	['PDK4', 'ADSL', 'DLST', 'TALDO1', 'DLAT', 'PDHA2', 'PDHX', 'PDHB', 'SDHD', 'PDHA1', 'PDK3', 'GPD1', 'PDK1', 'SDHB', 'NDUFAB1', 'SDHA', 'SDHC', 'DLD', 'PDK2', 'NDUFV3', 'MFN1', 'OGDH']
48	GO:BP	GO:0009260	ribonucleotide biosynthetic process	8.489695532627036e-13	True	"""The chemical reactions and pathways resulting in the formation of a ribonucleotide, a compound consisting of ribonucleoside (a base linked to a ribose sugar) esterified with a phosphate group at either the 3' or 5'-hydroxyl group of the sugar."" [GOC:go_curators, ISBN:0198506732]"	218	97	17	17376	0.1752577319587628	0.0779816513761468	query_1	['GO:0009165', 'GO:0009259', 'GO:0046390']	['PDK4', 'ADSL', 'DLAT', 'PDHA2', 'PDHX', 'PDHB', 'SDHD', 'PDHA1', 'PDK3', 'PDK1', 'SDHB', 'NDUFAB1', 'SDHA', 'SDHC', 'DLD', 'PDK2', 'NDUFV3']
49	GO:BP	GO:0009150	purine ribonucleotide metabolic process	8.489695532627036e-13	True	"""The chemical reactions and pathways involving a purine ribonucleotide, a compound consisting of ribonucleoside (a purine base linked to a ribose sugar) esterified with a phosphate group at either the 3' or 5'-hydroxyl group of the sugar."" [GOC:go_curators, ISBN:0198506732]"	346	97	20	17376	0.2061855670103092	0.0578034682080924	query_1	['GO:0006163', 'GO:0009259']	['PDK4', 'ADSL', 'DLST', 'DLAT', 'PDHA2', 'PDHX', 'PDHB', 'SDHD', 'PDHA1', 'PDK3', 'PDK1', 'SDHB', 'NDUFAB1', 'SDHA', 'SDHC', 'DLD', 'PDK2', 'NDUFV3', 'MFN1', 'OGDH']
50	GO:BP	GO:0006082	organic acid metabolic process	1.0528355089166578e-12	True	"""The chemical reactions and pathways involving organic acids, any acidic compound containing carbon in covalent linkage."" [ISBN:0198506732]"	904	97	29	17376	0.2989690721649484	0.0320796460176991	query_1	['GO:0044237', 'GO:0044281', 'GO:0071704']	['PDK4', 'GCSH', 'OTC', 'DLST', 'DLAT', 'PDHA2', 'PDHX', 'PDHB', 'MCAT', 'DBT', 'BCKDK', 'BCKDHB', 'PDHA1', 'PDK3', 'VDAC1', 'GPD1', 'PDK1', 'SDHB', 'NDUFAB1', 'BRCA1', 'SDHA', 'STAT5A', 'DLD', 'PDK2', 'ABHD6', 'PEPD', 'OGDH', 'STAT5B', 'BCKDHA']
51	GO:BP	GO:0009060	aerobic respiration	1.0528355089166578e-12	True	"""The enzymatic release of energy from inorganic and organic compounds (especially carbohydrates and fats) which requires oxygen as the terminal electron acceptor."" [GOC:das, GOC:jl, ISBN:0140513590]"	186	97	16	17376	0.1649484536082474	0.086021505376344	query_1	['GO:0045333']	['PPIF', 'ADSL', 'DLST', 'DLAT', 'PDHA2', 'PDHB', 'SDHD', 'PDHA1', 'ISCU', 'SDHB', 'NDUFAB1', 'SDHA', 'SDHC', 'DLD', 'NDUFV3', 'OGDH']
52	GO:BP	GO:0046390	ribose phosphate biosynthetic process	1.1297984579759879e-12	True	"""The chemical reactions and pathways resulting in the formation of ribose phosphate, any phosphorylated ribose sugar."" [GOC:ai]"	225	97	17	17376	0.1752577319587628	0.0755555555555555	query_1	['GO:0019693', 'GO:0090407', 'GO:1901137']	['PDK4', 'ADSL', 'DLAT', 'PDHA2', 'PDHX', 'PDHB', 'SDHD', 'PDHA1', 'PDK3', 'PDK1', 'SDHB', 'NDUFAB1', 'SDHA', 'SDHC', 'DLD', 'PDK2', 'NDUFV3']
53	GO:BP	GO:0045333	cellular respiration	1.5481825263748913e-12	True	"""The enzymatic release of energy from inorganic and organic compounds (especially carbohydrates and fats) which either requires oxygen (aerobic respiration) or does not (anaerobic respiration)."" [GOC:das, ISBN:0140513590, ISBN:0198506732]"	232	97	17	17376	0.1752577319587628	0.0732758620689655	query_1	['GO:0015980']	['PPIF', 'ADSL', 'DLST', 'DLAT', 'PDHA2', 'PDHB', 'SDHD', 'PDHA1', 'ISCU', 'GPD1', 'SDHB', 'NDUFAB1', 'SDHA', 'SDHC', 'DLD', 'NDUFV3', 'OGDH']
54	GO:BP	GO:0009259	ribonucleotide metabolic process	1.5481825263748913e-12	True	"""The chemical reactions and pathways involving a ribonucleotide, a compound consisting of ribonucleoside (a base linked to a ribose sugar) esterified with a phosphate group at either the 3' or 5'-hydroxyl group of the sugar."" [GOC:go_curators, ISBN:0198506732]"	366	97	20	17376	0.2061855670103092	0.0546448087431694	query_1	['GO:0009117', 'GO:0019693']	['PDK4', 'ADSL', 'DLST', 'DLAT', 'PDHA2', 'PDHX', 'PDHB', 'SDHD', 'PDHA1', 'PDK3', 'PDK1', 'SDHB', 'NDUFAB1', 'SDHA', 'SDHC', 'DLD', 'PDK2', 'NDUFV3', 'MFN1', 'OGDH']
55	GO:BP	GO:0072521	purine-containing compound metabolic process	1.5481825263748913e-12	True	"""The chemical reactions and pathways involving a purine-containing compound, i.e. any compound that contains purine or a formal derivative thereof."" [GOC:mah]"	469	97	22	17376	0.2268041237113402	0.0469083155650319	query_1	['GO:0006725', 'GO:0034641', 'GO:0046483', 'GO:1901360', 'GO:1901564']	['PDK4', 'ADSL', 'DLST', 'TALDO1', 'DLAT', 'PDHA2', 'PDHX', 'PDHB', 'SDHD', 'PDHA1', 'PDK3', 'GPD1', 'PDK1', 'SDHB', 'NDUFAB1', 'SDHA', 'SDHC', 'DLD', 'PDK2', 'NDUFV3', 'MFN1', 'OGDH']
56	GO:CC	GO:0019866	organelle inner membrane	1.703747263275346e-12	True	"""The inner, i.e. lumen-facing, lipid bilayer of an organelle envelope; usually highly selective to most ions and metabolites."" [GOC:mah]"	526	97	22	17376	0.2268041237113402	0.0418250950570342	query_1	['GO:0031090', 'GO:0031967']	['PPIF', 'SPG7', 'MAIP1', 'OTC', 'HSPA9', 'MCUB', 'PMPCA', 'PHB2', 'SDHD', 'MCU', 'HSPD1', 'AFG3L2', 'SDHB', 'NDUFAB1', 'SDHA', 'MICU1', 'SMDT1', 'SDHC', 'NDUFV3', 'MICU2', 'PMPCB', 'PHB1']
57	GO:BP	GO:0019693	ribose phosphate metabolic process	2.2882404958609048e-12	True	"""The chemical reactions and pathways involving ribose phosphate, any phosphorylated ribose sugar."" [GOC:ai]"	375	97	20	17376	0.2061855670103092	0.0533333333333333	query_1	['GO:0006796', 'GO:0019637', 'GO:1901135']	['PDK4', 'ADSL', 'DLST', 'DLAT', 'PDHA2', 'PDHX', 'PDHB', 'SDHD', 'PDHA1', 'PDK3', 'PDK1', 'SDHB', 'NDUFAB1', 'SDHA', 'SDHC', 'DLD', 'PDK2', 'NDUFV3', 'MFN1', 'OGDH']
58	REAC	REAC:R-HSA-9675135	Diseases of DNA repair	2.4901963714321866e-12	True	Diseases of DNA repair	50	97	10	17376	0.1030927835051546	0.2	query_1	['REAC:R-HSA-1643685']	['RBBP8', 'NBN', 'RAD50', 'BRCA2', 'RPA1', 'BLM', 'MRE11', 'RAD51', 'BRCA1', 'BARD1']
59	REAC	REAC:R-HSA-5693568	Resolution of D-loop Structures through Holliday Junction Intermediates	2.574964149715968e-12	True	Resolution of D-loop Structures through Holliday Junction Intermediates	34	97	9	17376	0.0927835051546391	0.2647058823529412	query_1	['REAC:R-HSA-5693537']	['RBBP8', 'NBN', 'RAD50', 'BRCA2', 'BLM', 'MRE11', 'RAD51', 'BRCA1', 'BARD1']
60	REAC	REAC:R-HSA-5693607	Processing of DNA double-strand break ends	3.18506592011108e-12	True	Processing of DNA double-strand break ends	97	97	12	17376	0.1237113402061855	0.1237113402061855	query_1	['REAC:R-HSA-5693567']	['RBBP8', 'UBE2I', 'NBN', 'TP53BP1', 'RAD50', 'H2AX', 'MDC1', 'RPA1', 'BLM', 'MRE11', 'BRCA1', 'BARD1']
61	REAC	REAC:R-HSA-5693537	Resolution of D-Loop Structures	3.18506592011108e-12	True	Resolution of D-Loop Structures	35	97	9	17376	0.0927835051546391	0.2571428571428571	query_1	['REAC:R-HSA-5685942']	['RBBP8', 'NBN', 'RAD50', 'BRCA2', 'BLM', 'MRE11', 'RAD51', 'BRCA1', 'BARD1']
62	REAC	REAC:R-HSA-73894	DNA Repair	3.627548956093374e-12	True	DNA Repair	329	97	18	17376	0.1855670103092783	0.0547112462006079	query_1	['REAC:0000000']	['RBBP8', 'UBE2I', 'NBN', 'TP53BP1', 'RAD50', 'XRCC6', 'PAXIP1', 'H2AX', 'MDC1', 'BRCA2', 'SUMO1', 'RPA1', 'BLM', 'PIAS1', 'MRE11', 'RAD51', 'BRCA1', 'BARD1']
63	GO:BP	GO:0009117	nucleotide metabolic process	3.769927953941759e-12	True	"""The chemical reactions and pathways involving a nucleotide, a nucleoside that is esterified with (ortho)phosphate or an oligophosphate at any hydroxyl group on the glycose moiety; may be mono-, di- or triphosphate; this definition includes cyclic nucleotides (nucleoside cyclic phosphates)."" [GOC:ma]"	495	97	22	17376	0.2268041237113402	0.0444444444444444	query_1	['GO:0006753']	['PDK4', 'ADSL', 'DLST', 'TALDO1', 'DLAT', 'PDHA2', 'PDHX', 'PDHB', 'SDHD', 'PDHA1', 'PDK3', 'GPD1', 'PDK1', 'SDHB', 'NDUFAB1', 'SDHA', 'SDHC', 'DLD', 'PDK2', 'NDUFV3', 'MFN1', 'OGDH']
64	GO:BP	GO:0006090	pyruvate metabolic process	4.499625270241357e-12	True	"""The chemical reactions and pathways involving pyruvate, 2-oxopropanoate."" [GOC:go_curators]"	110	97	13	17376	0.134020618556701	0.1181818181818181	query_1	['GO:0032787']	['PDK4', 'DLAT', 'PDHA2', 'PDHX', 'PDHB', 'PDHA1', 'PDK3', 'VDAC1', 'GPD1', 'PDK1', 'DLD', 'PDK2', 'OGDH']
65	GO:BP	GO:0006164	purine nucleotide biosynthetic process	4.603480864480513e-12	True	"""The chemical reactions and pathways resulting in the formation of a purine nucleotide, a compound consisting of nucleoside (a purine base linked to a deoxyribose or ribose sugar) esterified with a phosphate group at either the 3' or 5'-hydroxyl group of the sugar."" [GOC:go_curators, ISBN:0198506732]"	251	97	17	17376	0.1752577319587628	0.0677290836653386	query_1	['GO:0006163', 'GO:0009165', 'GO:0072522']	['PDK4', 'ADSL', 'DLAT', 'PDHA2', 'PDHX', 'PDHB', 'SDHD', 'PDHA1', 'PDK3', 'PDK1', 'SDHB', 'NDUFAB1', 'SDHA', 'SDHC', 'DLD', 'PDK2', 'NDUFV3']
66	GO:BP	GO:0006753	nucleoside phosphate metabolic process	4.6988195508382976e-12	True	"""The chemical reactions and pathways involving any phosphorylated nucleoside."" [GOC:mah]"	504	97	22	17376	0.2268041237113402	0.0436507936507936	query_1	['GO:0006796', 'GO:0019637', 'GO:0055086']	['PDK4', 'ADSL', 'DLST', 'TALDO1', 'DLAT', 'PDHA2', 'PDHX', 'PDHB', 'SDHD', 'PDHA1', 'PDK3', 'GPD1', 'PDK1', 'SDHB', 'NDUFAB1', 'SDHA', 'SDHC', 'DLD', 'PDK2', 'NDUFV3', 'MFN1', 'OGDH']
67	GO:BP	GO:0035384	thioester biosynthetic process	4.902851017483788e-12	True	"""The chemical reactions and pathways resulting in the formation of a thioester, a compound of general formula RC(=O)SR' in which the linking oxygen in an ester is replaced by a sulfur atom. They are the product of esterification between a carboxylic acid and a thiol."" [GOC:bf, http://encyclopedia.thefreedictionary.com/Thioester]"	45	97	10	17376	0.1030927835051546	0.2222222222222222	query_1	['GO:0035383', 'GO:0044272', 'GO:1901576']	['PDK4', 'DLAT', 'PDHA2', 'PDHX', 'PDHB', 'PDHA1', 'PDK3', 'PDK1', 'DLD', 'PDK2']
68	GO:BP	GO:0071616	acyl-CoA biosynthetic process	4.902851017483788e-12	True	"""The chemical reactions and pathways resulting in the formation of acyl-CoA, any derivative of coenzyme A in which the sulfhydryl group is in thiolester linkage with an acyl group."" [GOC:cjk]"	45	97	10	17376	0.1030927835051546	0.2222222222222222	query_1	['GO:0006637', 'GO:0009152', 'GO:0034030', 'GO:0034033', 'GO:0035384', 'GO:0043604']	['PDK4', 'DLAT', 'PDHA2', 'PDHX', 'PDHB', 'PDHA1', 'PDK3', 'PDK1', 'DLD', 'PDK2']
69	REAC	REAC:R-HSA-5685938	HDR through Single Strand Annealing (SSA)	5.1635149340056895e-12	True	HDR through Single Strand Annealing (SSA)	37	97	9	17376	0.0927835051546391	0.2432432432432432	query_1	['REAC:R-HSA-5693567']	['RBBP8', 'NBN', 'RAD50', 'RPA1', 'BLM', 'MRE11', 'RAD51', 'BRCA1', 'BARD1']
70	GO:BP	GO:0072522	purine-containing compound biosynthetic process	6.898570468276601e-12	True	"""The chemical reactions and pathways resulting in the formation of a purine-containing compound, i.e. any compound that contains purine or a formal derivative thereof."" [GOC:mah]"	260	97	17	17376	0.1752577319587628	0.0653846153846153	query_1	['GO:0018130', 'GO:0019438', 'GO:0044271', 'GO:0072521', 'GO:1901362', 'GO:1901566']	['PDK4', 'ADSL', 'DLAT', 'PDHA2', 'PDHX', 'PDHB', 'SDHD', 'PDHA1', 'PDK3', 'PDK1', 'SDHB', 'NDUFAB1', 'SDHA', 'SDHC', 'DLD', 'PDK2', 'NDUFV3']
71	GO:BP	GO:0006637	acyl-CoA metabolic process	7.647942639680491e-12	True	"""The chemical reactions and pathways involving acyl-CoA, any derivative of coenzyme A in which the sulfhydryl group is in thiolester linkage with an acyl group."" [ISBN:0198506732]"	90	97	12	17376	0.1237113402061855	0.1333333333333333	query_1	['GO:0009150', 'GO:0033875', 'GO:0034032', 'GO:0035383', 'GO:0043603']	['PDK4', 'DLST', 'DLAT', 'PDHA2', 'PDHX', 'PDHB', 'PDHA1', 'PDK3', 'PDK1', 'DLD', 'PDK2', 'OGDH']
72	GO:BP	GO:0035383	thioester metabolic process	7.647942639680491e-12	True	"""The chemical reactions and pathways involving a thioester, a compound of general formula RC(=O)SR' in which the linking oxygen in an ester is replaced by a sulfur atom. They are the product of esterification between a carboxylic acid and a thiol."" [GOC:bf, Wikipedia:Thioester]"	90	97	12	17376	0.1237113402061855	0.1333333333333333	query_1	['GO:0006790', 'GO:0071704']	['PDK4', 'DLST', 'DLAT', 'PDHA2', 'PDHX', 'PDHB', 'PDHA1', 'PDK3', 'PDK1', 'DLD', 'PDK2', 'OGDH']
73	GO:BP	GO:1901564	organonitrogen compound metabolic process	1.0249572736082359e-11	True	"""The chemical reactions and pathways involving organonitrogen compound."" [GOC:pr, GOC:TermGenie]"	5950	97	69	17376	0.711340206185567	0.0115966386554621	query_1	['GO:0006807', 'GO:0071704']	['PPIF', 'SNX6', 'UBE2I', 'PDK4', 'GCSH', 'SPG7', 'PPM1K', 'SNX1', 'ADSL', 'CDK5RAP3', 'NBN', 'OTC', 'DLST', 'RAD50', 'UBAC2', 'XRCC6', 'TALDO1', 'PAXIP1', 'DLAT', 'PDHA2', 'PDHX', 'SETDB2', 'PDHB', 'DDRGK1', 'UFL1', 'PMPCA', 'PHB2', 'METTL21C', 'SDHD', 'DBT', 'BRCA2', 'SETDB1', 'BCKDK', 'BCKDHB', 'PDHA1', 'SUMO1', 'HSPD1', 'PDK3', 'BLM', 'PIAS1', 'MRE11', 'RAD51', 'AFG3L2', 'HDAC6', 'MOCS3', 'GPD1', 'PDK1', 'SDHB', 'FAF2', 'NFS1', 'NDUFAB1', 'BRCA1', 'SDHA', 'STAT5A', 'SDHC', 'DLD', 'PDK2', 'NDUFV3', 'TRIM28', 'BARD1', 'MFN1', 'PEPD', 'PMPCB', 'UBA5', 'OGDH', 'PHB1', 'UFM1', 'STAT5B', 'BCKDHA']
74	GO:BP	GO:0019752	carboxylic acid metabolic process	1.3720361064979479e-11	True	"""The chemical reactions and pathways involving carboxylic acids, any organic acid containing one or more carboxyl (COOH) groups or anions (COO-)."" [ISBN:0198506732]"	878	97	27	17376	0.2783505154639175	0.030751708428246	query_1	['GO:0043436']	['PDK4', 'GCSH', 'OTC', 'DLST', 'DLAT', 'PDHA2', 'PDHX', 'PDHB', 'MCAT', 'DBT', 'BCKDK', 'BCKDHB', 'PDHA1', 'PDK3', 'VDAC1', 'GPD1', 'PDK1', 'SDHB', 'NDUFAB1', 'BRCA1', 'SDHA', 'DLD', 'PDK2', 'ABHD6', 'PEPD', 'OGDH', 'BCKDHA']
75	GO:BP	GO:0009165	nucleotide biosynthetic process	2.1012425037526917e-11	True	"""The chemical reactions and pathways resulting in the formation of nucleotides, any nucleoside that is esterified with (ortho)phosphate or an oligophosphate at any hydroxyl group on the glycose moiety; may be mono-, di- or triphosphate; this definition includes cyclic-nucleotides (nucleoside cyclic phosphates)."" [GOC:go_curators]"	283	97	17	17376	0.1752577319587628	0.0600706713780918	query_1	['GO:0009117', 'GO:1901293']	['PDK4', 'ADSL', 'DLAT', 'PDHA2', 'PDHX', 'PDHB', 'SDHD', 'PDHA1', 'PDK3', 'PDK1', 'SDHB', 'NDUFAB1', 'SDHA', 'SDHC', 'DLD', 'PDK2', 'NDUFV3']
76	GO:BP	GO:0033866	nucleoside bisphosphate biosynthetic process	2.1012425037526917e-11	True	"""The chemical reactions and pathways resulting in the formation of a nucleoside bisphosphate, a compound consisting of a nucleobase linked to a deoxyribose or ribose sugar esterified with one phosphate group attached to each of two different hydroxyl groups on the sugar."" [GOC:mah, GOC:pde]"	53	97	10	17376	0.1030927835051546	0.1886792452830188	query_1	['GO:0033865', 'GO:1901293']	['PDK4', 'DLAT', 'PDHA2', 'PDHX', 'PDHB', 'PDHA1', 'PDK3', 'PDK1', 'DLD', 'PDK2']
77	GO:BP	GO:0034030	ribonucleoside bisphosphate biosynthetic process	2.1012425037526917e-11	True	"""The chemical reactions and pathways resulting in the formation of a ribonucleoside bisphosphate, a compound consisting of a nucleobase linked to a ribose sugar esterified with one phosphate group attached to each of two different hydroxyl groups on the sugar."" [GOC:mah, GOC:pde]"	53	97	10	17376	0.1030927835051546	0.1886792452830188	query_1	['GO:0033866', 'GO:0033875']	['PDK4', 'DLAT', 'PDHA2', 'PDHX', 'PDHB', 'PDHA1', 'PDK3', 'PDK1', 'DLD', 'PDK2']
78	GO:BP	GO:0034033	purine nucleoside bisphosphate biosynthetic process	2.1012425037526917e-11	True	"""The chemical reactions and pathways resulting in the formation of a purine nucleoside bisphosphate, a compound consisting of a purine base linked to a deoxyribose or ribose sugar esterified with one phosphate group attached to each of two different hydroxyl groups on the sugar."" [GOC:mah, GOC:pde]"	53	97	10	17376	0.1030927835051546	0.1886792452830188	query_1	['GO:0033866', 'GO:0034032', 'GO:0072522']	['PDK4', 'DLAT', 'PDHA2', 'PDHX', 'PDHB', 'PDHA1', 'PDK3', 'PDK1', 'DLD', 'PDK2']
79	GO:BP	GO:0043436	oxoacid metabolic process	2.108110131627493e-11	True	"""The chemical reactions and pathways involving any oxoacid; an oxoacid is a compound which contains oxygen, at least one other element, and at least one hydrogen bound to oxygen, and which produces a conjugate base by loss of positive hydrogen ion(s) (hydrons)."" [Wikipedia:Oxyacid]"	900	97	27	17376	0.2783505154639175	0.03	query_1	['GO:0006082']	['PDK4', 'GCSH', 'OTC', 'DLST', 'DLAT', 'PDHA2', 'PDHX', 'PDHB', 'MCAT', 'DBT', 'BCKDK', 'BCKDHB', 'PDHA1', 'PDK3', 'VDAC1', 'GPD1', 'PDK1', 'SDHB', 'NDUFAB1', 'BRCA1', 'SDHA', 'DLD', 'PDK2', 'ABHD6', 'PEPD', 'OGDH', 'BCKDHA']
80	GO:BP	GO:1901293	nucleoside phosphate biosynthetic process	2.2047971018525326e-11	True	"""The chemical reactions and pathways resulting in the formation of a nucleoside phosphate."" [GOC:TermGenie]"	285	97	17	17376	0.1752577319587628	0.0596491228070175	query_1	['GO:0006753', 'GO:0034654', 'GO:0090407']	['PDK4', 'ADSL', 'DLAT', 'PDHA2', 'PDHX', 'PDHB', 'SDHD', 'PDHA1', 'PDK3', 'PDK1', 'SDHB', 'NDUFAB1', 'SDHA', 'SDHC', 'DLD', 'PDK2', 'NDUFV3']
81	GO:BP	GO:0033554	cellular response to stress	2.4668763072514737e-11	True	"""Any process that results in a change in state or activity of a cell (in terms of movement, secretion, enzyme production, gene expression, etc.) as a result of a stimulus indicating the organism is under stress. The stress is usually, but not necessarily, exogenous (e.g. temperature, humidity, ionizing radiation)."" [GOC:mah]"	1893	97	38	17376	0.3917525773195876	0.0200739566825145	query_1	['GO:0006950', 'GO:0051716']	['PPIF', 'RBBP8', 'PDK4', 'CDK5RAP3', 'NBN', 'HSPA9', 'TP53BP1', 'RAD50', 'UBAC2', 'XRCC6', 'PAXIP1', 'H2AX', 'DDRGK1', 'UFL1', 'MDC1', 'PHB2', 'SDHD', 'BRCA2', 'SUMO1', 'HSPD1', 'RPA1', 'PDK3', 'FLYWCH1', 'BLM', 'MRE11', 'VDAC1', 'RAD51', 'HDAC6', 'PDK1', 'FAF2', 'CBX5', 'BRCA1', 'MICU1', 'PDK2', 'TRIM28', 'BARD1', 'UBA5', 'UFM1']
82	GO:BP	GO:0055086	nucleobase-containing small molecule metabolic process	3.1152766823490725e-11	True	"""The cellular chemical reactions and pathways involving a nucleobase-containing small molecule: a nucleobase, a nucleoside, or a nucleotide."" [GOC:vw]"	568	97	22	17376	0.2268041237113402	0.0387323943661971	query_1	['GO:0006139', 'GO:0044281']	['PDK4', 'ADSL', 'DLST', 'TALDO1', 'DLAT', 'PDHA2', 'PDHX', 'PDHB', 'SDHD', 'PDHA1', 'PDK3', 'GPD1', 'PDK1', 'SDHB', 'NDUFAB1', 'SDHA', 'SDHC', 'DLD', 'PDK2', 'NDUFV3', 'MFN1', 'OGDH']
83	GO:CC	GO:0045239	tricarboxylic acid cycle enzyme complex	3.924301881126097e-11	True	"""Any of the heteromeric enzymes that act in the TCA cycle."" [GOC:mah]"	17	97	7	17376	0.0721649484536082	0.4117647058823529	query_1	['GO:0005737', 'GO:1902494']	['DLST', 'DBT', 'BCKDK', 'BCKDHB', 'DLD', 'OGDH', 'BCKDHA']
84	GO:BP	GO:0110025	DNA strand resection involved in replication fork processing	4.483367903451437e-11	True	"""The 5' to 3' exonucleolytic resection of DNA at the site of a stalled replication fork that contributes to replication fork processing."" [GOC:mah, PMID:28475874]"	8	97	6	17376	0.0618556701030927	0.75	query_1	['GO:0006259', 'GO:0031297']	['RBBP8', 'NBN', 'RAD50', 'MRE11', 'BRCA1', 'BARD1']
85	REAC	REAC:R-HSA-5693571	Nonhomologous End-Joining (NHEJ)	4.9772388999581184e-11	True	Nonhomologous End-Joining (NHEJ)	68	97	10	17376	0.1030927835051546	0.1470588235294117	query_1	['REAC:R-HSA-5693532']	['NBN', 'TP53BP1', 'RAD50', 'XRCC6', 'PAXIP1', 'H2AX', 'MDC1', 'MRE11', 'BRCA1', 'BARD1']
86	REAC	REAC:R-HSA-5685942	HDR through Homologous Recombination (HRR)	4.9772388999581184e-11	True	HDR through Homologous Recombination (HRR)	68	97	10	17376	0.1030927835051546	0.1470588235294117	query_1	['REAC:R-HSA-5693567']	['RBBP8', 'NBN', 'RAD50', 'BRCA2', 'RPA1', 'BLM', 'MRE11', 'RAD51', 'BRCA1', 'BARD1']
87	REAC	REAC:R-HSA-69473	G2/M DNA damage checkpoint	5.1172104834925365e-11	True	G2/M DNA damage checkpoint	94	97	11	17376	0.1134020618556701	0.1170212765957446	query_1	['REAC:R-HSA-69481']	['RBBP8', 'NBN', 'TP53BP1', 'RAD50', 'H2AX', 'MDC1', 'RPA1', 'BLM', 'MRE11', 'BRCA1', 'BARD1']
88	GO:CC	GO:1990246	uniplex complex	7.230028536821374e-11	True	"""A calcium channel complex in the mitochondrial inner membrane capable of highly-selective calcium channel activity. Its components include the EF-hand-containing proteins mitochondrial calcium uptake 1 (MICU1) and MICU2, the pore-forming subunit mitochondrial calcium uniporter (MCU) and its paralog MCUb, and the MCU regulator EMRE."" [PMID:24231807]"	5	97	5	17376	0.0515463917525773	1.0	query_1	['GO:0034704', 'GO:0098800']	['MCUB', 'MCU', 'MICU1', 'SMDT1', 'MICU2']
89	GO:BP	GO:0033865	nucleoside bisphosphate metabolic process	9.107576011374393e-11	True	"""The chemical reactions and pathways involving a nucleoside bisphosphate, a compound consisting of a nucleobase linked to a deoxyribose or ribose sugar esterified with one phosphate group attached to each of two different hydroxyl groups on the sugar."" [GOC:mah, GOC:pde]"	114	97	12	17376	0.1237113402061855	0.1052631578947368	query_1	['GO:0006753']	['PDK4', 'DLST', 'DLAT', 'PDHA2', 'PDHX', 'PDHB', 'PDHA1', 'PDK3', 'PDK1', 'DLD', 'PDK2', 'OGDH']
90	GO:BP	GO:0033875	ribonucleoside bisphosphate metabolic process	9.107576011374393e-11	True	"""The chemical reactions and pathways involving a ribonucleoside bisphosphate, a compound consisting of a nucleobase linked to a ribose sugar esterified with one phosphate group attached to each of two different hydroxyl groups on the sugar."" [GOC:mah, GOC:pde]"	114	97	12	17376	0.1237113402061855	0.1052631578947368	query_1	['GO:0033865']	['PDK4', 'DLST', 'DLAT', 'PDHA2', 'PDHX', 'PDHB', 'PDHA1', 'PDK3', 'PDK1', 'DLD', 'PDK2', 'OGDH']
91	GO:BP	GO:0034032	purine nucleoside bisphosphate metabolic process	9.107576011374393e-11	True	"""The chemical reactions and pathways involving a purine nucleoside bisphosphate, a compound consisting of a purine base linked to a deoxyribose or ribose sugar esterified with one phosphate group attached to each of two different hydroxyl groups on the sugar."" [GOC:mah, GOC:pde]"	114	97	12	17376	0.1237113402061855	0.1052631578947368	query_1	['GO:0033865', 'GO:0072521']	['PDK4', 'DLST', 'DLAT', 'PDHA2', 'PDHX', 'PDHB', 'PDHA1', 'PDK3', 'PDK1', 'DLD', 'PDK2', 'OGDH']
92	GO:CC	GO:0031975	envelope	9.35736565895238e-11	True	"""A multilayered structure surrounding all or part of a cell; encompasses one or more lipid bilayers, and may include a cell wall layer; also includes the space between layers."" [GOC:mah, GOC:pz]"	1199	97	29	17376	0.2989690721649484	0.0241868223519599	query_1	['GO:0110165']	['PPIF', 'UBE2I', 'SPG7', 'MAIP1', 'OTC', 'HSPA9', 'MCUB', 'PMPCA', 'PHB2', 'SDHD', 'MCU', 'SUMO1', 'HSPD1', 'VDAC1', 'AFG3L2', 'SDHB', 'CBX5', 'NDUFAB1', 'SDHA', 'MICU1', 'SMDT1', 'SDHC', 'NDUFV3', 'MICU2', 'MFN1', 'ABHD6', 'PMPCB', 'OGDH', 'PHB1']
93	GO:CC	GO:0031967	organelle envelope	9.35736565895238e-11	True	"""A double membrane structure enclosing an organelle, including two lipid bilayers and the region between them. In some cases, an organelle envelope may have more than two membranes."" [GOC:mah, GOC:pz]"	1199	97	29	17376	0.2989690721649484	0.0241868223519599	query_1	['GO:0031975', 'GO:0043227', 'GO:0043229']	['PPIF', 'UBE2I', 'SPG7', 'MAIP1', 'OTC', 'HSPA9', 'MCUB', 'PMPCA', 'PHB2', 'SDHD', 'MCU', 'SUMO1', 'HSPD1', 'VDAC1', 'AFG3L2', 'SDHB', 'CBX5', 'NDUFAB1', 'SDHA', 'MICU1', 'SMDT1', 'SDHC', 'NDUFV3', 'MICU2', 'MFN1', 'ABHD6', 'PMPCB', 'OGDH', 'PHB1']
94	GO:BP	GO:0015980	energy derivation by oxidation of organic compounds	1.376911259963691e-10	True	"""The chemical reactions and pathways by which a cell derives energy from organic compounds; results in the oxidation of the compounds from which energy is released."" [GOC:mah]"	323	97	17	17376	0.1752577319587628	0.0526315789473684	query_1	['GO:0006091']	['PPIF', 'ADSL', 'DLST', 'DLAT', 'PDHA2', 'PDHB', 'SDHD', 'PDHA1', 'ISCU', 'GPD1', 'SDHB', 'NDUFAB1', 'SDHA', 'SDHC', 'DLD', 'NDUFV3', 'OGDH']
95	GO:BP	GO:0006091	generation of precursor metabolites and energy	1.376911259963691e-10	True	"""The chemical reactions and pathways resulting in the formation of precursor metabolites, substances from which energy is derived, and any process involved in the liberation of energy from these substances."" [GOC:jl]"	431	97	19	17376	0.1958762886597938	0.0440835266821345	query_1	['GO:0044237']	['PPIF', 'ADSL', 'DLST', 'TALDO1', 'DLAT', 'PDHA2', 'PDHB', 'PHB2', 'SDHD', 'PDHA1', 'ISCU', 'GPD1', 'SDHB', 'NDUFAB1', 'SDHA', 'SDHC', 'DLD', 'NDUFV3', 'OGDH']
96	GO:CC	GO:0043231	intracellular membrane-bounded organelle	1.6047681066106768e-10	True	"""Organized structure of distinctive morphology and function, bounded by a single or double lipid bilayer membrane and occurring within the cell. Includes the nucleus, mitochondria, plastids, vacuoles, and vesicles. Excludes the plasma membrane."" [GOC:go_curators]"	11246	97	91	17376	0.9381443298969072	0.0080917659612306	query_1	['GO:0043227', 'GO:0043229']	['PPIF', 'RBBP8', 'SNX6', 'UBE2I', 'PDK4', 'GCSH', 'SPG7', 'PPM1K', 'SNX1', 'LYRM4', 'MAIP1', 'CDK5RAP3', 'NBN', 'OTC', 'ATF7IP', 'DLST', 'HSPA9', 'MCUB', 'TP53BP1', 'RAD50', 'ZNF45', 'UBAC2', 'ZNF350', 'XRCC6', 'TALDO1', 'PAXIP1', 'DLAT', 'PDHA2', 'PDHX', 'SETDB2', 'PDHB', 'H2AX', 'DDRGK1', 'UFL1', 'MDC1', 'PMPCA', 'PHB2', 'MCAT', 'METTL21C', 'SDHD', 'DBT', 'BRCA2', 'MCU', 'SIL1', 'SETDB1', 'BCKDK', 'CDNF', 'BCKDHB', 'PDHA1', 'SUMO1', 'HSPD1', 'RPA1', 'PDK3', 'ARL14EP', 'FLYWCH1', 'BLM', 'PIAS1', 'MRE11', 'VDAC1', 'RAD51', 'AFG3L2', 'HDAC6', 'ISCU', 'PDK1', 'SDHB', 'FAF2', 'NFS1', 'CBX5', 'NDUFAB1', 'BRCA1', 'SDHA', 'MICU1', 'STAT5A', 'SMDT1', 'SDHC', 'DLD', 'PDK2', 'MBD1', 'NDUFV3', 'TRIM28', 'BARD1', 'MICU2', 'MFN1', 'ABHD6', 'PMPCB', 'UBA5', 'OGDH', 'PHB1', 'UFM1', 'STAT5B', 'BCKDHA']
97	REAC	REAC:R-HSA-5693565	Recruitment and ATM-mediated phosphorylation of repair and signaling proteins at DNA double strand breaks	1.6448045146091415e-10	True	Recruitment and ATM-mediated phosphorylation of repair and signaling proteins at DNA double strand breaks	77	97	10	17376	0.1030927835051546	0.1298701298701298	query_1	['REAC:R-HSA-5693606']	['UBE2I', 'NBN', 'TP53BP1', 'RAD50', 'H2AX', 'MDC1', 'SUMO1', 'MRE11', 'BRCA1', 'BARD1']
98	REAC	REAC:R-HSA-71403	Citric acid cycle (TCA cycle)	1.6448045146091415e-10	True	Citric acid cycle (TCA cycle)	21	97	7	17376	0.0721649484536082	0.3333333333333333	query_1	['REAC:R-HSA-71406']	['DLST', 'SDHD', 'SDHB', 'SDHA', 'SDHC', 'DLD', 'OGDH']
99	GO:BP	GO:0044281	small molecule metabolic process	1.6911087115973102e-10	True	"""The chemical reactions and pathways involving small molecules, any low molecular weight, monomeric, non-encoded molecule."" [GOC:curators, GOC:pde, GOC:vw]"	1718	97	35	17376	0.3608247422680412	0.0203725261932479	query_1	['GO:0008152']	['PDK4', 'GCSH', 'ADSL', 'OTC', 'DLST', 'TALDO1', 'DLAT', 'PDHA2', 'PDHX', 'PDHB', 'MCAT', 'SDHD', 'DBT', 'BCKDK', 'BCKDHB', 'PDHA1', 'PDK3', 'VDAC1', 'GPD1', 'PDK1', 'SDHB', 'NDUFAB1', 'BRCA1', 'SDHA', 'STAT5A', 'SDHC', 'DLD', 'PDK2', 'NDUFV3', 'MFN1', 'ABHD6', 'PEPD', 'OGDH', 'STAT5B', 'BCKDHA']
100	GO:BP	GO:0031297	replication fork processing	1.7655930702498088e-10	True	"""The process in which a DNA replication fork that has stalled is restored to a functional state and replication is restarted. The stalling may be due to DNA damage, DNA secondary structure, bound proteins, dNTP shortage, or other causes."" [GOC:vw, PMID:11459955, PMID:15367656, PMID:17660542]"	46	97	9	17376	0.0927835051546391	0.1956521739130435	query_1	['GO:0045005']	['RBBP8', 'NBN', 'RAD50', 'BRCA2', 'BLM', 'MRE11', 'RAD51', 'BRCA1', 'BARD1']
101	REAC	REAC:R-HSA-5693606	DNA Double Strand Break Response	1.8157487191856662e-10	True	DNA Double Strand Break Response	78	97	10	17376	0.1030927835051546	0.1282051282051282	query_1	['REAC:R-HSA-5693532']	['UBE2I', 'NBN', 'TP53BP1', 'RAD50', 'H2AX', 'MDC1', 'SUMO1', 'MRE11', 'BRCA1', 'BARD1']
102	GO:BP	GO:0019637	organophosphate metabolic process	1.8428579752241578e-10	True	"""The chemical reactions and pathways involving organophosphates, any phosphate-containing organic compound."" [ISBN:0198506732]"	920	97	26	17376	0.268041237113402	0.0282608695652173	query_1	['GO:0006793', 'GO:0071704']	['PDK4', 'ADSL', 'DLST', 'TALDO1', 'DLAT', 'PDHA2', 'PDHX', 'PDHB', 'PHB2', 'SDHD', 'PDHA1', 'PDK3', 'MOCS3', 'GPD1', 'PDK1', 'SDHB', 'NFS1', 'NDUFAB1', 'SDHA', 'SDHC', 'DLD', 'PDK2', 'NDUFV3', 'MFN1', 'ABHD6', 'OGDH']
103	GO:CC	GO:0005947	mitochondrial alpha-ketoglutarate dehydrogenase complex	3.5990594532641124e-10	True	"""Mitochondrial complex that possesses alpha-ketoglutarate dehydrogenase activity."" [GOC:mah, GOC:mtg_sensu]"	6	97	5	17376	0.0515463917525773	0.8333333333333334	query_1	['GO:0030062', 'GO:0045240']	['DBT', 'BCKDK', 'BCKDHB', 'DLD', 'BCKDHA']
104	REAC	REAC:R-HSA-912446	Meiotic recombination	3.748911022339328e-10	True	Meiotic recombination	84	97	10	17376	0.1030927835051546	0.119047619047619	query_1	['REAC:R-HSA-1500620']	['RBBP8', 'NBN', 'RAD50', 'H2AX', 'BRCA2', 'RPA1', 'BLM', 'MRE11', 'RAD51', 'BRCA1']
105	REAC	REAC:R-HSA-1500620	Meiosis	3.748911022339328e-10	True	Meiosis	114	97	11	17376	0.1134020618556701	0.0964912280701754	query_1	['REAC:R-HSA-1474165', 'REAC:R-HSA-1640170']	['RBBP8', 'UBE2I', 'NBN', 'RAD50', 'H2AX', 'BRCA2', 'RPA1', 'BLM', 'MRE11', 'RAD51', 'BRCA1']
106	GO:BP	GO:0044237	cellular metabolic process	3.9844843831507376e-10	True	"""The chemical reactions and pathways by which individual cells transform chemical substances."" [GOC:go_curators]"	8316	97	79	17376	0.8144329896907216	0.0094997594997595	query_1	['GO:0008152', 'GO:0009987']	['PPIF', 'RBBP8', 'SNX6', 'UBE2I', 'PDK4', 'GCSH', 'PPM1K', 'LYRM4', 'ADSL', 'CDK5RAP3', 'NBN', 'OTC', 'ATF7IP', 'DLST', 'HSPA9', 'TP53BP1', 'RAD50', 'ZNF45', 'ZNF350', 'XRCC6', 'TALDO1', 'PAXIP1', 'DLAT', 'PDHA2', 'PDHX', 'SETDB2', 'PDHB', 'H2AX', 'DDRGK1', 'UFL1', 'MDC1', 'PHB2', 'MCAT', 'SDHD', 'DBT', 'BRCA2', 'SETDB1', 'BCKDK', 'BCKDHB', 'PDHA1', 'SUMO1', 'HSPD1', 'RPA1', 'PDK3', 'FLYWCH1', 'BLM', 'PIAS1', 'MRE11', 'VDAC1', 'RAD51', 'HDAC6', 'MOCS3', 'ISCU', 'GPD1', 'PDK1', 'NSUN6', 'SDHB', 'NFS1', 'CBX5', 'NDUFAB1', 'BRCA1', 'SDHA', 'STAT5A', 'SDHC', 'DLD', 'PDK2', 'MBD1', 'NDUFV3', 'TRIM28', 'BARD1', 'MFN1', 'ABHD6', 'PEPD', 'UBA5', 'OGDH', 'PHB1', 'UFM1', 'STAT5B', 'BCKDHA']
107	GO:BP	GO:0045005	DNA-templated DNA replication maintenance of fidelity	6.448452854574249e-10	True	"""A DNA metabolic process that prevents or corrects errors to ensure that DNA is replicated accurately. Errors can be corrected either by intrinsic DNA polymerase proofreading activity or via mismatch repair."" [GOC:mah, GOC:vw]"	53	97	9	17376	0.0927835051546391	0.1698113207547169	query_1	['GO:0006259', 'GO:0006261']	['RBBP8', 'NBN', 'RAD50', 'BRCA2', 'BLM', 'MRE11', 'RAD51', 'BRCA1', 'BARD1']
108	GO:BP	GO:0006139	nucleobase-containing compound metabolic process	8.544087177320951e-10	True	"""Any cellular metabolic process involving nucleobases, nucleosides, nucleotides and nucleic acids."" [GOC:ai]"	5202	97	61	17376	0.6288659793814433	0.0117262591311034	query_1	['GO:0006725', 'GO:0034641', 'GO:0044238', 'GO:0046483', 'GO:1901360']	['RBBP8', 'SNX6', 'UBE2I', 'PDK4', 'ADSL', 'CDK5RAP3', 'NBN', 'ATF7IP', 'DLST', 'TP53BP1', 'RAD50', 'ZNF45', 'ZNF350', 'XRCC6', 'TALDO1', 'PAXIP1', 'DLAT', 'PDHA2', 'PDHX', 'SETDB2', 'PDHB', 'H2AX', 'DDRGK1', 'UFL1', 'MDC1', 'PHB2', 'SDHD', 'BRCA2', 'SETDB1', 'PDHA1', 'SUMO1', 'HSPD1', 'RPA1', 'PDK3', 'FLYWCH1', 'BLM', 'PIAS1', 'MRE11', 'RAD51', 'HDAC6', 'MOCS3', 'GPD1', 'PDK1', 'NSUN6', 'SDHB', 'CBX5', 'NDUFAB1', 'BRCA1', 'SDHA', 'STAT5A', 'SDHC', 'DLD', 'PDK2', 'MBD1', 'NDUFV3', 'TRIM28', 'BARD1', 'MFN1', 'OGDH', 'PHB1', 'STAT5B']
109	GO:BP	GO:0046483	heterocycle metabolic process	8.544087177320951e-10	True	"""The chemical reactions and pathways involving heterocyclic compounds, those with a cyclic molecular structure and at least two different atoms in the ring (or rings)."" [ISBN:0198506732]"	5358	97	62	17376	0.6391752577319587	0.0115714818962299	query_1	['GO:0044237']	['RBBP8', 'SNX6', 'UBE2I', 'PDK4', 'ADSL', 'CDK5RAP3', 'NBN', 'ATF7IP', 'DLST', 'TP53BP1', 'RAD50', 'ZNF45', 'ZNF350', 'XRCC6', 'TALDO1', 'PAXIP1', 'DLAT', 'PDHA2', 'PDHX', 'SETDB2', 'PDHB', 'H2AX', 'DDRGK1', 'UFL1', 'MDC1', 'PHB2', 'SDHD', 'BRCA2', 'SETDB1', 'PDHA1', 'SUMO1', 'HSPD1', 'RPA1', 'PDK3', 'FLYWCH1', 'BLM', 'PIAS1', 'MRE11', 'RAD51', 'HDAC6', 'MOCS3', 'GPD1', 'PDK1', 'NSUN6', 'SDHB', 'NFS1', 'CBX5', 'NDUFAB1', 'BRCA1', 'SDHA', 'STAT5A', 'SDHC', 'DLD', 'PDK2', 'MBD1', 'NDUFV3', 'TRIM28', 'BARD1', 'MFN1', 'OGDH', 'PHB1', 'STAT5B']
110	REAC	REAC:R-HSA-71291	Metabolism of amino acids and derivatives	1.1065785752965158e-09	True	Metabolism of amino acids and derivatives	354	97	16	17376	0.1649484536082474	0.0451977401129943	query_1	['REAC:R-HSA-1430728']	['GCSH', 'PPM1K', 'OTC', 'DLST', 'DLAT', 'PDHA2', 'PDHX', 'PDHB', 'DBT', 'BCKDK', 'BCKDHB', 'PDHA1', 'NDUFAB1', 'DLD', 'OGDH', 'BCKDHA']
111	GO:BP	GO:0071569	protein ufmylation	1.3578009670263494e-09	True	"""Covalent attachment of the ubiquitin-like protein UFM1 to another protein."" [GOC:vw, PMID:20018847]"	6	97	5	17376	0.0515463917525773	0.8333333333333334	query_1	['GO:0032446']	['CDK5RAP3', 'DDRGK1', 'UFL1', 'UBA5', 'UFM1']
112	GO:BP	GO:0006807	nitrogen compound metabolic process	1.3628699645352155e-09	True	"""The chemical reactions and pathways involving organic or inorganic compounds that contain nitrogen."" [GOC:jl, ISBN:0198506732]"	8916	97	81	17376	0.8350515463917526	0.0090847913862718	query_1	['GO:0008152']	['PPIF', 'RBBP8', 'SNX6', 'UBE2I', 'PDK4', 'GCSH', 'SPG7', 'PPM1K', 'SNX1', 'ADSL', 'CDK5RAP3', 'NBN', 'OTC', 'ATF7IP', 'DLST', 'TP53BP1', 'RAD50', 'ZNF45', 'UBAC2', 'ZNF350', 'XRCC6', 'TALDO1', 'PAXIP1', 'DLAT', 'PDHA2', 'PDHX', 'SETDB2', 'PDHB', 'H2AX', 'DDRGK1', 'UFL1', 'MDC1', 'PMPCA', 'PHB2', 'METTL21C', 'SDHD', 'DBT', 'BRCA2', 'SETDB1', 'BCKDK', 'BCKDHB', 'PDHA1', 'SUMO1', 'HSPD1', 'RPA1', 'PDK3', 'FLYWCH1', 'BLM', 'PIAS1', 'MRE11', 'RAD51', 'AFG3L2', 'HDAC6', 'MOCS3', 'GPD1', 'PDK1', 'NSUN6', 'SDHB', 'FAF2', 'NFS1', 'CBX5', 'NDUFAB1', 'BRCA1', 'SDHA', 'STAT5A', 'SDHC', 'DLD', 'PDK2', 'MBD1', 'NDUFV3', 'TRIM28', 'BARD1', 'MFN1', 'PEPD', 'PMPCB', 'UBA5', 'OGDH', 'PHB1', 'UFM1', 'STAT5B', 'BCKDHA']
113	GO:BP	GO:0051560	mitochondrial calcium ion homeostasis	1.383494588766762e-09	True	"""Any process involved in the maintenance of an internal steady state of calcium ions within the cytoplasm of a cell or between mitochondria and their surroundings."" [GOC:ai, GOC:mah]"	23	97	7	17376	0.0721649484536082	0.3043478260869565	query_1	['GO:0006874']	['MAIP1', 'MCUB', 'MCU', 'AFG3L2', 'MICU1', 'SMDT1', 'MICU2']
114	GO:CC	GO:0043227	membrane-bounded organelle	1.5959211719486655e-09	True	"""Organized structure of distinctive morphology and function, bounded by a single or double lipid bilayer membrane. Includes the nucleus, mitochondria, plastids, vacuoles, and vesicles. Excludes the plasma membrane."" [GOC:go_curators]"	12190	97	93	17376	0.9587628865979382	0.0076292042657916	query_1	['GO:0043226']	['PPIF', 'RBBP8', 'SNX6', 'UBE2I', 'PDK4', 'GCSH', 'SPG7', 'PPM1K', 'SNX1', 'LYRM4', 'MAIP1', 'CDK5RAP3', 'NBN', 'OTC', 'ATF7IP', 'DLST', 'HSPA9', 'MCUB', 'TP53BP1', 'RAD50', 'ZNF45', 'UBAC2', 'ZNF350', 'XRCC6', 'TALDO1', 'PAXIP1', 'DLAT', 'PDHA2', 'PDHX', 'SETDB2', 'PDHB', 'H2AX', 'DDRGK1', 'UFL1', 'MDC1', 'PMPCA', 'PHB2', 'MCAT', 'METTL21C', 'SDHD', 'DBT', 'BRCA2', 'MCU', 'SIL1', 'SETDB1', 'BCKDK', 'CDNF', 'BCKDHB', 'PDHA1', 'SUMO1', 'HSPD1', 'RPA1', 'PDK3', 'ARL14EP', 'FLYWCH1', 'BLM', 'PIAS1', 'MRE11', 'VDAC1', 'RAD51', 'AFG3L2', 'HDAC6', 'ISCU', 'GPD1', 'PDK1', 'SDHB', 'FAF2', 'NFS1', 'CBX5', 'NDUFAB1', 'BRCA1', 'SDHA', 'MICU1', 'STAT5A', 'SMDT1', 'SDHC', 'DLD', 'PDK2', 'MBD1', 'NDUFV3', 'TRIM28', 'BARD1', 'MICU2', 'MFN1', 'ABHD6', 'PEPD', 'PMPCB', 'UBA5', 'OGDH', 'PHB1', 'UFM1', 'STAT5B', 'BCKDHA']
115	REAC	REAC:R-HSA-3108232	SUMO E3 ligases SUMOylate target proteins	1.7441834209123616e-09	True	SUMO E3 ligases SUMOylate target proteins	170	97	12	17376	0.1237113402061855	0.0705882352941176	query_1	['REAC:R-HSA-2990846']	['UBE2I', 'TP53BP1', 'ZNF350', 'MDC1', 'SUMO1', 'RPA1', 'BLM', 'PIAS1', 'CBX5', 'BRCA1', 'MBD1', 'TRIM28']
116	GO:BP	GO:0000075	cell cycle checkpoint signaling	2.0753182872893182e-09	True	"""A signaling process that controls cell cycle progression by monitoring the integrity of specific cell cycle events. A cell cycle checkpoint begins with detection of deficiencies or defects and ends with signal transduction."" [GOC:mtg_cell_cycle]"	191	97	13	17376	0.134020618556701	0.0680628272251308	query_1	['GO:0035556', 'GO:1901988']	['RBBP8', 'CDK5RAP3', 'NBN', 'TP53BP1', 'RAD50', 'H2AX', 'MDC1', 'BRCA2', 'BLM', 'MRE11', 'RAD51', 'BRCA1', 'BARD1']
117	GO:BP	GO:0044238	primary metabolic process	2.1127036989637754e-09	True	"""The chemical reactions and pathways involving those compounds which are formed as a part of the normal anabolic and catabolic processes. These processes take place in most, if not all, cells of the organism."" [GOC:go_curators, http://www.metacyc.org]"	9425	97	83	17376	0.8556701030927835	0.0088063660477453	query_1	['GO:0008152']	['PPIF', 'RBBP8', 'SNX6', 'UBE2I', 'PDK4', 'GCSH', 'SPG7', 'PPM1K', 'SNX1', 'ADSL', 'CDK5RAP3', 'NBN', 'OTC', 'ATF7IP', 'DLST', 'TP53BP1', 'RAD50', 'ZNF45', 'UBAC2', 'ZNF350', 'XRCC6', 'TALDO1', 'PAXIP1', 'DLAT', 'PDHA2', 'PDHX', 'SETDB2', 'PDHB', 'H2AX', 'DDRGK1', 'UFL1', 'MDC1', 'PMPCA', 'PHB2', 'MCAT', 'METTL21C', 'SDHD', 'DBT', 'BRCA2', 'SETDB1', 'BCKDK', 'BCKDHB', 'PDHA1', 'SUMO1', 'HSPD1', 'RPA1', 'PDK3', 'FLYWCH1', 'BLM', 'PIAS1', 'MRE11', 'RAD51', 'AFG3L2', 'HDAC6', 'MOCS3', 'GPD1', 'PDK1', 'NSUN6', 'SDHB', 'FAF2', 'NFS1', 'CBX5', 'NDUFAB1', 'BRCA1', 'SDHA', 'STAT5A', 'SDHC', 'DLD', 'PDK2', 'MBD1', 'NDUFV3', 'TRIM28', 'BARD1', 'MFN1', 'ABHD6', 'PEPD', 'PMPCB', 'UBA5', 'OGDH', 'PHB1', 'UFM1', 'STAT5B', 'BCKDHA']
118	REAC	REAC:R-HSA-2990846	SUMOylation	2.379851146549935e-09	True	SUMOylation	175	97	12	17376	0.1237113402061855	0.0685714285714285	query_1	['REAC:R-HSA-597592']	['UBE2I', 'TP53BP1', 'ZNF350', 'MDC1', 'SUMO1', 'RPA1', 'BLM', 'PIAS1', 'CBX5', 'BRCA1', 'MBD1', 'TRIM28']
119	GO:BP	GO:0008152	metabolic process	2.469345913332856e-09	True	"""The chemical reactions and pathways, including anabolism and catabolism, by which living organisms transform chemical substances. Metabolic processes typically transform small molecules, but also include macromolecular processes such as DNA repair and replication, and protein synthesis and degradation."" [GOC:go_curators, ISBN:0198547684]"	10396	97	87	17376	0.8969072164948454	0.0083686033089649	query_1	['GO:0008150']	['PPIF', 'RBBP8', 'SNX6', 'UBE2I', 'PDK4', 'GCSH', 'SPG7', 'PPM1K', 'SNX1', 'LYRM4', 'ADSL', 'CDK5RAP3', 'NBN', 'OTC', 'ATF7IP', 'DLST', 'HSPA9', 'TP53BP1', 'RAD50', 'ZNF45', 'UBAC2', 'ZNF350', 'XRCC6', 'TALDO1', 'PAXIP1', 'DLAT', 'PDHA2', 'PDHX', 'SETDB2', 'PDHB', 'H2AX', 'DDRGK1', 'UFL1', 'MDC1', 'PMPCA', 'PHB2', 'MCAT', 'METTL21C', 'SDHD', 'DBT', 'BRCA2', 'SETDB1', 'BCKDK', 'BCKDHB', 'PDHA1', 'SUMO1', 'HSPD1', 'RPA1', 'PDK3', 'FLYWCH1', 'BLM', 'PIAS1', 'MRE11', 'VDAC1', 'RAD51', 'AFG3L2', 'HDAC6', 'MOCS3', 'ISCU', 'GPD1', 'PDK1', 'NSUN6', 'SDHB', 'FAF2', 'NFS1', 'CBX5', 'NDUFAB1', 'BRCA1', 'SDHA', 'STAT5A', 'SDHC', 'DLD', 'PDK2', 'MBD1', 'NDUFV3', 'TRIM28', 'BARD1', 'MFN1', 'ABHD6', 'PEPD', 'PMPCB', 'UBA5', 'OGDH', 'PHB1', 'UFM1', 'STAT5B', 'BCKDHA']
120	REAC	REAC:R-HSA-1474165	Reproduction	2.9226339871968794e-09	True	Reproduction	139	97	11	17376	0.1134020618556701	0.079136690647482	query_1	['REAC:0000000']	['RBBP8', 'UBE2I', 'NBN', 'RAD50', 'H2AX', 'BRCA2', 'RPA1', 'BLM', 'MRE11', 'RAD51', 'BRCA1']
121	GO:CC	GO:0090734	site of DNA damage	3.527400302191223e-09	True	"""A region of a chromosome at which DNA damage has occurred. DNA damage signaling and repair proteins accumulate at the lesion to respond to the damage and repair the DNA to form a continuous DNA helix."" [GOC:pg]"	104	97	10	17376	0.1030927835051546	0.0961538461538461	query_1	['GO:0005694', 'GO:0110165']	['RBBP8', 'NBN', 'TP53BP1', 'RAD50', 'H2AX', 'UFL1', 'RPA1', 'MRE11', 'RAD51', 'CBX5']
122	GO:BP	GO:0006796	phosphate-containing compound metabolic process	3.541338192722189e-09	True	"""The chemical reactions and pathways involving the phosphate group, the anion or salt of any phosphoric acid."" [GOC:ai]"	2608	97	41	17376	0.422680412371134	0.0157208588957055	query_1	['GO:0006793']	['SNX6', 'PDK4', 'PPM1K', 'ADSL', 'CDK5RAP3', 'NBN', 'DLST', 'RAD50', 'XRCC6', 'TALDO1', 'DLAT', 'PDHA2', 'PDHX', 'PDHB', 'DDRGK1', 'PHB2', 'SDHD', 'BCKDK', 'PDHA1', 'PDK3', 'BLM', 'MRE11', 'RAD51', 'HDAC6', 'MOCS3', 'GPD1', 'PDK1', 'SDHB', 'NFS1', 'NDUFAB1', 'SDHA', 'SDHC', 'DLD', 'PDK2', 'NDUFV3', 'TRIM28', 'BARD1', 'MFN1', 'ABHD6', 'OGDH', 'PHB1']
123	GO:BP	GO:0018130	heterocycle biosynthetic process	3.6763008432225454e-09	True	"""The chemical reactions and pathways resulting in the formation of heterocyclic compounds, those with a cyclic molecular structure and at least two different atoms in the ring (or rings)."" [ISBN:0198547684]"	3764	97	50	17376	0.5154639175257731	0.0132837407013815	query_1	['GO:0044249', 'GO:0046483']	['RBBP8', 'SNX6', 'UBE2I', 'PDK4', 'ADSL', 'CDK5RAP3', 'ATF7IP', 'TP53BP1', 'RAD50', 'ZNF45', 'ZNF350', 'XRCC6', 'PAXIP1', 'DLAT', 'PDHA2', 'PDHX', 'SETDB2', 'PDHB', 'DDRGK1', 'UFL1', 'PHB2', 'SDHD', 'BRCA2', 'SETDB1', 'PDHA1', 'SUMO1', 'RPA1', 'PDK3', 'FLYWCH1', 'BLM', 'PIAS1', 'MRE11', 'HDAC6', 'MOCS3', 'PDK1', 'SDHB', 'NFS1', 'CBX5', 'NDUFAB1', 'BRCA1', 'SDHA', 'STAT5A', 'SDHC', 'DLD', 'PDK2', 'MBD1', 'NDUFV3', 'TRIM28', 'PHB1', 'STAT5B']
124	REAC	REAC:0000000	REACTOME root term	3.7447118479411505e-09	True	REACTOME root term	9962	97	84	17376	0.865979381443299	0.0084320417586829	query_1	[]	['RBBP8', 'UBE2I', 'PDK4', 'GCSH', 'SPG7', 'PPM1K', 'LYRM4', 'ADSL', 'MAIP1', 'NBN', 'OTC', 'ATF7IP', 'DLST', 'HSPA9', 'MCUB', 'TP53BP1', 'RAD50', 'ZNF45', 'ZNF350', 'XRCC6', 'TALDO1', 'PAXIP1', 'DLAT', 'PDHA2', 'PDHX', 'SETDB2', 'PDHB', 'H2AX', 'DDRGK1', 'UFL1', 'MDC1', 'PMPCA', 'PHB2', 'MCAT', 'SDHD', 'DBT', 'BRCA2', 'MCU', 'SETDB1', 'BCKDK', 'BCKDHB', 'PDHA1', 'SUMO1', 'HSPD1', 'RPA1', 'PDK3', 'BLM', 'PIAS1', 'MRE11', 'VDAC1', 'RAD51', 'AFG3L2', 'HDAC6', 'MOCS3', 'ISCU', 'GPD1', 'PDK1', 'NSUN6', 'SDHB', 'FAF2', 'CBX5', 'NDUFAB1', 'BRCA1', 'SDHA', 'MICU1', 'STAT5A', 'SMDT1', 'SDHC', 'DLD', 'PDK2', 'MBD1', 'NDUFV3', 'TRIM28', 'BARD1', 'MICU2', 'MFN1', 'ABHD6', 'PMPCB', 'UBA5', 'OGDH', 'GJA10', 'PHB1', 'STAT5B', 'BCKDHA']
125	GO:BP	GO:0006725	cellular aromatic compound metabolic process	4.002394348092695e-09	True	"""The chemical reactions and pathways involving aromatic compounds, any organic compound characterized by one or more planar rings, each of which contains conjugated double bonds and delocalized pi electrons, as carried out by individual cells."" [GOC:ai, ISBN:0198506732]"	5399	97	61	17376	0.6288659793814433	0.0112983885904797	query_1	['GO:0044237']	['RBBP8', 'SNX6', 'UBE2I', 'PDK4', 'ADSL', 'CDK5RAP3', 'NBN', 'ATF7IP', 'DLST', 'TP53BP1', 'RAD50', 'ZNF45', 'ZNF350', 'XRCC6', 'TALDO1', 'PAXIP1', 'DLAT', 'PDHA2', 'PDHX', 'SETDB2', 'PDHB', 'H2AX', 'DDRGK1', 'UFL1', 'MDC1', 'PHB2', 'SDHD', 'BRCA2', 'SETDB1', 'PDHA1', 'SUMO1', 'HSPD1', 'RPA1', 'PDK3', 'FLYWCH1', 'BLM', 'PIAS1', 'MRE11', 'RAD51', 'HDAC6', 'MOCS3', 'GPD1', 'PDK1', 'NSUN6', 'SDHB', 'CBX5', 'NDUFAB1', 'BRCA1', 'SDHA', 'STAT5A', 'SDHC', 'DLD', 'PDK2', 'MBD1', 'NDUFV3', 'TRIM28', 'BARD1', 'MFN1', 'OGDH', 'PHB1', 'STAT5B']
126	GO:BP	GO:0006793	phosphorus metabolic process	4.49816613232886e-09	True	"""The chemical reactions and pathways involving the nonmetallic element phosphorus or compounds that contain phosphorus, usually in the form of a phosphate group (PO4)."" [GOC:ai]"	2632	97	41	17376	0.422680412371134	0.0155775075987841	query_1	['GO:0044237']	['SNX6', 'PDK4', 'PPM1K', 'ADSL', 'CDK5RAP3', 'NBN', 'DLST', 'RAD50', 'XRCC6', 'TALDO1', 'DLAT', 'PDHA2', 'PDHX', 'PDHB', 'DDRGK1', 'PHB2', 'SDHD', 'BCKDK', 'PDHA1', 'PDK3', 'BLM', 'MRE11', 'RAD51', 'HDAC6', 'MOCS3', 'GPD1', 'PDK1', 'SDHB', 'NFS1', 'NDUFAB1', 'SDHA', 'SDHC', 'DLD', 'PDK2', 'NDUFV3', 'TRIM28', 'BARD1', 'MFN1', 'ABHD6', 'OGDH', 'PHB1']
127	GO:BP	GO:0000077	DNA damage checkpoint signaling	4.660548954981966e-09	True	"""A signal transduction process that contributes to a DNA damage checkpoint."" [GOC:mah]"	127	97	11	17376	0.1134020618556701	0.0866141732283464	query_1	['GO:0031570', 'GO:0042770']	['CDK5RAP3', 'NBN', 'TP53BP1', 'H2AX', 'MDC1', 'BRCA2', 'BLM', 'MRE11', 'RAD51', 'BRCA1', 'BARD1']
128	GO:BP	GO:1901360	organic cyclic compound metabolic process	6.518451468535054e-09	True	"""The chemical reactions and pathways involving organic cyclic compound."" [GOC:TermGenie]"	5624	97	62	17376	0.6391752577319587	0.0110241820768136	query_1	['GO:0071704']	['RBBP8', 'SNX6', 'UBE2I', 'PDK4', 'ADSL', 'CDK5RAP3', 'NBN', 'ATF7IP', 'DLST', 'TP53BP1', 'RAD50', 'ZNF45', 'ZNF350', 'XRCC6', 'TALDO1', 'PAXIP1', 'DLAT', 'PDHA2', 'PDHX', 'SETDB2', 'PDHB', 'H2AX', 'DDRGK1', 'UFL1', 'MDC1', 'PHB2', 'SDHD', 'BRCA2', 'SETDB1', 'PDHA1', 'SUMO1', 'HSPD1', 'RPA1', 'PDK3', 'FLYWCH1', 'BLM', 'PIAS1', 'MRE11', 'RAD51', 'HDAC6', 'MOCS3', 'GPD1', 'PDK1', 'NSUN6', 'SDHB', 'NFS1', 'CBX5', 'NDUFAB1', 'BRCA1', 'SDHA', 'STAT5A', 'SDHC', 'DLD', 'PDK2', 'MBD1', 'NDUFV3', 'TRIM28', 'BARD1', 'MFN1', 'OGDH', 'PHB1', 'STAT5B']
129	GO:CC	GO:0045283	fumarate reductase complex	8.713149895363239e-09	True	"""A membrane-bound flavoenzyme complex consisting of four subunits, A, B, C, and D. A and B comprise the membrane-extrinsic catalytic domain and C (InterPro:IPR003510; InterPro:IPR004224) and D (InterPro:IPR003418) link the catalytic centers to the electron-transport chain. This family consists of the 13 kDa hydrophobic subunit D. This component may be required to anchor the catalytic components of the fumarate reductase complex to the cytoplasmic membrane. Fumarate reductase couples the reduction of fumarate to succinate to the oxidation of quinol to quinone, in a reaction opposite to that catalyzed by the related complex II of the respiratory chain (succinate dehydrogenase-(ubiquinone))."" [InterPro:IPR003418, InterPro:IPR004224]"	4	97	4	17376	0.0412371134020618	1.0	query_1	['GO:0045273', 'GO:0098803', 'GO:1902494']	['SDHD', 'SDHB', 'SDHA', 'SDHC']
130	GO:CC	GO:0045273	respiratory chain complex II	8.713149895363239e-09	True	"""A part of the respiratory chain, containing the four polypeptide subunits of succinate dehydrogenase, flavin-adenine dinucleotide and iron-sulfur. Catalyzes the oxidation of succinate by ubiquinone. Connects the TCA cycle with the respiratory chain."" [ISBN:0198547684]"	4	97	4	17376	0.0412371134020618	1.0	query_1	['GO:0098803', 'GO:1902494']	['SDHD', 'SDHB', 'SDHA', 'SDHC']
131	GO:CC	GO:0045257	succinate dehydrogenase complex (ubiquinone)	8.713149895363239e-09	True	"""The enzyme that catalyzes the oxidation of succinate and ubiquinone to fumarate and ubiquinol; involved in aerobic respiration, repressed in anaerobic respiration."" [GOC:kd, ISBN:0198547684]"	4	97	4	17376	0.0412371134020618	1.0	query_1	['GO:0045281']	['SDHD', 'SDHB', 'SDHA', 'SDHC']
132	GO:CC	GO:0045281	succinate dehydrogenase complex	8.713149895363239e-09	True	"""A multimeric complex which consists of flavoprotein (subunit A ; InterPro:IPR003952), iron-sulfur protein (subunit B) and membrane-bound cytochrome b560 (subunit C; InterPro:IPR000701). In some Archaea, the membrane-bound subunits (C or C and D) do not necessarily contain heme. Membrane-bound subunits can bind or react with quinones."" [GOC:kd, InterPro:IPR000701]"	4	97	4	17376	0.0412371134020618	1.0	query_1	['GO:0005622', 'GO:0045273', 'GO:0098803', 'GO:1990204']	['SDHD', 'SDHB', 'SDHA', 'SDHC']
133	GO:CC	GO:0005749	mitochondrial respiratory chain complex II, succinate dehydrogenase complex (ubiquinone)	8.713149895363239e-09	True	"""A protein complex located in the mitochondrial inner membrane that forms part of the mitochondrial respiratory chain. Contains the four polypeptide subunits of succinate dehydrogenase, flavin-adenine dinucleotide and iron-sulfur. Catalyzes the oxidation of succinate by ubiquinone. Connects the TCA cycle with the respiratory chain."" [GOC:mtg_sensu, GOC:vw, ISBN:0198547684]"	4	97	4	17376	0.0412371134020618	1.0	query_1	['GO:0005746', 'GO:0045257', 'GO:0045283', 'GO:0098800']	['SDHD', 'SDHB', 'SDHA', 'SDHC']
134	GO:BP	GO:0031570	DNA integrity checkpoint signaling	8.753675682672385e-09	True	"""A signaling process that controls cell cycle progression in response to changes in DNA structure by monitoring the integrity of the DNA. The DNA integrity checkpoint begins with detection of DNA damage, defects in DNA structure or DNA replication, and progresses through signal transduction and ends with cell cycle effector processes."" [GOC:mtg_cell_cycle]"	135	97	11	17376	0.1134020618556701	0.0814814814814814	query_1	['GO:0000075']	['CDK5RAP3', 'NBN', 'TP53BP1', 'H2AX', 'MDC1', 'BRCA2', 'BLM', 'MRE11', 'RAD51', 'BRCA1', 'BARD1']
135	GO:BP	GO:0006310	DNA recombination	9.653833689259156e-09	True	"""Any process in which a new genotype is formed by reassortment of genes resulting in gene combinations different from those that were present in the parents. In eukaryotes genetic recombination can occur by chromosome assortment, intrachromosomal recombination, or nonreciprocal interchromosomal recombination. Interchromosomal recombination occurs by crossing over. In bacteria it may occur by genetic transformation, conjugation, transduction, or F-duction."" [ISBN:0198506732]"	319	97	15	17376	0.1546391752577319	0.0470219435736677	query_1	['GO:0006259']	['RBBP8', 'NBN', 'TP53BP1', 'RAD50', 'XRCC6', 'PAXIP1', 'H2AX', 'BRCA2', 'HSPD1', 'RPA1', 'BLM', 'MRE11', 'RAD51', 'BRCA1', 'BARD1']
136	GO:BP	GO:0090407	organophosphate biosynthetic process	1.0779620256647596e-08	True	"""The chemical reactions and pathways resulting in the biosynthesis of deoxyribose phosphate, the phosphorylated sugar 2-deoxy-erythro-pentose."" [GOC:chem_mtg]"	569	97	19	17376	0.1958762886597938	0.0333919156414762	query_1	['GO:0019637', 'GO:1901576']	['PDK4', 'ADSL', 'DLAT', 'PDHA2', 'PDHX', 'PDHB', 'SDHD', 'PDHA1', 'PDK3', 'MOCS3', 'PDK1', 'SDHB', 'NFS1', 'NDUFAB1', 'SDHA', 'SDHC', 'DLD', 'PDK2', 'NDUFV3']
137	REAC	REAC:R-HSA-70895	Branched-chain amino acid catabolism	1.1467270861997236e-08	True	Branched-chain amino acid catabolism	21	97	6	17376	0.0618556701030927	0.2857142857142857	query_1	['REAC:R-HSA-71291']	['PPM1K', 'DBT', 'BCKDK', 'BCKDHB', 'DLD', 'BCKDHA']
138	GO:BP	GO:0044818	mitotic G2/M transition checkpoint	1.321405033050576e-08	True	"""A cell cycle checkpoint that detects and negatively regulates progression from G2 to M phase as part of a mitotic cell cycle."" [GOC:mtg_cell_cycle]"	51	97	8	17376	0.0824742268041237	0.1568627450980392	query_1	['GO:0007093', 'GO:0010972']	['RBBP8', 'CDK5RAP3', 'NBN', 'RAD50', 'BLM', 'MRE11', 'BRCA1', 'BARD1']
139	GO:BP	GO:1901362	organic cyclic compound biosynthetic process	1.3471351233488298e-08	True	"""The chemical reactions and pathways resulting in the formation of organic cyclic compound."" [GOC:TermGenie]"	3912	97	50	17376	0.5154639175257731	0.0127811860940695	query_1	['GO:1901360', 'GO:1901576']	['RBBP8', 'SNX6', 'UBE2I', 'PDK4', 'ADSL', 'CDK5RAP3', 'ATF7IP', 'TP53BP1', 'RAD50', 'ZNF45', 'ZNF350', 'XRCC6', 'PAXIP1', 'DLAT', 'PDHA2', 'PDHX', 'SETDB2', 'PDHB', 'DDRGK1', 'UFL1', 'PHB2', 'SDHD', 'BRCA2', 'SETDB1', 'PDHA1', 'SUMO1', 'RPA1', 'PDK3', 'FLYWCH1', 'BLM', 'PIAS1', 'MRE11', 'HDAC6', 'MOCS3', 'PDK1', 'SDHB', 'NFS1', 'CBX5', 'NDUFAB1', 'BRCA1', 'SDHA', 'STAT5A', 'SDHC', 'DLD', 'PDK2', 'MBD1', 'NDUFV3', 'TRIM28', 'PHB1', 'STAT5B']
140	GO:BP	GO:0071704	organic substance metabolic process	1.6048771149780118e-08	True	"""The chemical reactions and pathways involving an organic substance, any molecular entity containing carbon."" [GOC:mah]"	9976	97	84	17376	0.865979381443299	0.0084202085004009	query_1	['GO:0008152']	['PPIF', 'RBBP8', 'SNX6', 'UBE2I', 'PDK4', 'GCSH', 'SPG7', 'PPM1K', 'SNX1', 'ADSL', 'CDK5RAP3', 'NBN', 'OTC', 'ATF7IP', 'DLST', 'TP53BP1', 'RAD50', 'ZNF45', 'UBAC2', 'ZNF350', 'XRCC6', 'TALDO1', 'PAXIP1', 'DLAT', 'PDHA2', 'PDHX', 'SETDB2', 'PDHB', 'H2AX', 'DDRGK1', 'UFL1', 'MDC1', 'PMPCA', 'PHB2', 'MCAT', 'METTL21C', 'SDHD', 'DBT', 'BRCA2', 'SETDB1', 'BCKDK', 'BCKDHB', 'PDHA1', 'SUMO1', 'HSPD1', 'RPA1', 'PDK3', 'FLYWCH1', 'BLM', 'PIAS1', 'MRE11', 'VDAC1', 'RAD51', 'AFG3L2', 'HDAC6', 'MOCS3', 'GPD1', 'PDK1', 'NSUN6', 'SDHB', 'FAF2', 'NFS1', 'CBX5', 'NDUFAB1', 'BRCA1', 'SDHA', 'STAT5A', 'SDHC', 'DLD', 'PDK2', 'MBD1', 'NDUFV3', 'TRIM28', 'BARD1', 'MFN1', 'ABHD6', 'PEPD', 'PMPCB', 'UBA5', 'OGDH', 'PHB1', 'UFM1', 'STAT5B', 'BCKDHA']
141	GO:BP	GO:0034641	cellular nitrogen compound metabolic process	1.641969420427067e-08	True	"""The chemical reactions and pathways involving various organic and inorganic nitrogenous compounds, as carried out by individual cells."" [GOC:mah]"	5752	97	62	17376	0.6391752577319587	0.010778859527121	query_1	['GO:0006807', 'GO:0044237']	['RBBP8', 'SNX6', 'UBE2I', 'PDK4', 'ADSL', 'CDK5RAP3', 'NBN', 'OTC', 'ATF7IP', 'DLST', 'TP53BP1', 'RAD50', 'ZNF45', 'ZNF350', 'XRCC6', 'TALDO1', 'PAXIP1', 'DLAT', 'PDHA2', 'PDHX', 'SETDB2', 'PDHB', 'H2AX', 'DDRGK1', 'UFL1', 'MDC1', 'PHB2', 'SDHD', 'BRCA2', 'SETDB1', 'PDHA1', 'SUMO1', 'HSPD1', 'RPA1', 'PDK3', 'FLYWCH1', 'BLM', 'PIAS1', 'MRE11', 'RAD51', 'HDAC6', 'MOCS3', 'GPD1', 'PDK1', 'NSUN6', 'SDHB', 'CBX5', 'NDUFAB1', 'BRCA1', 'SDHA', 'STAT5A', 'SDHC', 'DLD', 'PDK2', 'MBD1', 'NDUFV3', 'TRIM28', 'BARD1', 'MFN1', 'OGDH', 'PHB1', 'STAT5B']
142	REAC	REAC:R-HSA-69481	G2/M Checkpoints	1.9284810004226803e-08	True	G2/M Checkpoints	167	97	11	17376	0.1134020618556701	0.0658682634730539	query_1	['REAC:R-HSA-69620']	['RBBP8', 'NBN', 'TP53BP1', 'RAD50', 'H2AX', 'MDC1', 'RPA1', 'BLM', 'MRE11', 'BRCA1', 'BARD1']
143	REAC	REAC:R-HSA-1430728	Metabolism	1.9284810004226803e-08	True	Metabolism	1954	97	33	17376	0.3402061855670103	0.0168884339815762	query_1	['REAC:0000000']	['UBE2I', 'PDK4', 'GCSH', 'PPM1K', 'LYRM4', 'ADSL', 'OTC', 'DLST', 'TALDO1', 'DLAT', 'PDHA2', 'PDHX', 'PDHB', 'MCAT', 'SDHD', 'DBT', 'BCKDK', 'BCKDHB', 'PDHA1', 'PDK3', 'VDAC1', 'MOCS3', 'GPD1', 'PDK1', 'SDHB', 'NDUFAB1', 'SDHA', 'SDHC', 'DLD', 'PDK2', 'NDUFV3', 'OGDH', 'BCKDHA']
144	GO:CC	GO:0000781	chromosome, telomeric region	1.9640341869046088e-08	True	"""The end of a linear chromosome, required for the integrity and maintenance of the end. A chromosome telomere usually includes a region of telomerase-encoded repeats the length of which rarely exceeds 20 bp each and that permits the formation of a telomeric loop (T-loop). The telomeric repeat region is usually preceded by a sub-telomeric region that is gene-poor but rich in repetitive elements. Some telomeres only consist of the latter part (for eg. D. melanogaster telomeres)."" [GOC:elh]"	166	97	11	17376	0.1134020618556701	0.0662650602409638	query_1	['GO:0098687']	['NBN', 'TP53BP1', 'RAD50', 'XRCC6', 'H2AX', 'BRCA2', 'RPA1', 'BLM', 'MRE11', 'RAD51', 'CBX5']
145	GO:CC	GO:0030062	mitochondrial tricarboxylic acid cycle enzyme complex	1.971398004609868e-08	True	"""Any of the heteromeric enzymes, located in the mitochondrion, that act in the tricarboxylic acid (TCA) cycle."" [GOC:mah, GOC:mtg_sensu]"	11	97	5	17376	0.0515463917525773	0.4545454545454545	query_1	['GO:0005759', 'GO:0045239', 'GO:0098798']	['DBT', 'BCKDK', 'BCKDHB', 'DLD', 'BCKDHA']
146	GO:BP	GO:0042770	signal transduction in response to DNA damage	2.216199050388108e-08	True	"""A cascade of processes induced by the detection of DNA damage within a cell."" [GOC:go_curators]"	190	97	12	17376	0.1237113402061855	0.0631578947368421	query_1	['GO:0006974', 'GO:0035556']	['CDK5RAP3', 'NBN', 'TP53BP1', 'PAXIP1', 'H2AX', 'MDC1', 'BRCA2', 'BLM', 'MRE11', 'RAD51', 'BRCA1', 'BARD1']
147	GO:BP	GO:0034654	nucleobase-containing compound biosynthetic process	2.2954064526421605e-08	True	"""The chemical reactions and pathways resulting in the formation of nucleobases, nucleosides, nucleotides and nucleic acids."" [GOC:mah]"	3698	97	48	17376	0.4948453608247423	0.0129799891833423	query_1	['GO:0006139', 'GO:0018130', 'GO:0019438', 'GO:0044271', 'GO:1901362']	['RBBP8', 'SNX6', 'UBE2I', 'PDK4', 'ADSL', 'CDK5RAP3', 'ATF7IP', 'TP53BP1', 'RAD50', 'ZNF45', 'ZNF350', 'XRCC6', 'PAXIP1', 'DLAT', 'PDHA2', 'PDHX', 'SETDB2', 'PDHB', 'DDRGK1', 'UFL1', 'PHB2', 'SDHD', 'BRCA2', 'SETDB1', 'PDHA1', 'SUMO1', 'RPA1', 'PDK3', 'FLYWCH1', 'BLM', 'PIAS1', 'MRE11', 'HDAC6', 'PDK1', 'SDHB', 'CBX5', 'NDUFAB1', 'BRCA1', 'SDHA', 'STAT5A', 'SDHC', 'DLD', 'PDK2', 'MBD1', 'NDUFV3', 'TRIM28', 'PHB1', 'STAT5B']
148	GO:CC	GO:0098796	membrane protein complex	2.3789511600160463e-08	True	"""Any protein complex that is part of a membrane."" [GOC:dos]"	1247	97	26	17376	0.268041237113402	0.0208500400962309	query_1	['GO:0016020', 'GO:0032991']	['PPIF', 'SNX6', 'SPG7', 'SNX1', 'HSPA9', 'MCUB', 'PHB2', 'SDHD', 'MCU', 'SUMO1', 'HSPD1', 'VDAC1', 'AFG3L2', 'SDHB', 'FAF2', 'NDUFAB1', 'SDHA', 'MICU1', 'SMDT1', 'SDHC', 'NDUFV3', 'MICU2', 'MFN1', 'ABHD6', 'GJA10', 'PHB1']
149	GO:BP	GO:0010510	regulation of acetyl-CoA biosynthetic process from pyruvate	3.0075330600253666e-08	True	"""Any process that modulates the frequency, rate or extent of the chemical reactions and pathways resulting in the formation of acetyl-CoA from pyruvate."" [GOC:dph, GOC:tb]"	4	97	4	17376	0.0412371134020618	1.0	query_1	['GO:0006086', 'GO:0050812']	['PDK4', 'PDK3', 'PDK1', 'PDK2']
150	REAC	REAC:R-HSA-5685939	HDR through MMEJ (alt-NHEJ)	3.0592375457128915e-08	True	HDR through MMEJ (alt-NHEJ)	12	97	5	17376	0.0515463917525773	0.4166666666666667	query_1	['REAC:R-HSA-5693538']	['RBBP8', 'NBN', 'RAD50', 'BRCA2', 'MRE11']
151	GO:CC	GO:0016605	PML body	4.173921173078356e-08	True	"""A class of nuclear body; they react against SP100 auto-antibodies (PML, promyelocytic leukemia); cells typically contain 10-30 PML bodies per nucleus; alterations in the localization of PML bodies occurs after viral infection."" [GOC:ma, PMID:10944585]"	101	97	9	17376	0.0927835051546391	0.0891089108910891	query_1	['GO:0016604']	['UBE2I', 'NBN', 'SUMO1', 'RPA1', 'BLM', 'PIAS1', 'MRE11', 'RAD51', 'CBX5']
152	GO:BP	GO:0019438	aromatic compound biosynthetic process	4.579956981969246e-08	True	"""The chemical reactions and pathways resulting in the formation of aromatic compounds, any substance containing an aromatic carbon ring."" [GOC:ai]"	3774	97	48	17376	0.4948453608247423	0.012718600953895	query_1	['GO:0006725', 'GO:0044249']	['RBBP8', 'SNX6', 'UBE2I', 'PDK4', 'ADSL', 'CDK5RAP3', 'ATF7IP', 'TP53BP1', 'RAD50', 'ZNF45', 'ZNF350', 'XRCC6', 'PAXIP1', 'DLAT', 'PDHA2', 'PDHX', 'SETDB2', 'PDHB', 'DDRGK1', 'UFL1', 'PHB2', 'SDHD', 'BRCA2', 'SETDB1', 'PDHA1', 'SUMO1', 'RPA1', 'PDK3', 'FLYWCH1', 'BLM', 'PIAS1', 'MRE11', 'HDAC6', 'PDK1', 'SDHB', 'CBX5', 'NDUFAB1', 'BRCA1', 'SDHA', 'STAT5A', 'SDHC', 'DLD', 'PDK2', 'MBD1', 'NDUFV3', 'TRIM28', 'PHB1', 'STAT5B']
153	GO:BP	GO:0010972	negative regulation of G2/M transition of mitotic cell cycle	5.1378293830621064e-08	True	"""Any signalling pathway that decreases or inhibits the activity of a cell cycle cyclin-dependent protein kinase to modulate the switch from G2 phase to M phase of the mitotic cell cycle."" [GOC:mtg_cell_cycle]"	61	97	8	17376	0.0824742268041237	0.1311475409836065	query_1	['GO:0000086', 'GO:0010389', 'GO:1901991', 'GO:1902750']	['RBBP8', 'CDK5RAP3', 'NBN', 'RAD50', 'BLM', 'MRE11', 'BRCA1', 'BARD1']
154	GO:BP	GO:1901988	negative regulation of cell cycle phase transition	5.1378293830621064e-08	True	"""Any process that stops, prevents or reduces the frequency, rate or extent of cell cycle phase transition."" [GOC:mtg_cell_cycle, GOC:TermGenie, PMID:22841721]"	254	97	13	17376	0.134020618556701	0.0511811023622047	query_1	['GO:0010948', 'GO:0044770', 'GO:1901987']	['RBBP8', 'CDK5RAP3', 'NBN', 'TP53BP1', 'RAD50', 'H2AX', 'MDC1', 'BRCA2', 'BLM', 'MRE11', 'RAD51', 'BRCA1', 'BARD1']
155	GO:BP	GO:1901987	regulation of cell cycle phase transition	5.359789013619821e-08	True	"""Any process that modulates the frequency, rate or extent of cell cycle phase transition."" [GOC:mtg_cell_cycle, GOC:TermGenie, PMID:22841721]"	427	97	16	17376	0.1649484536082474	0.0374707259953161	query_1	['GO:0010564', 'GO:0044770']	['RBBP8', 'CDK5RAP3', 'NBN', 'TP53BP1', 'RAD50', 'PAXIP1', 'H2AX', 'DDRGK1', 'MDC1', 'PHB2', 'BRCA2', 'BLM', 'MRE11', 'RAD51', 'BRCA1', 'BARD1']
156	GO:BP	GO:1901135	carbohydrate derivative metabolic process	5.8230462878596996e-08	True	"""The chemical reactions and pathways involving carbohydrate derivative."" [GOC:TermGenie]"	956	97	23	17376	0.2371134020618556	0.0240585774058577	query_1	['GO:0071704']	['PDK4', 'ADSL', 'DLST', 'TALDO1', 'DLAT', 'PDHA2', 'PDHX', 'PDHB', 'SDHD', 'PDHA1', 'PDK3', 'GPD1', 'PDK1', 'SDHB', 'NDUFAB1', 'SDHA', 'SDHC', 'DLD', 'PDK2', 'NDUFV3', 'MFN1', 'ABHD6', 'OGDH']
157	GO:BP	GO:1902750	negative regulation of cell cycle G2/M phase transition	6.438105981940289e-08	True	"""Any signalling pathway that decreases or inhibits the activity of a cell cycle cyclin-dependent protein kinase to modulate the switch from G2 phase to M phase of the cell cycle."" [GO_REF:0000058, GOC:jl, GOC:TermGenie]"	63	97	8	17376	0.0824742268041237	0.1269841269841269	query_1	['GO:0044839', 'GO:1901988', 'GO:1902749']	['RBBP8', 'CDK5RAP3', 'NBN', 'RAD50', 'BLM', 'MRE11', 'BRCA1', 'BARD1']
158	GO:CC	GO:0035861	site of double-strand break	7.175763142260804e-08	True	"""A region of a chromosome at which a DNA double-strand break has occurred. DNA damage signaling and repair proteins accumulate at the lesion to respond to the damage and repair the DNA to form a continuous DNA helix."" [GOC:bf, GOC:mah, GOC:vw, PMID:20096808, PMID:21035408]"	75	97	8	17376	0.0824742268041237	0.1066666666666666	query_1	['GO:0090734']	['RBBP8', 'NBN', 'TP53BP1', 'RAD50', 'H2AX', 'UFL1', 'MRE11', 'RAD51']
159	GO:BP	GO:0006281	DNA repair	7.30315829792213e-08	True	"""The process of restoring DNA after damage. Genomes are subject to damage by chemical and physical agents in the environment (e.g. UV and ionizing radiations, chemical mutagens, fungal and bacterial toxins, etc.) and by free radicals or alkylating agents endogenously generated in metabolism. DNA is also damaged because of errors during its replication. A variety of different DNA repair pathways have been reported that include direct reversal, base excision repair, nucleotide excision repair, photoreactivation, bypass, double-strand break repair pathway, and mismatch repair pathway."" [PMID:11563486]"	573	97	18	17376	0.1855670103092783	0.031413612565445	query_1	['GO:0006259', 'GO:0006974']	['RBBP8', 'NBN', 'TP53BP1', 'RAD50', 'XRCC6', 'PAXIP1', 'H2AX', 'UFL1', 'MDC1', 'BRCA2', 'SUMO1', 'RPA1', 'BLM', 'MRE11', 'RAD51', 'BRCA1', 'TRIM28', 'BARD1']
160	GO:CC	GO:0043229	intracellular organelle	7.96202336417909e-08	True	"""Organized structure of distinctive morphology and function, occurring within the cell. Includes the nucleus, mitochondria, plastids, vacuoles, vesicles, ribosomes and the cytoskeleton. Excludes the plasma membrane."" [GOC:go_curators]"	12235	97	91	17376	0.9381443298969072	0.0074376787903555	query_1	['GO:0005622', 'GO:0043226']	['PPIF', 'RBBP8', 'SNX6', 'UBE2I', 'PDK4', 'GCSH', 'SPG7', 'PPM1K', 'SNX1', 'LYRM4', 'MAIP1', 'CDK5RAP3', 'NBN', 'OTC', 'ATF7IP', 'DLST', 'HSPA9', 'MCUB', 'TP53BP1', 'RAD50', 'ZNF45', 'UBAC2', 'ZNF350', 'XRCC6', 'TALDO1', 'PAXIP1', 'DLAT', 'PDHA2', 'PDHX', 'SETDB2', 'PDHB', 'H2AX', 'DDRGK1', 'UFL1', 'MDC1', 'PMPCA', 'PHB2', 'MCAT', 'METTL21C', 'SDHD', 'DBT', 'BRCA2', 'MCU', 'SIL1', 'SETDB1', 'BCKDK', 'CDNF', 'BCKDHB', 'PDHA1', 'SUMO1', 'HSPD1', 'RPA1', 'PDK3', 'ARL14EP', 'FLYWCH1', 'BLM', 'PIAS1', 'MRE11', 'VDAC1', 'RAD51', 'AFG3L2', 'HDAC6', 'ISCU', 'PDK1', 'SDHB', 'FAF2', 'NFS1', 'CBX5', 'NDUFAB1', 'BRCA1', 'SDHA', 'MICU1', 'STAT5A', 'SMDT1', 'SDHC', 'DLD', 'PDK2', 'MBD1', 'NDUFV3', 'TRIM28', 'BARD1', 'MICU2', 'MFN1', 'ABHD6', 'PMPCB', 'UBA5', 'OGDH', 'PHB1', 'UFM1', 'STAT5B', 'BCKDHA']
161	GO:BP	GO:0000725	recombinational repair	8.619132038831352e-08	True	"""A DNA repair process that involves the exchange, reciprocal or nonreciprocal, of genetic material between the broken DNA molecule and a homologous DNA region."" [GOC:elh]"	171	97	11	17376	0.1134020618556701	0.0643274853801169	query_1	['GO:0006281', 'GO:0006310']	['RBBP8', 'NBN', 'TP53BP1', 'XRCC6', 'H2AX', 'BRCA2', 'RPA1', 'BLM', 'MRE11', 'RAD51', 'BRCA1']
162	GO:BP	GO:0044272	sulfur compound biosynthetic process	1.1056071439867501e-07	True	"""The chemical reactions and pathways resulting in the formation of compounds that contain sulfur, such as the amino acids methionine and cysteine or the tripeptide glutathione."" [GOC:jl]"	134	97	10	17376	0.1030927835051546	0.0746268656716417	query_1	['GO:0006790', 'GO:0044249']	['PDK4', 'DLAT', 'PDHA2', 'PDHX', 'PDHB', 'PDHA1', 'PDK3', 'PDK1', 'DLD', 'PDK2']
163	GO:CC	GO:0031981	nuclear lumen	1.224341801368651e-07	True	"""The volume enclosed by the nuclear inner membrane."" [GOC:mah, GOC:pz]"	4336	97	50	17376	0.5154639175257731	0.0115313653136531	query_1	['GO:0005634', 'GO:0070013']	['RBBP8', 'UBE2I', 'LYRM4', 'CDK5RAP3', 'NBN', 'ATF7IP', 'DLST', 'HSPA9', 'MCUB', 'TP53BP1', 'RAD50', 'ZNF45', 'ZNF350', 'XRCC6', 'PAXIP1', 'PDHA2', 'SETDB2', 'PDHB', 'H2AX', 'DDRGK1', 'MDC1', 'PHB2', 'BRCA2', 'SETDB1', 'BCKDHB', 'PDHA1', 'SUMO1', 'RPA1', 'PDK3', 'ARL14EP', 'FLYWCH1', 'BLM', 'PIAS1', 'MRE11', 'RAD51', 'HDAC6', 'SDHB', 'NFS1', 'CBX5', 'NDUFAB1', 'BRCA1', 'SDHA', 'STAT5A', 'SMDT1', 'PDK2', 'MBD1', 'TRIM28', 'BARD1', 'PHB1', 'STAT5B']
164	GO:BP	GO:0006121	mitochondrial electron transport, succinate to ubiquinone	1.2683234271020396e-07	True	"""The transfer of electrons from succinate to ubiquinone that occurs during oxidative phosphorylation, mediated by the multisubunit enzyme known as complex II."" [ISBN:0716731363]"	5	97	4	17376	0.0412371134020618	0.8	query_1	['GO:0019646', 'GO:0042775']	['SDHD', 'SDHB', 'SDHA', 'SDHC']
165	GO:BP	GO:0050812	regulation of acyl-CoA biosynthetic process	1.2683234271020396e-07	True	"""Any process that modulates the frequency, rate or extent of the chemical reactions and pathways resulting in the formation of acyl-CoA."" [GOC:ai]"	5	97	4	17376	0.0412371134020618	0.8	query_1	['GO:0019217', 'GO:0034248', 'GO:0042762', 'GO:0071616', 'GO:1900371']	['PDK4', 'PDK3', 'PDK1', 'PDK2']
166	GO:BP	GO:1990564	protein polyufmylation	1.2683234271020396e-07	True	"""Covalent attachment of the ubiquitin-like protein UFM1 to a protein, forming an UFM1 chain."" [PMID:25219498]"	5	97	4	17376	0.0412371134020618	0.8	query_1	['GO:0071569']	['DDRGK1', 'UFL1', 'UBA5', 'UFM1']
167	GO:BP	GO:1990592	protein K69-linked ufmylation	1.2683234271020396e-07	True	"""A protein ufmylation process in which a polymer of the ubiquitin-like protein UFM1 is formed by linkages between lysine residues at position 69 of the UFM1 monomers, is added to a protein."" [PMID:25219498]"	5	97	4	17376	0.0412371134020618	0.8	query_1	['GO:1990564']	['DDRGK1', 'UFL1', 'UBA5', 'UFM1']
168	GO:BP	GO:0033143	regulation of intracellular steroid hormone receptor signaling pathway	1.37858397352412e-07	True	"""Any process that modulates the frequency, rate or extent of the activity of any intracellular steroid hormone receptor signaling pathway."" [GOC:mah]"	70	97	8	17376	0.0824742268041237	0.1142857142857142	query_1	['GO:0009966', 'GO:0030518']	['DDRGK1', 'UFL1', 'PHB2', 'HDAC6', 'BRCA1', 'UBA5', 'PHB1', 'UFM1']
169	GO:CC	GO:0043226	organelle	1.497400731418344e-07	True	"""Organized structure of distinctive morphology and function. Includes the nucleus, mitochondria, plastids, vacuoles, vesicles, ribosomes and the cytoskeleton, and prokaryotic structures such as anammoxosomes and pirellulosomes. Excludes the plasma membrane."" [GOC:go_curators]"	12942	97	93	17376	0.9587628865979382	0.007185906351414	query_1	['GO:0110165']	['PPIF', 'RBBP8', 'SNX6', 'UBE2I', 'PDK4', 'GCSH', 'SPG7', 'PPM1K', 'SNX1', 'LYRM4', 'MAIP1', 'CDK5RAP3', 'NBN', 'OTC', 'ATF7IP', 'DLST', 'HSPA9', 'MCUB', 'TP53BP1', 'RAD50', 'ZNF45', 'UBAC2', 'ZNF350', 'XRCC6', 'TALDO1', 'PAXIP1', 'DLAT', 'PDHA2', 'PDHX', 'SETDB2', 'PDHB', 'H2AX', 'DDRGK1', 'UFL1', 'MDC1', 'PMPCA', 'PHB2', 'MCAT', 'METTL21C', 'SDHD', 'DBT', 'BRCA2', 'MCU', 'SIL1', 'SETDB1', 'BCKDK', 'CDNF', 'BCKDHB', 'PDHA1', 'SUMO1', 'HSPD1', 'RPA1', 'PDK3', 'ARL14EP', 'FLYWCH1', 'BLM', 'PIAS1', 'MRE11', 'VDAC1', 'RAD51', 'AFG3L2', 'HDAC6', 'ISCU', 'GPD1', 'PDK1', 'SDHB', 'FAF2', 'NFS1', 'CBX5', 'NDUFAB1', 'BRCA1', 'SDHA', 'MICU1', 'STAT5A', 'SMDT1', 'SDHC', 'DLD', 'PDK2', 'MBD1', 'NDUFV3', 'TRIM28', 'BARD1', 'MICU2', 'MFN1', 'ABHD6', 'PEPD', 'PMPCB', 'UBA5', 'OGDH', 'PHB1', 'UFM1', 'STAT5B', 'BCKDHA']
170	GO:BP	GO:0006974	DNA damage response	2.0828757424726168e-07	True	"""Any process that results in a change in state or activity of a cell (in terms of movement, secretion, enzyme production, gene expression, etc.) as a result of a stimulus indicating damage to its DNA from environmental insults or errors during metabolism."" [GOC:go_curators]"	855	97	21	17376	0.2164948453608247	0.0245614035087719	query_1	['GO:0033554']	['RBBP8', 'CDK5RAP3', 'NBN', 'TP53BP1', 'RAD50', 'XRCC6', 'PAXIP1', 'H2AX', 'UFL1', 'MDC1', 'BRCA2', 'SUMO1', 'RPA1', 'FLYWCH1', 'BLM', 'MRE11', 'RAD51', 'CBX5', 'BRCA1', 'TRIM28', 'BARD1']
171	GO:CC	GO:0005622	intracellular anatomical structure	2.1133074448190298e-07	True	"""A component of a cell contained within (but not including) the plasma membrane. In eukaryotes it includes the nucleus and cytoplasm."" [ISBN:0198506732]"	13677	97	95	17376	0.979381443298969	0.0069459676829714	query_1	['GO:0110165']	['PPIF', 'RBBP8', 'SNX6', 'UBE2I', 'PDK4', 'GCSH', 'SPG7', 'PPM1K', 'SNX1', 'LYRM4', 'ADSL', 'MAIP1', 'CDK5RAP3', 'NBN', 'OTC', 'ATF7IP', 'DLST', 'HSPA9', 'MCUB', 'TP53BP1', 'RAD50', 'ZNF45', 'UBAC2', 'ZNF350', 'XRCC6', 'TALDO1', 'PAXIP1', 'DLAT', 'PDHA2', 'PDHX', 'SETDB2', 'PDHB', 'H2AX', 'DDRGK1', 'UFL1', 'MDC1', 'PMPCA', 'PHB2', 'MCAT', 'METTL21C', 'SDHD', 'DBT', 'BRCA2', 'MCU', 'SIL1', 'SETDB1', 'BCKDK', 'CDNF', 'BCKDHB', 'PDHA1', 'SUMO1', 'HSPD1', 'RPA1', 'PDK3', 'ARL14EP', 'FLYWCH1', 'BLM', 'PIAS1', 'MRE11', 'VDAC1', 'RAD51', 'AFG3L2', 'HDAC6', 'MOCS3', 'ISCU', 'GPD1', 'PDK1', 'NSUN6', 'SDHB', 'FAF2', 'NFS1', 'CBX5', 'NDUFAB1', 'BRCA1', 'SDHA', 'MICU1', 'STAT5A', 'SMDT1', 'SDHC', 'DLD', 'PDK2', 'MBD1', 'NDUFV3', 'TRIM28', 'BARD1', 'MICU2', 'MFN1', 'ABHD6', 'PMPCB', 'UBA5', 'OGDH', 'PHB1', 'UFM1', 'STAT5B', 'BCKDHA']
172	GO:BP	GO:0071479	cellular response to ionizing radiation	2.3533902553633906e-07	True	"""Any process that results in a change in state or activity of a cell (in terms of movement, secretion, enzyme production, gene expression, etc.) as a result of a ionizing radiation stimulus. Ionizing radiation is radiation with sufficient energy to remove electrons from atoms and may arise from spontaneous decay of unstable isotopes, resulting in alpha and beta particles and gamma rays. Ionizing radiation also includes X-rays."" [GOC:mah]"	75	97	8	17376	0.0824742268041237	0.1066666666666666	query_1	['GO:0010212', 'GO:0071478']	['TP53BP1', 'XRCC6', 'H2AX', 'BRCA2', 'BLM', 'RAD51', 'BRCA1', 'BARD1']
173	GO:BP	GO:1902749	regulation of cell cycle G2/M phase transition	2.3870532174271816e-07	True	"""Any signalling pathway that modulates the activity of a cell cycle cyclin-dependent protein kinase to modulate the switch from G2 phase to M phase of the cell cycle."" [GO_REF:0000058, GOC:jl, GOC:TermGenie]"	108	97	9	17376	0.0927835051546391	0.0833333333333333	query_1	['GO:0044839', 'GO:1901987']	['RBBP8', 'CDK5RAP3', 'NBN', 'RAD50', 'PAXIP1', 'BLM', 'MRE11', 'BRCA1', 'BARD1']
174	GO:BP	GO:0010948	negative regulation of cell cycle process	2.78385670825787e-07	True	"""Any process that decreases the rate, frequency or extent of a cellular process that is involved in the progression of biochemical and morphological phases and events that occur in a cell during successive cell replication or nuclear replication events."" [GOC:dph, GOC:tb]"	297	97	13	17376	0.134020618556701	0.0437710437710437	query_1	['GO:0010564', 'GO:0022402', 'GO:0045786']	['RBBP8', 'CDK5RAP3', 'NBN', 'TP53BP1', 'RAD50', 'H2AX', 'MDC1', 'BRCA2', 'BLM', 'MRE11', 'RAD51', 'BRCA1', 'BARD1']
175	REAC	REAC:R-HSA-6804756	Regulation of TP53 Activity through Phosphorylation	3.5548217513505025e-07	True	Regulation of TP53 Activity through Phosphorylation	92	97	8	17376	0.0824742268041237	0.0869565217391304	query_1	['REAC:R-HSA-5633007']	['RBBP8', 'NBN', 'RAD50', 'RPA1', 'BLM', 'MRE11', 'BRCA1', 'BARD1']
176	GO:BP	GO:0006261	DNA-templated DNA replication	4.5464215256000193e-07	True	"""A DNA replication process that uses parental DNA as a template for the DNA-dependent DNA polymerases that synthesize the new strands."" [GOC:mah, ISBN:0198506732]"	157	97	10	17376	0.1030927835051546	0.0636942675159235	query_1	['GO:0006260']	['RBBP8', 'NBN', 'RAD50', 'BRCA2', 'RPA1', 'BLM', 'MRE11', 'RAD51', 'BRCA1', 'BARD1']
177	GO:BP	GO:0022904	respiratory electron transport chain	5.042562175977563e-07	True	"""A process in which a series of electron carriers operate together to transfer electrons from donors such as NADH and FADH2 to any of several different terminal electron acceptors to generate a transmembrane electrochemical gradient."" [GOC:mtg_electron_transport, ISBN:0716720094]"	118	97	9	17376	0.0927835051546391	0.0762711864406779	query_1	['GO:0022900', 'GO:0045333']	['SDHD', 'ISCU', 'GPD1', 'SDHB', 'NDUFAB1', 'SDHA', 'SDHC', 'DLD', 'NDUFV3']
178	GO:BP	GO:0032787	monocarboxylic acid metabolic process	5.47128047173432e-07	True	"""The chemical reactions and pathways involving monocarboxylic acids, any organic acid containing one carboxyl (COOH) group or anion (COO-)."" [GOC:vk]"	583	97	17	17376	0.1752577319587628	0.0291595197255574	query_1	['GO:0019752']	['PDK4', 'DLAT', 'PDHA2', 'PDHX', 'PDHB', 'MCAT', 'PDHA1', 'PDK3', 'VDAC1', 'GPD1', 'PDK1', 'NDUFAB1', 'BRCA1', 'DLD', 'PDK2', 'ABHD6', 'OGDH']
179	GO:BP	GO:1901137	carbohydrate derivative biosynthetic process	5.982489888955332e-07	True	"""The chemical reactions and pathways resulting in the formation of carbohydrate derivative."" [GOC:TermGenie]"	587	97	17	17376	0.1752577319587628	0.0289608177172061	query_1	['GO:1901135', 'GO:1901576']	['PDK4', 'ADSL', 'DLAT', 'PDHA2', 'PDHX', 'PDHB', 'SDHD', 'PDHA1', 'PDK3', 'PDK1', 'SDHB', 'NDUFAB1', 'SDHA', 'SDHC', 'DLD', 'PDK2', 'NDUFV3']
180	GO:CC	GO:0016604	nuclear body	6.37954615830688e-07	True	"""Extra-nucleolar nuclear domains usually visualized by confocal microscopy and fluorescent antibodies to specific proteins."" [GOC:ma, PMID:10330182]"	808	97	19	17376	0.1958762886597938	0.0235148514851485	query_1	['GO:0005654', 'GO:0110165']	['UBE2I', 'LYRM4', 'NBN', 'ATF7IP', 'TP53BP1', 'ZNF350', 'H2AX', 'MDC1', 'SUMO1', 'RPA1', 'FLYWCH1', 'BLM', 'PIAS1', 'MRE11', 'RAD51', 'CBX5', 'BRCA1', 'MBD1', 'BARD1']
181	GO:BP	GO:0033146	regulation of intracellular estrogen receptor signaling pathway	7.663216679765158e-07	True	"""Any process that modulates the frequency, rate or extent of the activity of an intracellular estrogen receptor signaling pathway."" [GOC:mah]"	34	97	6	17376	0.0618556701030927	0.1764705882352941	query_1	['GO:0030520', 'GO:0033143']	['DDRGK1', 'UFL1', 'PHB2', 'BRCA1', 'UBA5', 'UFM1']
182	GO:BP	GO:0000724	double-strand break repair via homologous recombination	7.691394749116135e-07	True	"""The error-free repair of a double-strand break in DNA in which the broken DNA molecule is repaired using homologous sequences. A strand in the broken DNA searches for a homologous region in an intact chromosome to serve as the template for DNA synthesis. The restoration of two intact DNA molecules results in the exchange, reciprocal or nonreciprocal, of genetic material between the intact DNA molecule and the broken DNA molecule."" [GOC:elh, PMID:10357855]"	167	97	10	17376	0.1030927835051546	0.059880239520958	query_1	['GO:0000725', 'GO:0006302']	['RBBP8', 'NBN', 'TP53BP1', 'H2AX', 'BRCA2', 'RPA1', 'BLM', 'MRE11', 'RAD51', 'BRCA1']
183	GO:BP	GO:0019646	aerobic electron transport chain	7.691394749116135e-07	True	"""A process in which a series of electron carriers operate together to transfer electrons from donors such as NADH and FADH2 to oxygen to generate a transmembrane electrochemical gradient."" [GOC:ai, GOC:mtg_electron_transport]"	88	97	8	17376	0.0824742268041237	0.0909090909090909	query_1	['GO:0006119', 'GO:0009060', 'GO:0022904']	['SDHD', 'ISCU', 'SDHB', 'NDUFAB1', 'SDHA', 'SDHC', 'DLD', 'NDUFV3']
184	REAC	REAC:R-HSA-3899300	SUMOylation of transcription cofactors	7.760947042323478e-07	True	SUMOylation of transcription cofactors	41	97	6	17376	0.0618556701030927	0.1463414634146341	query_1	['REAC:R-HSA-3108232']	['UBE2I', 'ZNF350', 'SUMO1', 'PIAS1', 'MBD1', 'TRIM28']
185	GO:BP	GO:0035825	homologous recombination	1.1204765731604307e-06	True	"""A DNA recombination process that results in the exchange of an equal amount of genetic material between highly homologous DNA molecules."" [GOC:mah, PMID:11139492, PMID:17304215]"	61	97	7	17376	0.0721649484536082	0.1147540983606557	query_1	['GO:0006310']	['RBBP8', 'NBN', 'RAD50', 'MRE11', 'RAD51', 'BRCA1', 'BARD1']
186	REAC	REAC:R-HSA-3108214	SUMOylation of DNA damage response and repair proteins	1.1364643222401046e-06	True	SUMOylation of DNA damage response and repair proteins	72	97	7	17376	0.0721649484536082	0.0972222222222222	query_1	['REAC:R-HSA-3108232']	['UBE2I', 'MDC1', 'SUMO1', 'RPA1', 'BLM', 'PIAS1', 'BRCA1']
187	GO:BP	GO:0000729	DNA double-strand break processing	1.2798691913989813e-06	True	"""The 5' to 3' exonucleolytic resection of the DNA at the site of the break to form a 3' single-strand DNA overhang."" [PMID:10357855]"	19	97	5	17376	0.0515463917525773	0.2631578947368421	query_1	['GO:0006259', 'GO:0006302']	['RBBP8', 'NBN', 'RAD50', 'BLM', 'MRE11']
188	GO:BP	GO:0044770	cell cycle phase transition	1.3670507391642091e-06	True	"""The cell cycle process by which a cell commits to entering the next cell cycle phase."" [GOC:mtg_cell_cycle]"	548	97	16	17376	0.1649484536082474	0.0291970802919708	query_1	['GO:0022402']	['RBBP8', 'CDK5RAP3', 'NBN', 'TP53BP1', 'RAD50', 'PAXIP1', 'H2AX', 'DDRGK1', 'MDC1', 'PHB2', 'BRCA2', 'BLM', 'MRE11', 'RAD51', 'BRCA1', 'BARD1']
189	GO:BP	GO:0010389	regulation of G2/M transition of mitotic cell cycle	1.4359217260759089e-06	True	"""Any signalling pathway that modulates the activity of a cell cycle cyclin-dependent protein kinase to modulate the switch from G2 phase to M phase of the mitotic cell cycle."" [GOC:mtg_cell_cycle, PMID:17329565]"	96	97	8	17376	0.0824742268041237	0.0833333333333333	query_1	['GO:0000086', 'GO:1901990', 'GO:1902749']	['RBBP8', 'CDK5RAP3', 'NBN', 'RAD50', 'BLM', 'MRE11', 'BRCA1', 'BARD1']
190	GO:BP	GO:0042773	ATP synthesis coupled electron transport	1.4359217260759089e-06	True	"""The transfer of electrons through a series of electron donors and acceptors, generating energy that is ultimately used for synthesis of ATP."" [ISBN:0716731363]"	96	97	8	17376	0.0824742268041237	0.0833333333333333	query_1	['GO:0006119', 'GO:0022904']	['SDHD', 'ISCU', 'SDHB', 'NDUFAB1', 'SDHA', 'SDHC', 'DLD', 'NDUFV3']
191	GO:BP	GO:0042775	mitochondrial ATP synthesis coupled electron transport	1.4359217260759089e-06	True	"""The transfer of electrons through a series of electron donors and acceptors, generating energy that is ultimately used for synthesis of ATP, as it occurs in the mitochondrial inner membrane or chloroplast thylakoid membrane."" [GOC:mtg_sensu, ISBN:0716731363]"	96	97	8	17376	0.0824742268041237	0.0833333333333333	query_1	['GO:0042773']	['SDHD', 'ISCU', 'SDHB', 'NDUFAB1', 'SDHA', 'SDHC', 'DLD', 'NDUFV3']
192	GO:BP	GO:0009083	branched-chain amino acid catabolic process	1.6045441155447255e-06	True	"""The chemical reactions and pathways resulting in the breakdown of amino acids containing a branched carbon skeleton, comprising isoleucine, leucine and valine."" [GOC:ai]"	20	97	5	17376	0.0515463917525773	0.25	query_1	['GO:0009063', 'GO:0009081']	['DBT', 'BCKDK', 'BCKDHB', 'DLD', 'BCKDHA']
193	GO:BP	GO:0006006	glucose metabolic process	1.6045441155447255e-06	True	"""The chemical reactions and pathways involving glucose, the aldohexose gluco-hexose. D-glucose is dextrorotatory and is sometimes known as dextrose; it is an important source of energy for living organisms and is found free as well as combined in homo- and hetero-oligosaccharides and polysaccharides."" [ISBN:0198506732]"	182	97	10	17376	0.1030927835051546	0.0549450549450549	query_1	['GO:0019318']	['PDK4', 'DLAT', 'PDHA2', 'PDHB', 'BCKDK', 'PDHA1', 'PDK3', 'GPD1', 'PDK1', 'PDK2']
194	GO:BP	GO:0006119	oxidative phosphorylation	1.938418575832943e-06	True	"""The phosphorylation of ADP to ATP that accompanies the oxidation of a metabolite through the operation of the respiratory chain. Oxidation of compounds establishes a proton gradient across the membrane, providing the energy for ATP synthesis."" [ISBN:0198506732, ISBN:0471331309]"	140	97	9	17376	0.0927835051546391	0.0642857142857142	query_1	['GO:0009060']	['PPIF', 'SDHD', 'ISCU', 'SDHB', 'NDUFAB1', 'SDHA', 'SDHC', 'DLD', 'NDUFV3']
195	GO:BP	GO:0006302	double-strand break repair	2.0797482409775254e-06	True	"""The repair of double-strand breaks in DNA via homologous and nonhomologous mechanisms to reform a continuous DNA helix."" [GOC:elh]"	296	97	12	17376	0.1237113402061855	0.0405405405405405	query_1	['GO:0006281']	['RBBP8', 'NBN', 'TP53BP1', 'RAD50', 'XRCC6', 'H2AX', 'BRCA2', 'RPA1', 'BLM', 'MRE11', 'RAD51', 'BRCA1']
196	GO:BP	GO:0044271	cellular nitrogen compound biosynthetic process	2.280296620321326e-06	True	"""The chemical reactions and pathways resulting in the formation of organic and inorganic nitrogenous compounds."" [GOC:jl, ISBN:0198506732]"	4431	97	49	17376	0.5051546391752577	0.0110584518167456	query_1	['GO:0034641', 'GO:0044249']	['RBBP8', 'SNX6', 'UBE2I', 'PDK4', 'ADSL', 'CDK5RAP3', 'OTC', 'ATF7IP', 'TP53BP1', 'RAD50', 'ZNF45', 'ZNF350', 'XRCC6', 'PAXIP1', 'DLAT', 'PDHA2', 'PDHX', 'SETDB2', 'PDHB', 'DDRGK1', 'UFL1', 'PHB2', 'SDHD', 'BRCA2', 'SETDB1', 'PDHA1', 'SUMO1', 'RPA1', 'PDK3', 'FLYWCH1', 'BLM', 'PIAS1', 'MRE11', 'HDAC6', 'PDK1', 'SDHB', 'CBX5', 'NDUFAB1', 'BRCA1', 'SDHA', 'STAT5A', 'SDHC', 'DLD', 'PDK2', 'MBD1', 'NDUFV3', 'TRIM28', 'PHB1', 'STAT5B']
197	GO:BP	GO:0010212	response to ionizing radiation	2.280296620321326e-06	True	"""Any process that results in a change in state or activity of a cell or an organism (in terms of movement, secretion, enzyme production, gene expression, etc.) as a result of a ionizing radiation stimulus. Ionizing radiation is radiation with sufficient energy to remove electrons from atoms and may arise from spontaneous decay of unstable isotopes, resulting in alpha and beta particles and gamma rays. Ionizing radiation also includes X-rays."" [PMID:12509526]"	143	97	9	17376	0.0927835051546391	0.0629370629370629	query_1	['GO:0009314']	['TP53BP1', 'XRCC6', 'PAXIP1', 'H2AX', 'BRCA2', 'BLM', 'RAD51', 'BRCA1', 'BARD1']
198	GO:CC	GO:0000794	condensed nuclear chromosome	2.373762154654389e-06	True	"""A highly compacted molecule of DNA and associated proteins resulting in a cytologically distinct nuclear chromosome."" [GOC:elh]"	81	97	7	17376	0.0721649484536082	0.0864197530864197	query_1	['GO:0000228', 'GO:0000793']	['UBE2I', 'RAD50', 'H2AX', 'BRCA2', 'BLM', 'RAD51', 'BRCA1']
199	GO:BP	GO:0007093	mitotic cell cycle checkpoint signaling	2.3809965959809584e-06	True	"""A signaling process that ensures accurate chromosome replication and segregation by preventing progression through a mitotic cell cycle until conditions are suitable for the cell to proceed to the next stage."" [GOC:mtg_cell_cycle]"	144	97	9	17376	0.0927835051546391	0.0625	query_1	['GO:0000075', 'GO:0045930', 'GO:1903047']	['RBBP8', 'CDK5RAP3', 'NBN', 'RAD50', 'MDC1', 'BLM', 'MRE11', 'BRCA1', 'BARD1']
200	GO:BP	GO:0006259	DNA metabolic process	2.667767023518908e-06	True	"""Any cellular metabolic process involving deoxyribonucleic acid. This is one of the two main types of nucleic acid, consisting of a long, unbranched macromolecule formed from one, or more commonly, two, strands of linked deoxyribonucleotides."" [ISBN:0198506732]"	1006	97	21	17376	0.2164948453608247	0.0208747514910536	query_1	['GO:0090304']	['RBBP8', 'NBN', 'ATF7IP', 'TP53BP1', 'RAD50', 'XRCC6', 'PAXIP1', 'H2AX', 'UFL1', 'MDC1', 'BRCA2', 'SUMO1', 'HSPD1', 'RPA1', 'BLM', 'MRE11', 'RAD51', 'BRCA1', 'TRIM28', 'BARD1', 'PHB1']
201	GO:BP	GO:0018205	peptidyl-lysine modification	2.7692107675901303e-06	True	"""The modification of peptidyl-lysine."" [GOC:go_curators]"	368	97	13	17376	0.134020618556701	0.0353260869565217	query_1	['GO:0018193']	['UBE2I', 'GCSH', 'PAXIP1', 'SETDB2', 'METTL21C', 'BRCA2', 'SETDB1', 'SUMO1', 'PIAS1', 'HDAC6', 'NDUFAB1', 'BRCA1', 'TRIM28']
202	GO:BP	GO:0009063	amino acid catabolic process	2.844014911179125e-06	True	"""The chemical reactions and pathways resulting in the breakdown of amino acids, organic acids containing one or more amino substituents."" [GOC:ai]"	106	97	8	17376	0.0824742268041237	0.0754716981132075	query_1	['GO:0006520', 'GO:0046395', 'GO:1901565']	['GCSH', 'OTC', 'DLST', 'DBT', 'BCKDK', 'BCKDHB', 'DLD', 'BCKDHA']
203	GO:CC	GO:1990229	iron-sulfur cluster assembly complex	3.00447604482405e-06	True	"""A protein complex capable of assembling an iron-sulfur (Fe-S) cluster."" [GOC:bhm, PMID:17350958]"	12	97	4	17376	0.0412371134020618	0.3333333333333333	query_1	['GO:0005829', 'GO:0032991']	['LYRM4', 'ISCU', 'NFS1', 'NDUFAB1']
204	GO:BP	GO:0045786	negative regulation of cell cycle	3.380550111501507e-06	True	"""Any process that stops, prevents or reduces the rate or extent of progression through the cell cycle."" [GOC:dph, GOC:go_curators, GOC:tb]"	375	97	13	17376	0.134020618556701	0.0346666666666666	query_1	['GO:0007049', 'GO:0048523', 'GO:0051726']	['RBBP8', 'CDK5RAP3', 'NBN', 'TP53BP1', 'RAD50', 'H2AX', 'MDC1', 'BRCA2', 'BLM', 'MRE11', 'RAD51', 'BRCA1', 'BARD1']
205	GO:BP	GO:0007005	mitochondrion organization	4.041545792624164e-06	True	"""A process that is carried out at the cellular level which results in the assembly, arrangement of constituent parts, or disassembly of a mitochondrion; includes mitochondrial morphogenesis and distribution, and replication of the mitochondrial genome as well as synthesis of new mitochondrial components."" [GOC:dph, GOC:jl, GOC:mah, GOC:sgd_curators, PMID:9786946]"	523	97	15	17376	0.1546391752577319	0.02868068833652	query_1	['GO:0006996']	['PPIF', 'SPG7', 'MAIP1', 'HSPA9', 'PMPCA', 'PHB2', 'MCU', 'HSPD1', 'VDAC1', 'AFG3L2', 'HDAC6', 'NDUFAB1', 'MFN1', 'PMPCB', 'PHB1']
206	GO:BP	GO:0032508	DNA duplex unwinding	4.041545792624164e-06	True	"""The process in which interchain hydrogen bonds between two strands of DNA are broken or 'melted', generating a region of unpaired single strands."" [GOC:isa_complete, GOC:mah]"	75	97	7	17376	0.0721649484536082	0.0933333333333333	query_1	['GO:0032392']	['NBN', 'RAD50', 'XRCC6', 'RPA1', 'BLM', 'MRE11', 'RAD51']
207	GO:BP	GO:0044839	cell cycle G2/M phase transition	4.205848624559282e-06	True	"""The cell cycle process by which a cell in G2 phase commits to M phase."" [GOC:jl, GOC:mtg_cell_cycle]"	155	97	9	17376	0.0927835051546391	0.0580645161290322	query_1	['GO:0044770']	['RBBP8', 'CDK5RAP3', 'NBN', 'RAD50', 'PAXIP1', 'BLM', 'MRE11', 'BRCA1', 'BARD1']
208	REAC	REAC:R-HSA-9006931	Signaling by Nuclear Receptors	4.214105641077583e-06	True	Signaling by Nuclear Receptors	286	97	11	17376	0.1134020618556701	0.0384615384615384	query_1	['REAC:R-HSA-162582']	['PDK4', 'DLAT', 'PDHA2', 'PDHX', 'PDHB', 'H2AX', 'PDHA1', 'PDK3', 'PDK1', 'DLD', 'PDK2']
209	GO:BP	GO:0030518	intracellular steroid hormone receptor signaling pathway	4.476001160664074e-06	True	"""The series of molecular signals initiated by a steroid binding to an intracellular steroid hormone receptor."" [GOC:mah, GOC:signaling]"	113	97	8	17376	0.0824742268041237	0.0707964601769911	query_1	['GO:0030522', 'GO:0043401']	['DDRGK1', 'UFL1', 'PHB2', 'HDAC6', 'BRCA1', 'UBA5', 'PHB1', 'UFM1']
210	GO:CC	GO:0099128	mitochondrial iron-sulfur cluster assembly complex	4.519862241779685e-06	True	"""A protein complex consisting of frataxin, cysteine desulfurase, an accessory protein and a Fe-S scaffold protein. In human these genes correspond to FXN, NFS1, ISD11 and ISCU respectively. This complex assembles Fe-S clusters onto the scaffolding protein using the substrates ferrous iron, electrons, and sulfur from l-cysteine."" [PMID:27519411]"	4	97	3	17376	0.0309278350515463	0.75	query_1	['GO:0098798']	['LYRM4', 'ISCU', 'NFS1']
211	REAC	REAC:R-HSA-69620	Cell Cycle Checkpoints	4.578388540787789e-06	True	Cell Cycle Checkpoints	289	97	11	17376	0.1134020618556701	0.0380622837370242	query_1	['REAC:R-HSA-1640170']	['RBBP8', 'NBN', 'TP53BP1', 'RAD50', 'H2AX', 'MDC1', 'RPA1', 'BLM', 'MRE11', 'BRCA1', 'BARD1']
212	GO:BP	GO:0044249	cellular biosynthetic process	5.149555451288182e-06	True	"""The chemical reactions and pathways resulting in the formation of substances, carried out by individual cells."" [GOC:jl]"	5011	97	52	17376	0.5360824742268041	0.0103771702255038	query_1	['GO:0009058', 'GO:0044237']	['RBBP8', 'SNX6', 'UBE2I', 'PDK4', 'ADSL', 'CDK5RAP3', 'OTC', 'ATF7IP', 'TP53BP1', 'RAD50', 'ZNF45', 'ZNF350', 'XRCC6', 'PAXIP1', 'DLAT', 'PDHA2', 'PDHX', 'SETDB2', 'PDHB', 'DDRGK1', 'UFL1', 'PHB2', 'MCAT', 'SDHD', 'BRCA2', 'SETDB1', 'PDHA1', 'SUMO1', 'RPA1', 'PDK3', 'FLYWCH1', 'BLM', 'PIAS1', 'MRE11', 'HDAC6', 'MOCS3', 'PDK1', 'SDHB', 'NFS1', 'CBX5', 'NDUFAB1', 'BRCA1', 'SDHA', 'STAT5A', 'SDHC', 'DLD', 'PDK2', 'MBD1', 'NDUFV3', 'TRIM28', 'PHB1', 'STAT5B']
213	GO:BP	GO:0009081	branched-chain amino acid metabolic process	5.743482146768981e-06	True	"""The chemical reactions and pathways involving amino acids containing a branched carbon skeleton, comprising isoleucine, leucine and valine."" [GOC:ai]"	26	97	5	17376	0.0515463917525773	0.1923076923076923	query_1	['GO:0006520']	['DBT', 'BCKDK', 'BCKDHB', 'DLD', 'BCKDHA']
214	GO:BP	GO:0044571	[2Fe-2S] cluster assembly	5.743482146768981e-06	True	"""The incorporation of two iron atoms and two sulfur atoms into an iron-sulfur cluster."" [GOC:jl, GOC:mengo_curators, GOC:pde, GOC:tt, GOC:vw, PMID:15952888]"	11	97	4	17376	0.0412371134020618	0.3636363636363636	query_1	['GO:0016226']	['LYRM4', 'ISCU', 'NFS1', 'NDUFAB1']
215	GO:BP	GO:1901576	organic substance biosynthetic process	5.769690213958363e-06	True	"""The chemical reactions and pathways resulting in the formation of an organic substance, any molecular entity containing carbon."" [GOC:pr, GOC:TermGenie]"	5345	97	54	17376	0.5567010309278351	0.0101028999064546	query_1	['GO:0009058', 'GO:0071704']	['RBBP8', 'SNX6', 'UBE2I', 'PDK4', 'ADSL', 'CDK5RAP3', 'OTC', 'ATF7IP', 'TP53BP1', 'RAD50', 'ZNF45', 'ZNF350', 'XRCC6', 'PAXIP1', 'DLAT', 'PDHA2', 'PDHX', 'SETDB2', 'PDHB', 'DDRGK1', 'UFL1', 'PHB2', 'MCAT', 'SDHD', 'BRCA2', 'SETDB1', 'PDHA1', 'SUMO1', 'RPA1', 'PDK3', 'FLYWCH1', 'BLM', 'PIAS1', 'MRE11', 'HDAC6', 'MOCS3', 'GPD1', 'PDK1', 'SDHB', 'NFS1', 'CBX5', 'NDUFAB1', 'BRCA1', 'SDHA', 'STAT5A', 'SDHC', 'DLD', 'PDK2', 'MBD1', 'NDUFV3', 'TRIM28', 'ABHD6', 'PHB1', 'STAT5B']
216	GO:BP	GO:0032392	DNA geometric change	6.498115219341474e-06	True	"""The process in which a transformation is induced in the geometry of a DNA double helix, resulting in a change in twist, writhe, or both, but with no change in linking number. Includes the unwinding of double-stranded DNA by helicases."" [GOC:mah]"	81	97	7	17376	0.0721649484536082	0.0864197530864197	query_1	['GO:0071103']	['NBN', 'RAD50', 'XRCC6', 'RPA1', 'BLM', 'MRE11', 'RAD51']
217	GO:BP	GO:0009987	cellular process	7.245444364893974e-06	True	"""Any process that is carried out at the cellular level, but not necessarily restricted to a single cell. For example, cell communication occurs among more than one cell, but occurs at the cellular level."" [GOC:go_curators, GOC:isa_complete]"	14469	97	96	17376	0.9896907216494846	0.0066348745594028	query_1	['GO:0008150']	['PPIF', 'RBBP8', 'SNX6', 'UBE2I', 'PDK4', 'GCSH', 'SPG7', 'PPM1K', 'SNX1', 'LYRM4', 'ADSL', 'MAIP1', 'CDK5RAP3', 'NBN', 'OTC', 'ATF7IP', 'DLST', 'HSPA9', 'MCUB', 'TP53BP1', 'RAD50', 'ZNF45', 'UBAC2', 'ZNF350', 'XRCC6', 'TALDO1', 'PAXIP1', 'DLAT', 'PDHA2', 'PDHX', 'SETDB2', 'PDHB', 'H2AX', 'DDRGK1', 'UFL1', 'MDC1', 'PMPCA', 'PHB2', 'MCAT', 'METTL21C', 'SDHD', 'DBT', 'BRCA2', 'MCU', 'SIL1', 'SETDB1', 'BCKDK', 'CDNF', 'BCKDHB', 'PDHA1', 'SUMO1', 'HSPD1', 'RPA1', 'PDK3', 'FLYWCH1', 'BLM', 'PIAS1', 'MRE11', 'VDAC1', 'RAD51', 'AFG3L2', 'HDAC6', 'MOCS3', 'ISCU', 'GPD1', 'PDK1', 'NSUN6', 'SDHB', 'FAF2', 'NFS1', 'CBX5', 'NDUFAB1', 'BRCA1', 'SDHA', 'MICU1', 'STAT5A', 'SMDT1', 'SDHC', 'DLD', 'PDK2', 'MBD1', 'NDUFV3', 'TRIM28', 'BARD1', 'MICU2', 'MFN1', 'ABHD6', 'PEPD', 'PMPCB', 'UBA5', 'OGDH', 'GJA10', 'PHB1', 'UFM1', 'STAT5B', 'BCKDHA']
218	GO:BP	GO:0043412	macromolecule modification	7.309130589641665e-06	True	"""The covalent alteration of one or more monomeric units in a polypeptide, polynucleotide, polysaccharide, or other biological macromolecule, resulting in a change in its properties."" [GOC:go_curators]"	3593	97	42	17376	0.4329896907216495	0.0116893960478708	query_1	['GO:0043170']	['PPIF', 'SNX6', 'UBE2I', 'PDK4', 'GCSH', 'PPM1K', 'CDK5RAP3', 'NBN', 'ATF7IP', 'DLST', 'RAD50', 'XRCC6', 'PAXIP1', 'SETDB2', 'DDRGK1', 'UFL1', 'PHB2', 'METTL21C', 'BRCA2', 'SETDB1', 'BCKDK', 'SUMO1', 'PDK3', 'BLM', 'PIAS1', 'MRE11', 'RAD51', 'HDAC6', 'MOCS3', 'PDK1', 'NSUN6', 'NFS1', 'NDUFAB1', 'BRCA1', 'DLD', 'PDK2', 'TRIM28', 'BARD1', 'UBA5', 'OGDH', 'PHB1', 'UFM1']
219	GO:CC	GO:0000800	lateral element	7.815682192528711e-06	True	"""A proteinaceous core found between sister chromatids during meiotic prophase."" [GOC:elh]"	15	97	4	17376	0.0412371134020618	0.2666666666666666	query_1	['GO:0000795', 'GO:0110165']	['BRCA2', 'BLM', 'RAD51', 'BRCA1']
220	GO:BP	GO:0019318	hexose metabolic process	7.82244696633553e-06	True	"""The chemical reactions and pathways involving a hexose, any monosaccharide with a chain of six carbon atoms in the molecule."" [ISBN:0198506732]"	220	97	10	17376	0.1030927835051546	0.0454545454545454	query_1	['GO:0005996']	['PDK4', 'DLAT', 'PDHA2', 'PDHB', 'BCKDK', 'PDHA1', 'PDK3', 'GPD1', 'PDK1', 'PDK2']
221	GO:BP	GO:0030520	intracellular estrogen receptor signaling pathway	8.003164596762441e-06	True	"""The series of molecular signals initiated by estrogen binding to an intracellular receptor, and ending with the regulation of a downstream cellular process, e.g. transcription."" [GOC:mah, GOC:signaling]"	52	97	6	17376	0.0618556701030927	0.1153846153846153	query_1	['GO:0030518']	['DDRGK1', 'UFL1', 'PHB2', 'BRCA1', 'UBA5', 'UFM1']
222	GO:BP	GO:0090309	positive regulation of DNA methylation-dependent heterochromatin formation	8.091578630115108e-06	True	"""Any process that increases the rate, frequency, or extent of DNA methylation-dependent heterochromatin formation."" [GOC:BHF]"	12	97	4	17376	0.0412371134020618	0.3333333333333333	query_1	['GO:0006346', 'GO:0031453', 'GO:0090308']	['ATF7IP', 'SETDB2', 'SETDB1', 'TRIM28']
223	GO:BP	GO:0022900	electron transport chain	8.35486444870293e-06	True	"""A process in which a series of electron carriers operate together to transfer electrons from donors to any of several different terminal electron acceptors."" [GOC:mtg_electron_transport]"	170	97	9	17376	0.0927835051546391	0.0529411764705882	query_1	['GO:0006091']	['SDHD', 'ISCU', 'GPD1', 'SDHB', 'NDUFAB1', 'SDHA', 'SDHC', 'DLD', 'NDUFV3']
224	GO:BP	GO:0009058	biosynthetic process	8.446212632542633e-06	True	"""The chemical reactions and pathways resulting in the formation of substances; typically the energy-requiring part of metabolism in which simpler substances are transformed into more complex ones."" [GOC:curators, ISBN:0198547684]"	5412	97	54	17376	0.5567010309278351	0.0099778270509977	query_1	['GO:0008152']	['RBBP8', 'SNX6', 'UBE2I', 'PDK4', 'ADSL', 'CDK5RAP3', 'OTC', 'ATF7IP', 'TP53BP1', 'RAD50', 'ZNF45', 'ZNF350', 'XRCC6', 'PAXIP1', 'DLAT', 'PDHA2', 'PDHX', 'SETDB2', 'PDHB', 'DDRGK1', 'UFL1', 'PHB2', 'MCAT', 'SDHD', 'BRCA2', 'SETDB1', 'PDHA1', 'SUMO1', 'RPA1', 'PDK3', 'FLYWCH1', 'BLM', 'PIAS1', 'MRE11', 'HDAC6', 'MOCS3', 'GPD1', 'PDK1', 'SDHB', 'NFS1', 'CBX5', 'NDUFAB1', 'BRCA1', 'SDHA', 'STAT5A', 'SDHC', 'DLD', 'PDK2', 'MBD1', 'NDUFV3', 'TRIM28', 'ABHD6', 'PHB1', 'STAT5B']
225	REAC	REAC:R-HSA-1268020	Mitochondrial protein import	8.898407146347273e-06	True	Mitochondrial protein import	62	97	6	17376	0.0618556701030927	0.0967741935483871	query_1	['REAC:R-HSA-9609507']	['OTC', 'HSPA9', 'PMPCA', 'HSPD1', 'VDAC1', 'PMPCB']
226	GO:BP	GO:0031163	metallo-sulfur cluster assembly	9.379761214006902e-06	True	"""The incorporation of a metal and exogenous sulfur into a metallo-sulfur cluster."" [GOC:jl, GOC:mah, GOC:pde, GOC:vw]"	29	97	5	17376	0.0515463917525773	0.1724137931034483	query_1	['GO:0022607']	['LYRM4', 'HSPA9', 'ISCU', 'NFS1', 'NDUFAB1']
227	GO:BP	GO:0016226	iron-sulfur cluster assembly	9.379761214006902e-06	True	"""The incorporation of iron and exogenous sulfur into a metallo-sulfur cluster."" [GOC:jl, GOC:mah, GOC:pde, GOC:vw]"	29	97	5	17376	0.0515463917525773	0.1724137931034483	query_1	['GO:0006790', 'GO:0031163']	['LYRM4', 'HSPA9', 'ISCU', 'NFS1', 'NDUFAB1']
228	GO:BP	GO:0071103	DNA conformation change	1.0628692617192936e-05	True	"""A cellular process that results in a change in the spatial configuration of a DNA molecule. A conformation change can bend DNA, or alter the, twist, writhe, or linking number of a DNA molecule."" [GOC:mah]"	88	97	7	17376	0.0721649484536082	0.0795454545454545	query_1	['GO:0051276']	['NBN', 'RAD50', 'XRCC6', 'RPA1', 'BLM', 'MRE11', 'RAD51']
229	GO:CC	GO:0030870	Mre11 complex	1.0764515549550812e-05	True	"""Trimeric protein complex that possesses endonuclease activity; involved in meiotic recombination, DNA repair and checkpoint signaling. In Saccharomyces cerevisiae, the complex comprises Mre11p, Rad50p, and Xrs2p; complexes identified in other species generally contain proteins orthologous to the Saccharomyces cerevisiae proteins."" [GOC:mah, GOC:vw, PMID:11988766, PMID:17674145]"	5	97	3	17376	0.0309278350515463	0.6	query_1	['GO:0140513']	['NBN', 'RAD50', 'MRE11']
230	GO:BP	GO:0034982	mitochondrial protein processing	1.1034389370382063e-05	True	"""The peptide cleavage of mitochondrial proteins, including cleavage contributing to their import."" [GOC:curators]"	13	97	4	17376	0.0412371134020618	0.3076923076923077	query_1	['GO:0016485']	['SPG7', 'PMPCA', 'AFG3L2', 'PMPCB']
231	GO:BP	GO:0042762	regulation of sulfur metabolic process	1.1034389370382063e-05	True	"""Any process that modulates the frequency, rate or extent of the chemical reactions and pathways involving sulfur, the nonmetallic element sulfur or compounds that contain sulfur."" [GOC:go_curators]"	13	97	4	17376	0.0412371134020618	0.3076923076923077	query_1	['GO:0006790', 'GO:0031323']	['PDK4', 'PDK3', 'PDK1', 'PDK2']
232	GO:BP	GO:0018335	protein succinylation	1.1553267146217697e-05	True	"""The modification of a protein by the addition of a succinyl group (CO-CH2-CH2-CO) to an amino acid residue."" [GOC:bf]"	4	97	3	17376	0.0309278350515463	0.75	query_1	['GO:0043543']	['DLST', 'DLD', 'OGDH']
233	GO:BP	GO:0106077	histone succinylation	1.1553267146217697e-05	True	"""The modification of a histone by the addition of an succinyl group."" [PMID:29211711]"	4	97	3	17376	0.0309278350515463	0.75	query_1	['GO:0018335']	['DLST', 'DLD', 'OGDH']
234	GO:BP	GO:0031860	telomeric 3' overhang formation	1.1553267146217697e-05	True	"""The formation of the single stranded telomeric 3' overhang, a conserved feature that ranges in length from 12 nt in budding yeast to approximately 500 nt in humans."" [PMID:16096639]"	4	97	3	17376	0.0309278350515463	0.75	query_1	['GO:0016233', 'GO:0022616']	['NBN', 'RAD50', 'MRE11']
235	GO:CC	GO:0098687	chromosomal region	1.1727902744199231e-05	True	"""Any subdivision of a chromosome along its length."" [GOC:dos]"	392	97	12	17376	0.1237113402061855	0.0306122448979591	query_1	['GO:0005694', 'GO:0110165']	['NBN', 'TP53BP1', 'RAD50', 'XRCC6', 'H2AX', 'BRCA2', 'RPA1', 'FLYWCH1', 'BLM', 'MRE11', 'RAD51', 'CBX5']
236	GO:BP	GO:0061912	selective autophagy	1.1860908197249684e-05	True	"""The macroautophagy process in which specific structures are targeted by the autophagy process."" [PMID:20484971, PMID:21997368, PMID:22966490]"	90	97	7	17376	0.0721649484536082	0.0777777777777777	query_1	['GO:0016236']	['DDRGK1', 'UFL1', 'PHB2', 'VDAC1', 'HDAC6', 'UBA5', 'UFM1']
237	GO:BP	GO:0036211	protein modification process	1.2019721038227854e-05	True	"""The covalent alteration of one or more amino acids occurring in proteins, peptides and nascent polypeptides (co-translational, post-translational modifications). Includes the modification of charged tRNAs that are destined to occur in a protein (pre-translation modification)."" [GOC:bf, GOC:jl]"	3393	97	40	17376	0.4123711340206185	0.0117889773062186	query_1	['GO:0019538', 'GO:0043412']	['PPIF', 'SNX6', 'UBE2I', 'PDK4', 'GCSH', 'PPM1K', 'CDK5RAP3', 'NBN', 'DLST', 'RAD50', 'XRCC6', 'PAXIP1', 'SETDB2', 'DDRGK1', 'UFL1', 'PHB2', 'METTL21C', 'BRCA2', 'SETDB1', 'BCKDK', 'SUMO1', 'PDK3', 'BLM', 'PIAS1', 'MRE11', 'RAD51', 'HDAC6', 'MOCS3', 'PDK1', 'NFS1', 'NDUFAB1', 'BRCA1', 'DLD', 'PDK2', 'TRIM28', 'BARD1', 'UBA5', 'OGDH', 'PHB1', 'UFM1']
238	GO:BP	GO:0043401	steroid hormone mediated signaling pathway	1.309180236889914e-05	True	"""The series of molecular signals mediated by a steroid hormone binding to a receptor."" [PMID:12606724]"	133	97	8	17376	0.0824742268041237	0.0601503759398496	query_1	['GO:0009755', 'GO:0071383']	['DDRGK1', 'UFL1', 'PHB2', 'HDAC6', 'BRCA1', 'UBA5', 'PHB1', 'UFM1']
239	GO:BP	GO:0010165	response to X-ray	1.4590884014559943e-05	True	"""Any process that results in a change in state or activity of a cell or an organism (in terms of movement, secretion, enzyme production, gene expression, etc.) as a result of X-ray radiation. An X-ray is a form of electromagnetic radiation with a wavelength in the range of 10 nanometers to 100 picometers (corresponding to frequencies in the range 30 PHz to 3 EHz)."" [GOC:sm, Wikipedia:X-ray]"	32	97	5	17376	0.0515463917525773	0.15625	query_1	['GO:0010212']	['TP53BP1', 'XRCC6', 'BRCA2', 'BLM', 'RAD51']
240	GO:CC	GO:0000795	synaptonemal complex	1.4621249995573924e-05	True	"""A proteinaceous scaffold found between homologous chromosomes during meiosis. It consists of 2 lateral elements and a central element, all running parallel to each other. Transverse filaments connect the lateral elements to the central element."" [DOI:10.5772/29752, GOC:elh]"	39	97	5	17376	0.0515463917525773	0.1282051282051282	query_1	['GO:0099086']	['UBE2I', 'BRCA2', 'BLM', 'RAD51', 'BRCA1']
241	GO:CC	GO:0099086	synaptonemal structure	1.4621249995573924e-05	True	"""A proteinaceous scaffold found between homologous chromosomes during meiosis."" [GOC:elh, GOC:vw]"	39	97	5	17376	0.0515463917525773	0.1282051282051282	query_1	['GO:0000794', 'GO:0110165']	['UBE2I', 'BRCA2', 'BLM', 'RAD51', 'BRCA1']
242	GO:CC	GO:0005657	replication fork	1.6379535041093218e-05	True	"""The Y-shaped region of a replicating DNA molecule, resulting from the separation of the DNA strands and in which the synthesis of new strands takes place. Also includes associated protein complexes."" [GOC:mah, ISBN:0198547684]"	71	97	6	17376	0.0618556701030927	0.0845070422535211	query_1	['GO:0005694', 'GO:0110165']	['NBN', 'TP53BP1', 'H2AX', 'RPA1', 'BLM', 'MRE11']
243	GO:BP	GO:0009755	hormone-mediated signaling pathway	1.7535658276837056e-05	True	"""The series of molecular signals mediated by the detection of a hormone."" [GOC:sm]"	188	97	9	17376	0.0927835051546391	0.0478723404255319	query_1	['GO:0007165', 'GO:0032870']	['DDRGK1', 'UFL1', 'PHB2', 'METTL21C', 'HDAC6', 'BRCA1', 'UBA5', 'PHB1', 'UFM1']
244	GO:BP	GO:0000086	G2/M transition of mitotic cell cycle	1.792158992267795e-05	True	"""The mitotic cell cycle transition by which a cell in G2 commits to M phase. The process begins when the kinase activity of M cyclin/CDK complex reaches a threshold high enough for the cell cycle to proceed. This is accomplished by activating a positive feedback loop that results in the accumulation of unphosphorylated and active M cyclin/CDK complex."" [GOC:mtg_cell_cycle]"	139	97	8	17376	0.0824742268041237	0.0575539568345323	query_1	['GO:0044772', 'GO:0044839']	['RBBP8', 'CDK5RAP3', 'NBN', 'RAD50', 'BLM', 'MRE11', 'BRCA1', 'BARD1']
245	GO:CC	GO:0005737	cytoplasm	1.823220271823372e-05	True	"""The contents of a cell excluding the plasma membrane and nucleus, but including other subcellular structures."" [ISBN:0198547684]"	11219	97	83	17376	0.8556701030927835	0.0073981638292182	query_1	['GO:0005622', 'GO:0110165']	['PPIF', 'SNX6', 'UBE2I', 'PDK4', 'GCSH', 'SPG7', 'PPM1K', 'SNX1', 'LYRM4', 'ADSL', 'MAIP1', 'CDK5RAP3', 'NBN', 'OTC', 'ATF7IP', 'DLST', 'HSPA9', 'MCUB', 'TP53BP1', 'UBAC2', 'XRCC6', 'TALDO1', 'DLAT', 'PDHA2', 'PDHX', 'SETDB2', 'PDHB', 'DDRGK1', 'UFL1', 'PMPCA', 'PHB2', 'MCAT', 'METTL21C', 'SDHD', 'DBT', 'BRCA2', 'MCU', 'SIL1', 'SETDB1', 'BCKDK', 'CDNF', 'BCKDHB', 'PDHA1', 'SUMO1', 'HSPD1', 'PDK3', 'ARL14EP', 'FLYWCH1', 'BLM', 'MRE11', 'VDAC1', 'RAD51', 'AFG3L2', 'HDAC6', 'MOCS3', 'ISCU', 'GPD1', 'PDK1', 'NSUN6', 'SDHB', 'FAF2', 'NFS1', 'NDUFAB1', 'BRCA1', 'SDHA', 'MICU1', 'STAT5A', 'SMDT1', 'SDHC', 'DLD', 'PDK2', 'NDUFV3', 'BARD1', 'MICU2', 'MFN1', 'ABHD6', 'PMPCB', 'UBA5', 'OGDH', 'PHB1', 'UFM1', 'STAT5B', 'BCKDHA']
246	REAC	REAC:R-HSA-3232118	SUMOylation of transcription factors	1.8559068863054005e-05	True	SUMOylation of transcription factors	18	97	4	17376	0.0412371134020618	0.2222222222222222	query_1	['REAC:R-HSA-3108232']	['UBE2I', 'TP53BP1', 'SUMO1', 'PIAS1']
247	GO:CC	GO:0045252	oxoglutarate dehydrogenase complex	1.896766237329221e-05	True	"""A complex of multiple copies of three enzymatic components: oxoglutarate dehydrogenase (lipoamide) (E1), dihydrolipoamide S-succinyltransferase (E2) and dihydrolipoamide dehydrogenase (E3); catalyzes the overall conversion of 2-oxoglutarate to succinyl-CoA and carbon dioxide (CO2)."" [MetaCyc:CPLX66-42, PMID:10848975]"	6	97	3	17376	0.0309278350515463	0.5	query_1	['GO:0045240', 'GO:1990234']	['DLST', 'DLD', 'OGDH']
248	GO:BP	GO:0120263	positive regulation of heterochromatin organization	1.929582997678555e-05	True	"""Any process that activates or increases the frequency, rate or extent of heterochromatin organization."" [GOC:krc]"	15	97	4	17376	0.0412371134020618	0.2666666666666666	query_1	['GO:0070828', 'GO:0120261', 'GO:1905269']	['ATF7IP', 'SETDB2', 'SETDB1', 'TRIM28']
249	GO:BP	GO:0031453	positive regulation of heterochromatin formation	1.929582997678555e-05	True	"""Any process that activates or increases the frequency, rate or extent of heterochromatin formation."" [GOC:mah]"	15	97	4	17376	0.0412371134020618	0.2666666666666666	query_1	['GO:0031445', 'GO:0031507', 'GO:0044089', 'GO:0120263']	['ATF7IP', 'SETDB2', 'SETDB1', 'TRIM28']
250	GO:BP	GO:0005996	monosaccharide metabolic process	1.929582997678555e-05	True	"""The chemical reactions and pathways involving monosaccharides, the simplest carbohydrates. They are polyhydric alcohols containing either an aldehyde or a keto group and between three to ten or more carbon atoms. They form the constitutional repeating units of oligo- and polysaccharides."" [ISBN:0198506732]"	247	97	10	17376	0.1030927835051546	0.0404858299595141	query_1	['GO:0005975', 'GO:0044281']	['PDK4', 'DLAT', 'PDHA2', 'PDHB', 'BCKDK', 'PDHA1', 'PDK3', 'GPD1', 'PDK1', 'PDK2']
251	REAC	REAC:R-HSA-5633007	Regulation of TP53 Activity	2.167572397307008e-05	True	Regulation of TP53 Activity	160	97	8	17376	0.0824742268041237	0.05	query_1	['REAC:R-HSA-3700989']	['RBBP8', 'NBN', 'RAD50', 'RPA1', 'BLM', 'MRE11', 'BRCA1', 'BARD1']
252	GO:BP	GO:0007095	mitotic G2 DNA damage checkpoint signaling	2.2271100905932973e-05	True	"""A mitotic cell cycle checkpoint that detects and negatively regulates progression through the G2/M transition of the cell cycle in response to DNA damage."" [GOC:mtg_cell_cycle, PMID:16299494]"	35	97	5	17376	0.0515463917525773	0.1428571428571428	query_1	['GO:0044773', 'GO:0044818']	['CDK5RAP3', 'NBN', 'BLM', 'MRE11', 'BRCA1']
253	REAC	REAC:R-HSA-5693548	Sensing of DNA Double Strand Breaks	2.2646325621365656e-05	True	Sensing of DNA Double Strand Breaks	6	97	3	17376	0.0309278350515463	0.5	query_1	['REAC:R-HSA-5693606']	['NBN', 'RAD50', 'MRE11']
254	GO:BP	GO:0006950	response to stress	2.345354615901916e-05	True	"""Any process that results in a change in state or activity of a cell or an organism (in terms of movement, secretion, enzyme production, gene expression, etc.) as a result of a disturbance in organismal or cellular homeostasis, usually, but not necessarily, exogenous (e.g. temperature, humidity, ionizing radiation)."" [GOC:mah]"	3769	97	42	17376	0.4329896907216495	0.0111435394003714	query_1	['GO:0050896']	['PPIF', 'RBBP8', 'PDK4', 'ADSL', 'CDK5RAP3', 'NBN', 'HSPA9', 'TP53BP1', 'RAD50', 'UBAC2', 'XRCC6', 'PAXIP1', 'H2AX', 'DDRGK1', 'UFL1', 'MDC1', 'PHB2', 'SDHD', 'BRCA2', 'SUMO1', 'HSPD1', 'RPA1', 'PDK3', 'FLYWCH1', 'BLM', 'MRE11', 'VDAC1', 'RAD51', 'HDAC6', 'PDK1', 'FAF2', 'CBX5', 'BRCA1', 'MICU1', 'STAT5A', 'PDK2', 'TRIM28', 'BARD1', 'UBA5', 'PHB1', 'UFM1', 'STAT5B']
255	GO:BP	GO:1905269	positive regulation of chromatin organization	2.479053902814912e-05	True	"""Any process that activates or increases the frequency, rate or extent of chromatin organization."" [GO_REF:0000058, GOC:pr, GOC:TermGenie, GOC:vw, PMID:654321]"	16	97	4	17376	0.0412371134020618	0.25	query_1	['GO:0006325', 'GO:1902275', 'GO:2001252']	['ATF7IP', 'SETDB2', 'SETDB1', 'TRIM28']
256	GO:BP	GO:0061709	reticulophagy	2.479053902814912e-05	True	"""The selective autohagy process in which parts of the endoplasmic reticulum are loaded into autophagosomes, delivered to the vacuole, and degraded in response to changing cellular conditions."" [GOC:autophagy, GOC:dph, PMID:22481944, PMID:24060720, PMID:26040717]"	16	97	4	17376	0.0412371134020618	0.25	query_1	['GO:0061912', 'GO:1903008']	['DDRGK1', 'UFL1', 'UBA5', 'UFM1']
257	GO:BP	GO:0044572	[4Fe-4S] cluster assembly	2.611648711677337e-05	True	"""The incorporation of four iron atoms and four sulfur atoms into an iron-sulfur cluster."" [GOC:jl, GOC:mengo_curators, GOC:pde, GOC:tt, GOC:vw, PMID:15952888]"	5	97	3	17376	0.0309278350515463	0.6	query_1	['GO:0016226']	['LYRM4', 'ISCU', 'NFS1']
258	GO:BP	GO:0010564	regulation of cell cycle process	2.705905845224756e-05	True	"""Any process that modulates a cellular process that is involved in the progression of biochemical and morphological phases and events that occur in a cell during successive cell replication or nuclear replication events."" [GOC:dph, GOC:tb]"	707	97	16	17376	0.1649484536082474	0.0226308345120226	query_1	['GO:0022402', 'GO:0051726']	['RBBP8', 'CDK5RAP3', 'NBN', 'TP53BP1', 'RAD50', 'PAXIP1', 'H2AX', 'DDRGK1', 'MDC1', 'PHB2', 'BRCA2', 'BLM', 'MRE11', 'RAD51', 'BRCA1', 'BARD1']
259	GO:BP	GO:0042776	proton motive force-driven mitochondrial ATP synthesis	2.7660987576917304e-05	True	"""The transport of protons across a mitochondrial membrane to generate an electrochemical gradient (proton-motive force) that powers ATP synthesis."" [GOC:mtg_sensu, ISBN:0716731363]"	66	97	6	17376	0.0618556701030927	0.0909090909090909	query_1	['GO:0006119', 'GO:0015986']	['SDHD', 'SDHB', 'NDUFAB1', 'SDHA', 'SDHC', 'NDUFV3']
260	GO:BP	GO:0070588	calcium ion transmembrane transport	3.010825604667156e-05	True	"""A process in which a calcium ion is transported from one side of a membrane to the other by means of some agent such as a transporter or pore."" [GOC:mah]"	325	97	11	17376	0.1134020618556701	0.0338461538461538	query_1	['GO:0006816', 'GO:0098655', 'GO:0098662']	['MAIP1', 'MCUB', 'METTL21C', 'MCU', 'SUMO1', 'VDAC1', 'AFG3L2', 'MICU1', 'SMDT1', 'MICU2', 'PMPCB']
261	REAC	REAC:R-HSA-1640170	Cell Cycle	3.06619402992563e-05	True	Cell Cycle	673	97	15	17376	0.1546391752577319	0.0222882615156017	query_1	['REAC:0000000']	['RBBP8', 'UBE2I', 'NBN', 'TP53BP1', 'RAD50', 'H2AX', 'MDC1', 'BRCA2', 'SUMO1', 'RPA1', 'BLM', 'MRE11', 'RAD51', 'BRCA1', 'BARD1']
262	GO:CC	GO:0005757	mitochondrial permeability transition pore complex	3.2435049946080804e-05	True	"""A protein complex that connects the inner and outer membranes of animal mitochondria and acts as a pore that can open transiently to allow free diffusion of solutes between the mitochondrial matrix and the cytosol. The pore complex is formed of the voltage-dependent anion channel (VDAC), the adenine nucleotide translocase (ANT) and cyclophilin-D (CyP-D)."" [PMID:10393078]"	7	97	3	17376	0.0309278350515463	0.4285714285714285	query_1	['GO:0005740', 'GO:0046930', 'GO:0098798']	['PPIF', 'SPG7', 'VDAC1']
263	GO:CC	GO:1990391	DNA repair complex	3.387223191046242e-05	True	"""A protein complex involved in DNA repair processes including direct reversal, base excision repair, nucleotide excision repair, photoreactivation, bypass, double-strand break repair pathway, and mismatch repair pathway."" [GOC:bhm, PMID:17217467, PMID:20551348, PMID:22749910, PMID:24192350]"	22	97	4	17376	0.0412371134020618	0.1818181818181818	query_1	['GO:1902494']	['TP53BP1', 'XRCC6', 'BRCA2', 'BRCA1']
264	GO:BP	GO:0071383	cellular response to steroid hormone stimulus	3.5692318466706094e-05	True	"""Any process that results in a change in state or activity of a cell (in terms of movement, secretion, enzyme production, gene expression, etc.) as a result of a steroid hormone stimulus."" [GOC:mah]"	207	97	9	17376	0.0927835051546391	0.0434782608695652	query_1	['GO:0032870', 'GO:0048545', 'GO:0071396', 'GO:0071407']	['DDRGK1', 'UFL1', 'PHB2', 'METTL21C', 'HDAC6', 'BRCA1', 'UBA5', 'PHB1', 'UFM1']
265	GO:CC	GO:0005654	nucleoplasm	3.6121256677657057e-05	True	"""That part of the nuclear content other than the chromosomes or the nucleolus."" [GOC:ma, ISBN:0124325653]"	3986	97	42	17376	0.4329896907216495	0.0105368790767686	query_1	['GO:0031981', 'GO:0110165']	['RBBP8', 'UBE2I', 'LYRM4', 'NBN', 'ATF7IP', 'DLST', 'MCUB', 'TP53BP1', 'RAD50', 'ZNF45', 'ZNF350', 'XRCC6', 'PAXIP1', 'SETDB2', 'PDHB', 'H2AX', 'MDC1', 'BRCA2', 'SETDB1', 'BCKDHB', 'SUMO1', 'RPA1', 'ARL14EP', 'FLYWCH1', 'BLM', 'PIAS1', 'MRE11', 'RAD51', 'HDAC6', 'SDHB', 'NFS1', 'CBX5', 'NDUFAB1', 'BRCA1', 'STAT5A', 'SMDT1', 'PDK2', 'MBD1', 'TRIM28', 'BARD1', 'PHB1', 'STAT5B']
266	GO:BP	GO:0000723	telomere maintenance	3.732865989742546e-05	True	"""Any process that contributes to the maintenance of proper telomeric length and structure by affecting and monitoring the activity of telomeric proteins, the length of telomeric DNA and the replication and repair of the DNA. These processes includes those that shorten, lengthen, replicate and repair the telomeric DNA sequences."" [GOC:BHF, GOC:BHF_telomere, GOC:elh, GOC:rl, PMID:11092831]"	155	97	8	17376	0.0824742268041237	0.0516129032258064	query_1	['GO:0006259', 'GO:0032200']	['NBN', 'RAD50', 'XRCC6', 'BRCA2', 'RPA1', 'BLM', 'MRE11', 'RAD51']
267	GO:BP	GO:0090308	regulation of DNA methylation-dependent heterochromatin formation	3.949427209025303e-05	True	"""Any process that modulates the rate, frequency, or extent of DNA methylation-dependent heterochromatin formation."" [GOC:BHF]"	18	97	4	17376	0.0412371134020618	0.2222222222222222	query_1	['GO:0006346', 'GO:0031445']	['ATF7IP', 'SETDB2', 'SETDB1', 'TRIM28']
268	GO:BP	GO:0006260	DNA replication	4.244888826012816e-05	True	"""The cellular metabolic process in which a cell duplicates one or more molecules of DNA. DNA replication begins when specific sequences, known as origins of replication, are recognized and bound by the origin recognition complex, and ends when the original DNA molecule has been completely duplicated and the copies topologically separated. The unit of replication usually corresponds to the genome of the cell, an organelle, or a virus. The template for replication can either be an existing DNA molecule or RNA."" [GOC:mah]"	272	97	10	17376	0.1030927835051546	0.0367647058823529	query_1	['GO:0006259']	['RBBP8', 'NBN', 'RAD50', 'BRCA2', 'RPA1', 'BLM', 'MRE11', 'RAD51', 'BRCA1', 'BARD1']
269	GO:BP	GO:2001252	positive regulation of chromosome organization	4.522070002254936e-05	True	"""Any process that activates or increases the frequency, rate or extent of chromosome organization."" [GOC:obol]"	112	97	7	17376	0.0721649484536082	0.0625	query_1	['GO:0010638', 'GO:0033044', 'GO:0051276']	['NBN', 'ATF7IP', 'RAD50', 'SETDB2', 'SETDB1', 'MRE11', 'TRIM28']
270	GO:BP	GO:0035518	histone H2A monoubiquitination	4.888404828784488e-05	True	"""The modification of histone H2A by addition of a single ubiquitin group."" [PMID:18206970]"	19	97	4	17376	0.0412371134020618	0.2105263157894736	query_1	['GO:0010390', 'GO:0033522']	['BRCA2', 'RAD51', 'BRCA1', 'BARD1']
271	GO:BP	GO:0015986	proton motive force-driven ATP synthesis	5.172213390181936e-05	True	"""The transport of protons across a membrane to generate an electrochemical gradient (proton-motive force) that powers ATP synthesis."" [ISBN:0716731363]"	74	97	6	17376	0.0618556701030927	0.081081081081081	query_1	['GO:0006754']	['SDHD', 'SDHB', 'NDUFAB1', 'SDHA', 'SDHC', 'NDUFV3']
272	GO:CC	GO:0098803	respiratory chain complex	5.4736750159261246e-05	True	"""Any protein complex that is part of a respiratory chain."" [GOC:dos]"	89	97	6	17376	0.0618556701030927	0.0674157303370786	query_1	['GO:0070469', 'GO:0098796']	['SDHD', 'SDHB', 'NDUFAB1', 'SDHA', 'SDHC', 'NDUFV3']
273	GO:CC	GO:0005746	mitochondrial respirasome	6.510691140596416e-05	True	"""The protein complexes that form the mitochondrial electron transport system (the respiratory chain), associated with the inner mitochondrial membrane. The respiratory chain complexes transfer electrons from an electron donor to an electron acceptor and are associated with a proton pump to create a transmembrane electrochemical gradient."" [GOC:curators, GOC:ecd, ISBN:0198547684]"	92	97	6	17376	0.0618556701030927	0.0652173913043478	query_1	['GO:0005743', 'GO:0070469']	['SDHD', 'SDHB', 'NDUFAB1', 'SDHA', 'SDHC', 'NDUFV3']
274	GO:BP	GO:0045930	negative regulation of mitotic cell cycle	6.759016266765568e-05	True	"""Any process that stops, prevents or reduces the rate or extent of progression through the mitotic cell cycle."" [GOC:dph, GOC:go_curators, GOC:tb]"	225	97	9	17376	0.0927835051546391	0.04	query_1	['GO:0000278', 'GO:0007346', 'GO:0045786']	['RBBP8', 'CDK5RAP3', 'NBN', 'RAD50', 'MDC1', 'BLM', 'MRE11', 'BRCA1', 'BARD1']
275	GO:BP	GO:0045934	negative regulation of nucleobase-containing compound metabolic process	7.283809483260876e-05	True	"""Any cellular process that stops, prevents, or reduces the frequency, rate or extent of the chemical reactions and pathways involving nucleobases, nucleosides, nucleotides and nucleic acids."" [GOC:go_curators]"	1481	97	23	17376	0.2371134020618556	0.0155300472653612	query_1	['GO:0006139', 'GO:0019219', 'GO:0031324', 'GO:0051172']	['RBBP8', 'SNX6', 'UBE2I', 'NBN', 'ATF7IP', 'TP53BP1', 'RAD50', 'ZNF350', 'XRCC6', 'SETDB2', 'PHB2', 'SETDB1', 'SUMO1', 'FLYWCH1', 'BLM', 'PIAS1', 'HDAC6', 'CBX5', 'BRCA1', 'MBD1', 'TRIM28', 'BARD1', 'PHB1']
276	GO:CC	GO:0005694	chromosome	8.927504729700712e-05	True	"""A structure composed of a very long molecule of DNA and associated proteins (e.g. histones) that carries hereditary information."" [ISBN:0198547684]"	1834	97	25	17376	0.2577319587628865	0.0136314067611777	query_1	['GO:0043232']	['RBBP8', 'UBE2I', 'NBN', 'TP53BP1', 'RAD50', 'XRCC6', 'PAXIP1', 'SETDB2', 'H2AX', 'UFL1', 'MDC1', 'BRCA2', 'SETDB1', 'SUMO1', 'RPA1', 'FLYWCH1', 'BLM', 'MRE11', 'RAD51', 'CBX5', 'BRCA1', 'STAT5A', 'MBD1', 'TRIM28', 'STAT5B']
277	GO:CC	GO:0070469	respirasome	9.038829603031112e-05	True	"""The protein complexes that form the electron transport system (the respiratory chain), associated with a cell membrane, usually the plasma membrane (in prokaryotes) or the inner mitochondrial membrane (on eukaryotes). The respiratory chain complexes transfer electrons from an electron donor to an electron acceptor and are associated with a proton pump to create a transmembrane electrochemical gradient."" [GOC:ecd, GOC:mah, ISBN:0198547684, Wikipedia:Respirasome]"	98	97	6	17376	0.0618556701030927	0.0612244897959183	query_1	['GO:0016020', 'GO:0110165']	['SDHD', 'SDHB', 'NDUFAB1', 'SDHA', 'SDHC', 'NDUFV3']
278	GO:BP	GO:0000018	regulation of DNA recombination	9.59139788399209e-05	True	"""Any process that modulates the frequency, rate or extent of DNA recombination, a DNA metabolic process in which a new genotype is formed by reassortment of genes resulting in gene combinations different from those that were present in the parents."" [GOC:go_curators, ISBN:0198506732]"	126	97	7	17376	0.0721649484536082	0.0555555555555555	query_1	['GO:0006310', 'GO:0051052']	['RBBP8', 'TP53BP1', 'RAD50', 'PAXIP1', 'BLM', 'MRE11', 'RAD51']
279	GO:BP	GO:1901991	negative regulation of mitotic cell cycle phase transition	9.850587220400767e-05	True	"""Any process that stops, prevents or reduces the frequency, rate or extent of mitotic cell cycle phase transition."" [GOC:mtg_cell_cycle, GOC:TermGenie, PMID:22841721]"	178	97	8	17376	0.0824742268041237	0.0449438202247191	query_1	['GO:0044772', 'GO:0045930', 'GO:1901988', 'GO:1901990']	['RBBP8', 'CDK5RAP3', 'NBN', 'RAD50', 'BLM', 'MRE11', 'BRCA1', 'BARD1']
280	GO:BP	GO:0051054	positive regulation of DNA metabolic process	9.907206059819687e-05	True	"""Any process that activates or increases the frequency, rate or extent of the chemical reactions and pathways involving DNA."" [GOC:ai]"	301	97	10	17376	0.1030927835051546	0.0332225913621262	query_1	['GO:0006259', 'GO:0010604', 'GO:0045935', 'GO:0051052']	['RBBP8', 'NBN', 'TP53BP1', 'RAD50', 'PAXIP1', 'H2AX', 'MRE11', 'RAD51', 'BRCA1', 'TRIM28']
281	GO:BP	GO:0046395	carboxylic acid catabolic process	9.93244128723562e-05	True	"""The chemical reactions and pathways resulting in the breakdown of carboxylic acids, any organic acid containing one or more carboxyl (-COOH) groups."" [ISBN:0198506732]"	237	97	9	17376	0.0927835051546391	0.0379746835443038	query_1	['GO:0016054', 'GO:0019752']	['GCSH', 'OTC', 'DLST', 'MCAT', 'DBT', 'BCKDK', 'BCKDHB', 'DLD', 'BCKDHA']
282	GO:BP	GO:0016054	organic acid catabolic process	9.93244128723562e-05	True	"""The chemical reactions and pathways resulting in the breakdown of organic acids, any acidic compound containing carbon in covalent linkage."" [ISBN:0198506732]"	237	97	9	17376	0.0927835051546391	0.0379746835443038	query_1	['GO:0006082', 'GO:0044248', 'GO:0044282', 'GO:1901575']	['GCSH', 'OTC', 'DLST', 'MCAT', 'DBT', 'BCKDK', 'BCKDHB', 'DLD', 'BCKDHA']
283	GO:BP	GO:0019538	protein metabolic process	9.955195666977192e-05	True	"""The chemical reactions and pathways involving a protein. Includes protein modification."" [GOC:ma]"	5057	97	49	17376	0.5051546391752577	0.0096895392525212	query_1	['GO:0043170', 'GO:0044238', 'GO:1901564']	['PPIF', 'SNX6', 'UBE2I', 'PDK4', 'GCSH', 'SPG7', 'PPM1K', 'SNX1', 'CDK5RAP3', 'NBN', 'DLST', 'RAD50', 'UBAC2', 'XRCC6', 'PAXIP1', 'SETDB2', 'DDRGK1', 'UFL1', 'PMPCA', 'PHB2', 'METTL21C', 'BRCA2', 'SETDB1', 'BCKDK', 'SUMO1', 'HSPD1', 'PDK3', 'BLM', 'PIAS1', 'MRE11', 'RAD51', 'AFG3L2', 'HDAC6', 'MOCS3', 'PDK1', 'FAF2', 'NFS1', 'NDUFAB1', 'BRCA1', 'DLD', 'PDK2', 'TRIM28', 'BARD1', 'PEPD', 'PMPCB', 'UBA5', 'OGDH', 'PHB1', 'UFM1']
284	GO:CC	GO:0000793	condensed chromosome	0.0001078788692708	True	"""A highly compacted molecule of DNA and associated proteins resulting in a cytologically distinct structure."" [GOC:elh]"	273	97	9	17376	0.0927835051546391	0.0329670329670329	query_1	['GO:0005694']	['UBE2I', 'TP53BP1', 'RAD50', 'H2AX', 'BRCA2', 'BLM', 'RAD51', 'CBX5', 'BRCA1']
285	GO:BP	GO:0044773	mitotic DNA damage checkpoint signaling	0.0001101138172698	True	"""A signal transduction process involved in mitotic DNA damage checkpoint."" [GOC:mtg_cell_cycle, GOC:TermGenie]"	85	97	6	17376	0.0618556701030927	0.0705882352941176	query_1	['GO:0000077', 'GO:0044774']	['CDK5RAP3', 'NBN', 'MDC1', 'BLM', 'MRE11', 'BRCA1']
286	REAC	REAC:R-HSA-212436	Generic Transcription Pathway	0.0001113567638691	True	Generic Transcription Pathway	1151	97	19	17376	0.1958762886597938	0.0165073848827106	query_1	['REAC:R-HSA-73857']	['RBBP8', 'UBE2I', 'NBN', 'RAD50', 'ZNF45', 'ZNF350', 'H2AX', 'MDC1', 'SUMO1', 'HSPD1', 'RPA1', 'BLM', 'MRE11', 'RAD51', 'HDAC6', 'CBX5', 'BRCA1', 'TRIM28', 'BARD1']
287	GO:BP	GO:0071478	cellular response to radiation	0.0001119129406301	True	"""Any process that results in a change in state or activity of a cell (in terms of movement, secretion, enzyme production, gene expression, etc.) as a result of an electromagnetic radiation stimulus. Electromagnetic radiation is a propagating wave in space with electric and magnetic components. These components oscillate at right angles to each other and to the direction of propagation."" [GOC:mah]"	182	97	8	17376	0.0824742268041237	0.0439560439560439	query_1	['GO:0009314', 'GO:0071214']	['TP53BP1', 'XRCC6', 'H2AX', 'BRCA2', 'BLM', 'RAD51', 'BRCA1', 'BARD1']
288	GO:BP	GO:0006312	mitotic recombination	0.0001199962493488	True	"""The exchange, reciprocal or nonreciprocal, of genetic material between one DNA molecule and a homologous DNA region that occurs during mitotic cell cycles."" [GOC:elh]"	24	97	4	17376	0.0412371134020618	0.1666666666666666	query_1	['GO:0006310']	['RAD50', 'BRCA2', 'MRE11', 'RAD51']
289	GO:BP	GO:0032200	telomere organization	0.0001199962493488	True	"""A process that is carried out at the cellular level which results in the assembly, arrangement of constituent parts, or disassembly of telomeres, terminal regions of a linear chromosome that include the telomeric DNA repeats and associated proteins."" [GOC:dph, GOC:jl, GOC:mah]"	184	97	8	17376	0.0824742268041237	0.0434782608695652	query_1	['GO:0051276']	['NBN', 'RAD50', 'XRCC6', 'BRCA2', 'RPA1', 'BLM', 'MRE11', 'RAD51']
290	GO:BP	GO:0120261	regulation of heterochromatin organization	0.0001199962493488	True	"""Any process that modulates the frequency, rate, extent or location of heterochromatin organization."" [GOC:krc]"	24	97	4	17376	0.0412371134020618	0.1666666666666666	query_1	['GO:0070828', 'GO:1902275']	['ATF7IP', 'SETDB2', 'SETDB1', 'TRIM28']
291	GO:BP	GO:0031445	regulation of heterochromatin formation	0.0001199962493488	True	"""Any process that modulates the frequency, rate, extent or location of heterochromatin formation."" [GOC:mah]"	24	97	4	17376	0.0412371134020618	0.1666666666666666	query_1	['GO:0010468', 'GO:0031507', 'GO:0120261']	['ATF7IP', 'SETDB2', 'SETDB1', 'TRIM28']
292	REAC	REAC:R-HSA-611105	Respiratory electron transport	0.0001301956339891	True	Respiratory electron transport	100	97	6	17376	0.0618556701030927	0.06	query_1	['REAC:R-HSA-163200']	['SDHD', 'SDHB', 'NDUFAB1', 'SDHA', 'SDHC', 'NDUFV3']
293	GO:BP	GO:0044774	mitotic DNA integrity checkpoint signaling	0.0001388352659788	True	"""A signaling process that controls cell cycle progression in response to changes in DNA structure by monitoring the integrity of the DNA during mitosis. The DNA integrity checkpoint begins with detection of DNA damage, defects in DNA structure or DNA replication, and ends with signal transduction."" [GOC:mtg_cell_cycle]"	89	97	6	17376	0.0618556701030927	0.0674157303370786	query_1	['GO:0007093', 'GO:0031570']	['CDK5RAP3', 'NBN', 'MDC1', 'BLM', 'MRE11', 'BRCA1']
294	GO:BP	GO:0006346	DNA methylation-dependent heterochromatin formation	0.0001406442749612	True	"""Repression of transcription by methylation of DNA, leading to the formation of heterochromatin."" [GOC:mah]"	25	97	4	17376	0.0412371134020618	0.16	query_1	['GO:0140718']	['ATF7IP', 'SETDB2', 'SETDB1', 'TRIM28']
295	GO:CC	GO:0035632	mitochondrial prohibitin complex	0.0001449170576719	True	"""A complex composed of two proteins, prohibitin 1 and prohibitin 2 (PHB1/PHB-1 and PHB2/PHB-2) that is highly conserved amongst eukaryotes and associated with the inner mitochondrial membrane. The mitochondrial prohibitin complex is a macromolecular supercomplex composed of repeating heterodimeric subunits of PHB1 and PHB2. The mitochondrial prohibitin complex plays a role in a number of biological processes, including mitochondrial biogenesis and function, development, replicative senescence, and cell death."" [GOC:kmv, PMID:12237468, PMID:21164222]"	2	97	2	17376	0.0206185567010309	1.0	query_1	['GO:0098800']	['PHB2', 'PHB1']
296	GO:CC	GO:0005745	m-AAA complex	0.0001449170576719	True	"""Protease complex of the mitochondrial inner membrane that is involved in mitochondrial protein turnover and in processing of proteins imported into mitochondria."" [GOC:mcc, PMID:12417197, PMID:21147776]"	2	97	2	17376	0.0206185567010309	1.0	query_1	['GO:0098800', 'GO:1905368']	['SPG7', 'AFG3L2']
297	GO:CC	GO:0017087	mitochondrial processing peptidase complex	0.0001449170576719	True	"""A protein complex consisting of a regulatory subunit (alpha-MPP) and a catalytic subunit (beta-MPP) that catalyzes the release of N-terminal targeting peptides from precursor proteins imported into the mitochondrion."" [GOC:mah]"	2	97	2	17376	0.0206185567010309	1.0	query_1	['GO:0005759', 'GO:0098798', 'GO:1902494']	['PMPCA', 'PMPCB']
298	GO:CC	GO:0005634	nucleus	0.0001477046741605	True	"""A membrane-bounded organelle of eukaryotic cells in which chromosomes are housed and replicated. In most cells, the nucleus contains all of the cell's chromosomes except the organellar chromosomes, and is the site of RNA synthesis and processing. In some species, or in specialized cell types, RNA metabolism or DNA replication may be absent."" [GOC:go_curators]"	7163	97	60	17376	0.6185567010309279	0.0083763786123132	query_1	['GO:0043231']	['RBBP8', 'SNX6', 'UBE2I', 'LYRM4', 'CDK5RAP3', 'NBN', 'ATF7IP', 'DLST', 'HSPA9', 'MCUB', 'TP53BP1', 'RAD50', 'ZNF45', 'ZNF350', 'XRCC6', 'TALDO1', 'PAXIP1', 'PDHA2', 'SETDB2', 'PDHB', 'H2AX', 'DDRGK1', 'UFL1', 'MDC1', 'PHB2', 'METTL21C', 'BRCA2', 'SETDB1', 'BCKDHB', 'PDHA1', 'SUMO1', 'RPA1', 'PDK3', 'ARL14EP', 'FLYWCH1', 'BLM', 'PIAS1', 'MRE11', 'VDAC1', 'RAD51', 'HDAC6', 'ISCU', 'SDHB', 'NFS1', 'CBX5', 'NDUFAB1', 'BRCA1', 'SDHA', 'STAT5A', 'SMDT1', 'DLD', 'PDK2', 'MBD1', 'TRIM28', 'BARD1', 'UBA5', 'OGDH', 'PHB1', 'UFM1', 'STAT5B']
299	GO:BP	GO:1903008	organelle disassembly	0.0001532266783381	True	"""The disaggregation of an organelle into its constituent components."" [GO_REF:0000079, GOC:TermGenie]"	137	97	7	17376	0.0721649484536082	0.0510948905109489	query_1	['GO:0006996', 'GO:0022411']	['DDRGK1', 'UFL1', 'PHB2', 'VDAC1', 'HDAC6', 'UBA5', 'UFM1']
300	GO:BP	GO:2000001	regulation of DNA damage checkpoint	0.0001636671361519	True	"""Any process that modulates the frequency, rate or extent of a DNA damage checkpoint."" [GOC:obol]"	26	97	4	17376	0.0412371134020618	0.1538461538461538	query_1	['GO:0000077', 'GO:0080135', 'GO:1901976']	['BRCA2', 'RAD51', 'BRCA1', 'BARD1']
301	REAC	REAC:R-HSA-71064	Lysine catabolism	0.0001704502590654	True	Lysine catabolism	11	97	3	17376	0.0309278350515463	0.2727272727272727	query_1	['REAC:R-HSA-71291']	['DLST', 'DLD', 'OGDH']
302	GO:CC	GO:0000228	nuclear chromosome	0.0001818345588705	True	"""A chromosome that encodes the nuclear genome and is found in the nucleus of a eukaryotic cell during the cell cycle phases when the nucleus is intact."" [GOC:dph, GOC:mah]"	227	97	8	17376	0.0824742268041237	0.0352422907488986	query_1	['GO:0005694', 'GO:0031981']	['UBE2I', 'RAD50', 'H2AX', 'BRCA2', 'RPA1', 'BLM', 'RAD51', 'BRCA1']
303	GO:CC	GO:0034704	calcium channel complex	0.0001856533977251	True	"""An ion channel complex through which calcium ions pass."" [GOC:mah]"	69	97	5	17376	0.0515463917525773	0.072463768115942	query_1	['GO:0034703']	['MCUB', 'MCU', 'MICU1', 'SMDT1', 'MICU2']
304	REAC	REAC:R-HSA-9699150	Defective DNA double strand break response due to BARD1 loss of function	0.0001886614465333	True	Defective DNA double strand break response due to BARD1 loss of function	2	97	2	17376	0.0206185567010309	1.0	query_1	['REAC:R-HSA-9675136']	['BRCA1', 'BARD1']
305	REAC	REAC:R-HSA-9663199	Defective DNA double strand break response due to BRCA1 loss of function	0.0001886614465333	True	Defective DNA double strand break response due to BRCA1 loss of function	2	97	2	17376	0.0206185567010309	1.0	query_1	['REAC:R-HSA-9675136']	['BRCA1', 'BARD1']
306	GO:BP	GO:0009056	catabolic process	0.000197427853004	True	"""The chemical reactions and pathways resulting in the breakdown of substances, including the breakdown of carbon compounds with the liberation of energy for use by the cell or organism."" [ISBN:0198547684]"	2441	97	30	17376	0.3092783505154639	0.0122900450634985	query_1	['GO:0008152']	['SNX6', 'UBE2I', 'GCSH', 'SNX1', 'CDK5RAP3', 'OTC', 'DLST', 'UBAC2', 'DDRGK1', 'UFL1', 'PHB2', 'MCAT', 'DBT', 'BCKDK', 'BCKDHB', 'SUMO1', 'PIAS1', 'VDAC1', 'HDAC6', 'GPD1', 'FAF2', 'DLD', 'BARD1', 'ABHD6', 'PEPD', 'UBA5', 'OGDH', 'PHB1', 'UFM1', 'BCKDHA']
307	GO:BP	GO:0048545	response to steroid hormone	0.000213237455078	True	"""Any process that results in a change in state or activity of a cell or an organism (in terms of movement, secretion, enzyme production, gene expression, etc.) as a result of a steroid hormone stimulus."" [GOC:go_curators]"	332	97	10	17376	0.1030927835051546	0.0301204819277108	query_1	['GO:0009725', 'GO:0014070', 'GO:0033993']	['DDRGK1', 'UFL1', 'PHB2', 'METTL21C', 'BCKDHB', 'HDAC6', 'BRCA1', 'UBA5', 'PHB1', 'UFM1']
308	GO:BP	GO:0033522	histone H2A ubiquitination	0.0002174342088428	True	"""The modification of histone H2A by addition of one or more ubiquitin groups."" [GOC:bf, GOC:mah, PMID:15509584, PMID:16473935, PMID:18430235]"	28	97	4	17376	0.0412371134020618	0.1428571428571428	query_1	['GO:0016574']	['BRCA2', 'RAD51', 'BRCA1', 'BARD1']
309	GO:BP	GO:0007346	regulation of mitotic cell cycle	0.0002174342088428	True	"""Any process that modulates the rate or extent of progress through the mitotic cell cycle."" [GOC:dph, GOC:go_curators, GOC:tb]"	487	97	12	17376	0.1237113402061855	0.0246406570841889	query_1	['GO:0000278', 'GO:0051726']	['RBBP8', 'CDK5RAP3', 'NBN', 'RAD50', 'MDC1', 'PHB2', 'BRCA2', 'BLM', 'MRE11', 'BRCA1', 'BARD1', 'STAT5B']
310	REAC	REAC:R-HSA-8953750	Transcriptional Regulation by E2F6	0.0002239050089818	True	Transcriptional Regulation by E2F6	34	97	4	17376	0.0412371134020618	0.1176470588235294	query_1	['REAC:R-HSA-212436']	['RBBP8', 'RAD51', 'CBX5', 'BRCA1']
311	GO:BP	GO:0031324	negative regulation of cellular metabolic process	0.0002459465599901	True	"""Any process that stops, prevents, or reduces the frequency, rate or extent of the chemical reactions and pathways by which individual cells transform chemical substances."" [GOC:mah]"	2089	97	27	17376	0.2783505154639175	0.0129248444231689	query_1	['GO:0009892', 'GO:0031323', 'GO:0044237', 'GO:0048523']	['PPIF', 'RBBP8', 'SNX6', 'UBE2I', 'CDK5RAP3', 'NBN', 'ATF7IP', 'TP53BP1', 'RAD50', 'ZNF350', 'XRCC6', 'SETDB2', 'PHB2', 'SETDB1', 'BCKDK', 'SUMO1', 'FLYWCH1', 'BLM', 'PIAS1', 'VDAC1', 'HDAC6', 'CBX5', 'BRCA1', 'MBD1', 'TRIM28', 'BARD1', 'PHB1']
312	GO:BP	GO:0006754	ATP biosynthetic process	0.0002579823569337	True	"""The chemical reactions and pathways resulting in the formation of ATP, adenosine 5'-triphosphate, a universally important coenzyme and enzyme regulator."" [GOC:go_curators, ISBN:0198506732]"	100	97	6	17376	0.0618556701030927	0.06	query_1	['GO:0009152', 'GO:0009206', 'GO:0046034']	['SDHD', 'SDHB', 'NDUFAB1', 'SDHA', 'SDHC', 'NDUFV3']
313	GO:BP	GO:0042180	cellular ketone metabolic process	0.000262163729491	True	"""The chemical reactions and pathways involving any of a class of organic compounds that contain the carbonyl group, CO, and in which the carbonyl group is bonded only to carbon atoms, as carried out by individual cells. The general formula for a ketone is RCOR, where R and R are alkyl or aryl groups."" [GOC:jl, ISBN:0787650153]"	207	97	8	17376	0.0824742268041237	0.038647342995169	query_1	['GO:0044237', 'GO:0044281', 'GO:0071704']	['PDK4', 'BCKDK', 'PDK3', 'GPD1', 'PDK1', 'BRCA1', 'PDK2', 'STAT5B']
314	GO:BP	GO:0006816	calcium ion transport	0.0002625958841255	True	"""The directed movement of calcium (Ca) ions into, out of or within a cell, or between cells, by means of some agent such as a transporter or pore."" [GOC:ai]"	417	97	11	17376	0.1134020618556701	0.026378896882494	query_1	['GO:0030001', 'GO:0071702']	['MAIP1', 'MCUB', 'METTL21C', 'MCU', 'SUMO1', 'VDAC1', 'AFG3L2', 'MICU1', 'SMDT1', 'MICU2', 'PMPCB']
315	GO:BP	GO:0006886	intracellular protein transport	0.0002710658007381	True	"""The directed movement of proteins in a cell, including the movement of proteins between specific compartments or structures within a cell, such as organelles of a eukaryotic cell."" [GOC:mah]"	863	97	16	17376	0.1649484536082474	0.0185399768250289	query_1	['GO:0008104', 'GO:0015031', 'GO:0046907']	['SNX6', 'SNX1', 'MAIP1', 'HSPA9', 'UBAC2', 'PMPCA', 'PHB2', 'SIL1', 'SUMO1', 'HSPD1', 'HDAC6', 'FAF2', 'TRIM28', 'BARD1', 'PMPCB', 'UFM1']
316	GO:BP	GO:0032870	cellular response to hormone stimulus	0.0002722828718372	True	"""Any process that results in a change in state or activity of a cell (in terms of movement, secretion, enzyme production, gene expression, etc.) as a result of a hormone stimulus."" [GOC:mah]"	585	97	13	17376	0.134020618556701	0.0222222222222222	query_1	['GO:0009725', 'GO:0071310', 'GO:0071495']	['PDK4', 'DDRGK1', 'UFL1', 'PHB2', 'METTL21C', 'HDAC6', 'BRCA1', 'STAT5A', 'PDK2', 'UBA5', 'PHB1', 'UFM1', 'STAT5B']
317	GO:BP	GO:0006520	amino acid metabolic process	0.0002796274039048	True	"""The chemical reactions and pathways involving amino acids, carboxylic acids containing one or more amino groups."" [ISBN:0198506732]"	274	97	9	17376	0.0927835051546391	0.0328467153284671	query_1	['GO:0019752', 'GO:0044238', 'GO:1901564']	['GCSH', 'OTC', 'DLST', 'DBT', 'BCKDK', 'BCKDHB', 'DLD', 'PEPD', 'BCKDHA']
318	GO:BP	GO:0032446	protein modification by small protein conjugation	0.0002863416580446	True	"""A protein modification process in which one or more groups of a small protein, such as ubiquitin or a ubiquitin-like protein, are covalently attached to a target protein."" [GOC:mah]"	868	97	16	17376	0.1649484536082474	0.0184331797235023	query_1	['GO:0070647']	['UBE2I', 'CDK5RAP3', 'PAXIP1', 'DDRGK1', 'UFL1', 'BRCA2', 'SUMO1', 'PIAS1', 'RAD51', 'HDAC6', 'MOCS3', 'BRCA1', 'TRIM28', 'BARD1', 'UBA5', 'UFM1']
319	GO:BP	GO:0002377	immunoglobulin production	0.0003108586784258	True	"""The appearance of immunoglobulin due to biosynthesis or secretion following a cellular stimulus, resulting in an increase in its intracellular or extracellular levels."" [GOC:add, ISBN:0781735149]"	104	97	6	17376	0.0618556701030927	0.0576923076923076	query_1	['GO:0002440']	['NBN', 'TP53BP1', 'PAXIP1', 'PHB2', 'HSPD1', 'PHB1']
320	GO:BP	GO:0010390	histone monoubiquitination	0.0003128447787116	True	"""The modification of histones by addition of a single ubiquitin group."" [PMID:17329563]"	31	97	4	17376	0.0412371134020618	0.1290322580645161	query_1	['GO:0006513', 'GO:0016574']	['BRCA2', 'RAD51', 'BRCA1', 'BARD1']
321	GO:BP	GO:0009205	purine ribonucleoside triphosphate metabolic process	0.0003133327256919	True	"""The chemical reactions and pathways involving purine ribonucleoside triphosphate, a compound consisting of a purine base linked to a ribose sugar esterified with triphosphate on the sugar."" [GOC:go_curators, ISBN:0198506732]"	155	97	7	17376	0.0721649484536082	0.0451612903225806	query_1	['GO:0009144', 'GO:0009199']	['SDHD', 'SDHB', 'NDUFAB1', 'SDHA', 'SDHC', 'NDUFV3', 'MFN1']
322	GO:CC	GO:0001741	XY body	0.0003228905763912	True	"""A structure found in a male mammalian spermatocyte containing an unpaired X chromosome that has become densely heterochromatic, silenced and localized at the nuclear periphery."" [GOC:hjd, GOC:mr, PMID:20622855, Wikipedia:XY_sex-determination_system]"	15	97	3	17376	0.0309278350515463	0.2	query_1	['GO:0000803']	['H2AX', 'SUMO1', 'BRCA1']
323	GO:BP	GO:0051561	positive regulation of mitochondrial calcium ion concentration	0.0003244823712114	True	"""Any process that increases the concentration of calcium ions in mitochondria."" [GOC:ai]"	11	97	3	17376	0.0309278350515463	0.2727272727272727	query_1	['GO:0051560']	['MCU', 'MICU1', 'MICU2']
324	GO:BP	GO:0035966	response to topologically incorrect protein	0.0003244823712114	True	"""Any process that results in a change in state or activity of a cell or an organism (in terms of movement, secretion, enzyme production, gene expression, etc.) as a result of a protein that is not folded in its correct three-dimensional structure."" [GOC:bf]"	156	97	7	17376	0.0721649484536082	0.0448717948717948	query_1	['GO:0006950', 'GO:0010033']	['CDK5RAP3', 'HSPA9', 'DDRGK1', 'UFL1', 'HSPD1', 'HDAC6', 'FAF2']
325	GO:BP	GO:1901565	organonitrogen compound catabolic process	0.0003298997306115	True	"""The chemical reactions and pathways resulting in the breakdown of organonitrogen compound."" [GOC:pr, GOC:TermGenie]"	1301	97	20	17376	0.2061855670103092	0.0153727901614142	query_1	['GO:1901564', 'GO:1901575']	['UBE2I', 'GCSH', 'SNX1', 'CDK5RAP3', 'OTC', 'DLST', 'UBAC2', 'DDRGK1', 'UFL1', 'DBT', 'BCKDK', 'BCKDHB', 'SUMO1', 'PIAS1', 'HDAC6', 'FAF2', 'DLD', 'BARD1', 'PHB1', 'BCKDHA']
326	GO:BP	GO:0009628	response to abiotic stimulus	0.0003322308463195	True	"""Any process that results in a change in state or activity of a cell or an organism (in terms of movement, secretion, enzyme production, gene expression, etc.) as a result of an abiotic (not derived from living organisms) stimulus."" [GOC:hb]"	1086	97	18	17376	0.1855670103092783	0.0165745856353591	query_1	['GO:0050896']	['ADSL', 'TP53BP1', 'XRCC6', 'PAXIP1', 'H2AX', 'PHB2', 'SDHD', 'BRCA2', 'SUMO1', 'HSPD1', 'PDK3', 'BLM', 'RAD51', 'PDK1', 'BRCA1', 'MICU1', 'BARD1', 'GJA10']
327	GO:BP	GO:0051052	regulation of DNA metabolic process	0.0003467834946559	True	"""Any process that modulates the frequency, rate or extent of the chemical reactions and pathways involving DNA."" [GOC:ai]"	515	97	12	17376	0.1237113402061855	0.0233009708737864	query_1	['GO:0006259', 'GO:0019219', 'GO:0060255']	['RBBP8', 'NBN', 'TP53BP1', 'RAD50', 'PAXIP1', 'H2AX', 'BLM', 'MRE11', 'RAD51', 'BRCA1', 'TRIM28', 'BARD1']
328	GO:BP	GO:1990426	mitotic recombination-dependent replication fork processing	0.0003605537745456	True	"""Replication fork processing that includes recombination between DNA near the arrested fork and homologous sequences. Proteins involved in homologous recombination are required for replication restart."" [GOC:mah, PMID:23093942]"	2	97	2	17376	0.0206185567010309	1.0	query_1	['GO:0031297', 'GO:1990505']	['BRCA2', 'RAD51']
329	GO:BP	GO:1990505	mitotic DNA replication maintenance of fidelity	0.0003605537745456	True	"""Any maintenance of fidelity that is involved in mitotic cell cycle DNA replication."" [PMID:19185548]"	2	97	2	17376	0.0206185567010309	1.0	query_1	['GO:1902298', 'GO:1902969', 'GO:1903047']	['BRCA2', 'RAD51']
330	GO:BP	GO:1902298	cell cycle DNA replication maintenance of fidelity	0.0003605537745456	True	"""Any maintenance of fidelity that is involved in cell cycle DNA replication."" [GOC:mtg_cell_cycle, GOC:TermGenie]"	2	97	2	17376	0.0206185567010309	1.0	query_1	['GO:0022402', 'GO:0044786', 'GO:0045005']	['BRCA2', 'RAD51']
331	GO:BP	GO:0009144	purine nucleoside triphosphate metabolic process	0.0003672747955228	True	"""The chemical reactions and pathways involving purine nucleoside triphosphate, a compound consisting of a purine base linked to a ribose or deoxyribose sugar esterified with triphosphate on the sugar."" [GOC:go_curators, ISBN:0198506732]"	160	97	7	17376	0.0721649484536082	0.04375	query_1	['GO:0009141']	['SDHD', 'SDHB', 'NDUFAB1', 'SDHA', 'SDHC', 'NDUFV3', 'MFN1']
332	GO:BP	GO:0005975	carbohydrate metabolic process	0.0003717850155914	True	"""The chemical reactions and pathways involving carbohydrates, any of a group of organic compounds based of the general formula Cx(H2O)y."" [GOC:mah, ISBN:0198506732]"	520	97	12	17376	0.1237113402061855	0.023076923076923	query_1	['GO:0044238', 'GO:0071704']	['PDK4', 'TALDO1', 'DLAT', 'PDHA2', 'PDHB', 'BCKDK', 'PDHA1', 'PDK3', 'GPD1', 'PDK1', 'PDK2', 'OGDH']
333	GO:BP	GO:0009206	purine ribonucleoside triphosphate biosynthetic process	0.0003800695280669	True	"""The chemical reactions and pathways resulting in the formation of purine ribonucleoside triphosphate, a compound consisting of a purine base linked to a ribose sugar esterified with triphosphate on the sugar."" [GOC:go_curators, ISBN:0198506732]"	109	97	6	17376	0.0618556701030927	0.055045871559633	query_1	['GO:0009145', 'GO:0009201', 'GO:0009205']	['SDHD', 'SDHB', 'NDUFAB1', 'SDHA', 'SDHC', 'NDUFV3']
334	REAC	REAC:R-HSA-163200	Respiratory electron transport, ATP synthesis by chemiosmotic coupling, and heat production by uncoupling proteins.	0.0003849358715041	True	Respiratory electron transport, ATP synthesis by chemiosmotic coupling, and heat production by uncoupling proteins.	123	97	6	17376	0.0618556701030927	0.048780487804878	query_1	['REAC:R-HSA-1428517']	['SDHD', 'SDHB', 'NDUFAB1', 'SDHA', 'SDHC', 'NDUFV3']
335	REAC	REAC:R-HSA-73857	RNA Polymerase II Transcription	0.0003895084174152	True	RNA Polymerase II Transcription	1272	97	19	17376	0.1958762886597938	0.0149371069182389	query_1	['REAC:R-HSA-74160']	['RBBP8', 'UBE2I', 'NBN', 'RAD50', 'ZNF45', 'ZNF350', 'H2AX', 'MDC1', 'SUMO1', 'HSPD1', 'RPA1', 'BLM', 'MRE11', 'RAD51', 'HDAC6', 'CBX5', 'BRCA1', 'TRIM28', 'BARD1']
336	GO:BP	GO:0009199	ribonucleoside triphosphate metabolic process	0.0003900503060409	True	"""The chemical reactions and pathways involving a ribonucleoside triphosphate, a compound consisting of a nucleobase linked to a ribose sugar esterified with triphosphate on the sugar."" [GOC:go_curators, ISBN:0198506732]"	162	97	7	17376	0.0721649484536082	0.0432098765432098	query_1	['GO:0009141']	['SDHD', 'SDHB', 'NDUFAB1', 'SDHA', 'SDHC', 'NDUFV3', 'MFN1']
337	GO:BP	GO:0030522	intracellular receptor signaling pathway	0.0003900503060409	True	"""The series of molecular signals initiated by a ligand binding to a receptor located within a cell."" [GOC:bf, GOC:mah]"	289	97	9	17376	0.0927835051546391	0.0311418685121107	query_1	['GO:0007165']	['DDRGK1', 'UFL1', 'PHB2', 'PDK3', 'HDAC6', 'BRCA1', 'UBA5', 'PHB1', 'UFM1']
338	GO:BP	GO:0009145	purine nucleoside triphosphate biosynthetic process	0.0003944560277031	True	"""The chemical reactions and pathways resulting in the formation of purine nucleoside triphosphate, a compound consisting of a purine base linked to a ribose or deoxyribose sugar esterified with triphosphate on the sugar."" [GOC:go_curators, ISBN:0198506732]"	110	97	6	17376	0.0618556701030927	0.0545454545454545	query_1	['GO:0009142', 'GO:0009144']	['SDHD', 'SDHB', 'NDUFAB1', 'SDHA', 'SDHC', 'NDUFV3']
339	GO:BP	GO:0051276	chromosome organization	0.0004283160908347	True	"""A process that is carried out at the cellular level that results in the assembly, arrangement of constituent parts, or disassembly of chromosomes, structures composed of a very long molecule of DNA and associated proteins that carries hereditary information. This term covers covalent modifications at the molecular level as well as spatial relationships among the major components of a chromosome."" [GOC:ai, GOC:dph, GOC:jl, GOC:mah]"	617	97	13	17376	0.134020618556701	0.0210696920583468	query_1	['GO:0006996']	['NBN', 'ATF7IP', 'RAD50', 'XRCC6', 'SETDB2', 'PHB2', 'BRCA2', 'SETDB1', 'RPA1', 'BLM', 'MRE11', 'RAD51', 'TRIM28']
340	GO:BP	GO:0009201	ribonucleoside triphosphate biosynthetic process	0.0004995510672641	True	"""The chemical reactions and pathways resulting in the formation of a ribonucleoside triphosphate, a compound consisting of a nucleobase linked to a ribose sugar esterified with triphosphate on the sugar."" [GOC:go_curators, ISBN:0198506732]"	115	97	6	17376	0.0618556701030927	0.0521739130434782	query_1	['GO:0009142', 'GO:0009199']	['SDHD', 'SDHB', 'NDUFAB1', 'SDHA', 'SDHC', 'NDUFV3']
341	GO:BP	GO:0035967	cellular response to topologically incorrect protein	0.0004995510672641	True	"""Any process that results in a change in state or activity of a cell (in terms of movement, secretion, enzyme production, gene expression, etc.) as a result of a protein that is not folded in its correct three-dimensional structure."" [GOC:bf]"	115	97	6	17376	0.0618556701030927	0.0521739130434782	query_1	['GO:0033554', 'GO:0035966', 'GO:0071310']	['CDK5RAP3', 'HSPA9', 'DDRGK1', 'UFL1', 'HSPD1', 'HDAC6']
342	REAC	REAC:R-HSA-382551	Transport of small molecules	0.0005380698052415	True	Transport of small molecules	675	97	13	17376	0.134020618556701	0.0192592592592592	query_1	['REAC:0000000']	['SPG7', 'MAIP1', 'MCUB', 'PMPCA', 'PHB2', 'MCU', 'VDAC1', 'AFG3L2', 'MICU1', 'SMDT1', 'MICU2', 'PMPCB', 'PHB1']
343	REAC	REAC:R-HSA-5696395	Formation of Incision Complex in GG-NER	0.0005380698052415	True	Formation of Incision Complex in GG-NER	43	97	4	17376	0.0412371134020618	0.0930232558139534	query_1	['REAC:R-HSA-5696399']	['UBE2I', 'SUMO1', 'RPA1', 'PIAS1']
344	GO:BP	GO:0019219	regulation of nucleobase-containing compound metabolic process	0.0005613960052826	True	"""Any cellular process that modulates the frequency, rate or extent of the chemical reactions and pathways involving nucleobases, nucleosides, nucleotides and nucleic acids."" [GOC:go_curators]"	3716	97	38	17376	0.3917525773195876	0.0102260495156081	query_1	['GO:0006139', 'GO:0031323', 'GO:0051171', 'GO:0080090']	['RBBP8', 'SNX6', 'UBE2I', 'PDK4', 'CDK5RAP3', 'NBN', 'ATF7IP', 'TP53BP1', 'RAD50', 'ZNF45', 'ZNF350', 'XRCC6', 'PAXIP1', 'SETDB2', 'H2AX', 'DDRGK1', 'UFL1', 'PHB2', 'BRCA2', 'SETDB1', 'SUMO1', 'PDK3', 'FLYWCH1', 'BLM', 'PIAS1', 'MRE11', 'RAD51', 'HDAC6', 'PDK1', 'CBX5', 'BRCA1', 'STAT5A', 'PDK2', 'MBD1', 'TRIM28', 'BARD1', 'PHB1', 'STAT5B']
345	GO:BP	GO:0030808	regulation of nucleotide biosynthetic process	0.0005775172350708	True	"""Any process that modulates the frequency, rate or extent of the chemical reactions and pathways resulting in the formation of nucleotides."" [GOC:mah]"	37	97	4	17376	0.0412371134020618	0.1081081081081081	query_1	['GO:0006140', 'GO:0009165', 'GO:0031326']	['PDK4', 'PDK3', 'PDK1', 'PDK2']
346	GO:BP	GO:1900371	regulation of purine nucleotide biosynthetic process	0.0005775172350708	True	"""Any process that modulates the frequency, rate or extent of purine nucleotide biosynthetic processes."" [GOC:go_curators, GOC:TermGenie]"	37	97	4	17376	0.0412371134020618	0.1081081081081081	query_1	['GO:0006164', 'GO:0030808', 'GO:1900542']	['PDK4', 'PDK3', 'PDK1', 'PDK2']
347	GO:CC	GO:0000152	nuclear ubiquitin ligase complex	0.0005894040050048	True	"""A ubiquitin ligase complex found in the nucleus."" [GOC:mah]"	47	97	4	17376	0.0412371134020618	0.0851063829787234	query_1	['GO:0000151', 'GO:0140513']	['BRCA2', 'RAD51', 'BRCA1', 'BARD1']
348	GO:BP	GO:0140718	facultative heterochromatin formation	0.000639732867522	True	"""The compaction of chromatin into a conformation that is refactory to transcription but that be converted to euchromatin and allow transcription in specific contexts. These can be temporal (e.g., developmental states or specific cell-cycle stages), spatial (e.g., nuclear localization changes from the center to the periphery or vice versa due to exogenous factors/signals), or parental/heritable (e.g., monoallelic gene expression)."" [PMID:17936700]"	38	97	4	17376	0.0412371134020618	0.1052631578947368	query_1	['GO:0031507']	['ATF7IP', 'SETDB2', 'SETDB1', 'TRIM28']
349	GO:BP	GO:0000722	telomere maintenance via recombination	0.0006419896006569	True	"""Any recombinational process that contributes to the maintenance of proper telomeric length."" [GOC:elh, PMID:11850777]"	14	97	3	17376	0.0309278350515463	0.2142857142857142	query_1	['GO:0000723', 'GO:0006312']	['RAD50', 'BRCA2', 'RAD51']
350	GO:BP	GO:0071407	cellular response to organic cyclic compound	0.000653144665233	True	"""Any process that results in a change in state or activity of a cell (in terms of movement, secretion, enzyme production, gene expression, etc.) as a result of an organic cyclic compound stimulus."" [GOC:mah]"	555	97	12	17376	0.1237113402061855	0.0216216216216216	query_1	['GO:0014070', 'GO:0071310']	['DDRGK1', 'UFL1', 'PHB2', 'METTL21C', 'BLM', 'RAD51', 'HDAC6', 'GPD1', 'BRCA1', 'UBA5', 'PHB1', 'UFM1']
351	GO:BP	GO:0009141	nucleoside triphosphate metabolic process	0.000653144665233	True	"""The chemical reactions and pathways involving a nucleoside triphosphate, a compound consisting of a nucleobase linked to a deoxyribose or ribose sugar esterified with triphosphate on the sugar."" [GOC:go_curators, ISBN:0198506732]"	177	97	7	17376	0.0721649484536082	0.03954802259887	query_1	['GO:0006753']	['SDHD', 'SDHB', 'NDUFAB1', 'SDHA', 'SDHC', 'NDUFV3', 'MFN1']
352	GO:BP	GO:0048523	negative regulation of cellular process	0.0006557467605227	True	"""Any process that stops, prevents, or reduces the frequency, rate or extent of a cellular process, any of those that are carried out at the cellular level, but are not necessarily restricted to a single cell. For example, cell communication occurs among more than one cell, but occurs at the cellular level."" [GOC:jid]"	4496	97	43	17376	0.4432989690721649	0.0095640569395017	query_1	['GO:0009987', 'GO:0048519', 'GO:0050794']	['PPIF', 'RBBP8', 'SNX6', 'UBE2I', 'PDK4', 'CDK5RAP3', 'NBN', 'ATF7IP', 'HSPA9', 'TP53BP1', 'RAD50', 'UBAC2', 'ZNF350', 'XRCC6', 'SETDB2', 'H2AX', 'DDRGK1', 'UFL1', 'MDC1', 'PHB2', 'METTL21C', 'BRCA2', 'SETDB1', 'BCKDK', 'SUMO1', 'HSPD1', 'FLYWCH1', 'BLM', 'PIAS1', 'MRE11', 'VDAC1', 'RAD51', 'HDAC6', 'ISCU', 'CBX5', 'BRCA1', 'MBD1', 'TRIM28', 'BARD1', 'ABHD6', 'PHB1', 'UFM1', 'STAT5B']
353	GO:BP	GO:0009725	response to hormone	0.0007082657135217	True	"""Any process that results in a change in state or activity of a cell or an organism (in terms of movement, secretion, enzyme production, gene expression, etc.) as a result of a hormone stimulus."" [GOC:jl]"	845	97	15	17376	0.1546391752577319	0.0177514792899408	query_1	['GO:0009719', 'GO:0010033']	['PDK4', 'OTC', 'DDRGK1', 'UFL1', 'PHB2', 'METTL21C', 'BCKDHB', 'HDAC6', 'BRCA1', 'STAT5A', 'PDK2', 'UBA5', 'PHB1', 'UFM1', 'STAT5B']
354	GO:BP	GO:0009142	nucleoside triphosphate biosynthetic process	0.0007272022717199	True	"""The chemical reactions and pathways resulting in the formation of a nucleoside triphosphate, a compound consisting of a nucleobase linked to a deoxyribose or ribose sugar esterified with triphosphate on the sugar."" [GOC:go_curators, ISBN:0198506732]"	124	97	6	17376	0.0618556701030927	0.0483870967741935	query_1	['GO:0009141', 'GO:1901293']	['SDHD', 'SDHB', 'NDUFAB1', 'SDHA', 'SDHC', 'NDUFV3']
355	GO:CC	GO:0031436	BRCA1-BARD1 complex	0.0007659167549264	True	"""A heterodimeric complex comprising BRCA1 and BARD1, which possesses ubiquitin ligase activity and is involved in genome maintenance, possibly by functioning in surveillance for DNA damage."" [PMID:12787778]"	4	97	2	17376	0.0206185567010309	0.5	query_1	['GO:0000152']	['BRCA1', 'BARD1']
356	GO:CC	GO:0030905	retromer, tubulation complex	0.0007659167549264	True	"""The dimeric subcomplex of the retromer, believed to be peripherally associated with the membrane. This dimeric complex is responsible for remodelling endosomal membranes to form a tube-structure to which cargo molecules are selected for recycling. The budding yeast complex comprises Vps5p and Vps17p, and may contain multiple copies of a Vps5p/Vps17p dimer. The mammalian complex contains SNX1 or SNX2 dimerized with SNX5 or SNX6."" [GOC:bf, PMID:26220253, PMID:9700157]"	4	97	2	17376	0.0206185567010309	0.5	query_1	['GO:0030904', 'GO:0098796']	['SNX6', 'SNX1']
357	GO:CC	GO:0070532	BRCA1-B complex	0.0007659167549264	True	"""A protein complex that contains the BRCA1-BARD1 heterodimer, BACH1 and TopBP1, and binds to DNA during S phase at DNA damage sites."" [GOC:mah, PMID:16391231]"	4	97	2	17376	0.0206185567010309	0.5	query_1	['GO:0140513']	['BRCA1', 'BARD1']
358	GO:CC	GO:0140513	nuclear protein-containing complex	0.0007798360877453	True	"""A stable assembly of two or more macromolecules, i.e. proteins, nucleic acids, carbohydrates or lipids, in which at least one component is a protein and the constituent parts function together in the nucleus."" [GOC:pg]"	1261	97	18	17376	0.1855670103092783	0.014274385408406	query_1	['GO:0005634', 'GO:0032991']	['RBBP8', 'UBE2I', 'NBN', 'RAD50', 'XRCC6', 'PAXIP1', 'BRCA2', 'SUMO1', 'RPA1', 'MRE11', 'RAD51', 'HDAC6', 'CBX5', 'BRCA1', 'STAT5A', 'TRIM28', 'BARD1', 'STAT5B']
359	GO:BP	GO:0010565	regulation of cellular ketone metabolic process	0.0007913517547019	True	"""Any process that modulates the chemical reactions and pathways involving any of a class of organic compounds that contain the carbonyl group, CO, and in which the carbonyl group is bonded only to carbon atoms. The general formula for a ketone is RCOR, where R and R are alkyl or aryl groups."" [GOC:dph, GOC:tb]"	126	97	6	17376	0.0618556701030927	0.0476190476190476	query_1	['GO:0031323', 'GO:0042180', 'GO:0062012']	['PDK4', 'BCKDK', 'PDK3', 'PDK1', 'BRCA1', 'PDK2']
360	GO:BP	GO:0051172	negative regulation of nitrogen compound metabolic process	0.0008445972926663	True	"""Any process that stops, prevents, or reduces the frequency, rate or extent of the chemical reactions and pathways involving nitrogen or nitrogenous compounds."" [GOC:ai, GOC:tb]"	2264	97	27	17376	0.2783505154639175	0.0119257950530035	query_1	['GO:0006807', 'GO:0009892', 'GO:0051171']	['RBBP8', 'SNX6', 'UBE2I', 'CDK5RAP3', 'NBN', 'ATF7IP', 'TP53BP1', 'RAD50', 'ZNF350', 'XRCC6', 'SETDB2', 'DDRGK1', 'UFL1', 'PHB2', 'SETDB1', 'BCKDK', 'SUMO1', 'FLYWCH1', 'BLM', 'PIAS1', 'HDAC6', 'CBX5', 'BRCA1', 'MBD1', 'TRIM28', 'BARD1', 'PHB1']
361	GO:BP	GO:0050801	monoatomic ion homeostasis	0.0008908558545443	True	"""Any process involved in the maintenance of an internal steady state of monoatomic ions within an organism or cell. Monatomic ions (also called simple ions) are ions consisting of exactly one atom."" [GOC:ai]"	575	97	12	17376	0.1237113402061855	0.0208695652173913	query_1	['GO:0048878']	['PDK4', 'MAIP1', 'OTC', 'MCUB', 'METTL21C', 'MCU', 'AFG3L2', 'ISCU', 'MICU1', 'SMDT1', 'PDK2', 'MICU2']
362	GO:BP	GO:0098662	inorganic cation transmembrane transport	0.0009135634932902	True	"""A process in which an inorganic cation is transported from one side of a membrane to the other by means of some agent such as a transporter or pore."" [GOC:mah]"	766	97	14	17376	0.1443298969072164	0.0182767624020887	query_1	['GO:0098660']	['PPIF', 'MAIP1', 'MCUB', 'PHB2', 'METTL21C', 'MCU', 'SUMO1', 'VDAC1', 'AFG3L2', 'ISCU', 'MICU1', 'SMDT1', 'MICU2', 'PMPCB']
363	GO:BP	GO:0104004	cellular response to environmental stimulus	0.0009444541065037	True	"""Any process that results in a change in state or activity of a cell (in terms of movement, secretion, enzyme production, gene expression, etc.) as a result of an environmental stimulus."" [GOC:dos]"	328	97	9	17376	0.0927835051546391	0.0274390243902439	query_1	['GO:0051716']	['TP53BP1', 'XRCC6', 'H2AX', 'BRCA2', 'BLM', 'RAD51', 'BRCA1', 'MICU1', 'BARD1']
364	GO:BP	GO:0071214	cellular response to abiotic stimulus	0.0009444541065037	True	"""Any process that results in a change in state or activity of a cell (in terms of movement, secretion, enzyme production, gene expression, etc.) as a result of an abiotic (non-living) stimulus."" [GOC:mah]"	328	97	9	17376	0.0927835051546391	0.0274390243902439	query_1	['GO:0009628', 'GO:0104004']	['TP53BP1', 'XRCC6', 'H2AX', 'BRCA2', 'BLM', 'RAD51', 'BRCA1', 'MICU1', 'BARD1']
365	REAC	REAC:R-HSA-3700989	Transcriptional Regulation by TP53	0.0009560614996043	True	Transcriptional Regulation by TP53	357	97	9	17376	0.0927835051546391	0.0252100840336134	query_1	['REAC:R-HSA-212436']	['RBBP8', 'NBN', 'RAD50', 'MDC1', 'RPA1', 'BLM', 'MRE11', 'BRCA1', 'BARD1']
366	GO:BP	GO:1901990	regulation of mitotic cell cycle phase transition	0.0009623691754244	True	"""Any process that modulates the frequency, rate or extent of mitotic cell cycle phase transition."" [GOC:mtg_cell_cycle, GOC:TermGenie, PMID:22841721]"	329	97	9	17376	0.0927835051546391	0.0273556231003039	query_1	['GO:0007346', 'GO:0044772', 'GO:1901987']	['RBBP8', 'CDK5RAP3', 'NBN', 'RAD50', 'PHB2', 'BLM', 'MRE11', 'BRCA1', 'BARD1']
367	GO:BP	GO:0051726	regulation of cell cycle	0.000983074327522	True	"""Any process that modulates the rate or extent of progression through the cell cycle."" [GOC:ai, GOC:dph, GOC:tb]"	1084	97	17	17376	0.1752577319587628	0.0156826568265682	query_1	['GO:0007049', 'GO:0050794']	['RBBP8', 'CDK5RAP3', 'NBN', 'TP53BP1', 'RAD50', 'PAXIP1', 'H2AX', 'DDRGK1', 'MDC1', 'PHB2', 'BRCA2', 'BLM', 'MRE11', 'RAD51', 'BRCA1', 'BARD1', 'STAT5B']
368	REAC	REAC:R-HSA-6783984	Glycine degradation	0.0010063277976561	True	Glycine degradation	4	97	2	17376	0.0206185567010309	0.5	query_1	['REAC:R-HSA-389661']	['GCSH', 'DLD']
369	GO:CC	GO:1902495	transmembrane transporter complex	0.0010449060285534	True	"""A transmembrane protein complex which enables the transfer of a substance from one side of a membrane to the other."" [GOC:bhm, GOC:TermGenie, PMID:18024586]"	377	97	9	17376	0.0927835051546391	0.0238726790450928	query_1	['GO:0098796', 'GO:1990351']	['MCUB', 'MCU', 'SUMO1', 'NDUFAB1', 'MICU1', 'SMDT1', 'NDUFV3', 'MICU2', 'ABHD6']
370	GO:BP	GO:0080135	regulation of cellular response to stress	0.0010604756176341	True	"""Any process that modulates the frequency, rate or extent of a cellular response to stress. Cellular response to stress is a change in state or activity of a cell (in terms of movement, secretion, enzyme production, gene expression, etc.) as a result of a stimulus indicating the organism is under stress. The stress is usually, but not necessarily, exogenous (e.g. temperature, humidity, ionizing radiation)."" [GOC:dhl]"	681	97	13	17376	0.134020618556701	0.0190895741556534	query_1	['GO:0033554', 'GO:0050794', 'GO:0080134']	['RBBP8', 'TP53BP1', 'H2AX', 'DDRGK1', 'UFL1', 'BRCA2', 'VDAC1', 'RAD51', 'HDAC6', 'BRCA1', 'MICU1', 'TRIM28', 'BARD1']
371	GO:BP	GO:0046034	ATP metabolic process	0.0010604756176341	True	"""The chemical reactions and pathways involving ATP, adenosine triphosphate, a universally important coenzyme and enzyme regulator."" [GOC:go_curators]"	134	97	6	17376	0.0618556701030927	0.044776119402985	query_1	['GO:0009150', 'GO:0009205']	['SDHD', 'SDHB', 'NDUFAB1', 'SDHA', 'SDHC', 'NDUFV3']
372	GO:BP	GO:0006986	response to unfolded protein	0.0010604756176341	True	"""Any process that results in a change in state or activity of a cell or an organism (in terms of movement, secretion, enzyme production, gene expression, etc.) as a result of an unfolded protein stimulus."" [GOC:jl]"	134	97	6	17376	0.0618556701030927	0.044776119402985	query_1	['GO:0035966']	['CDK5RAP3', 'HSPA9', 'DDRGK1', 'UFL1', 'HSPD1', 'FAF2']
373	GO:BP	GO:0090317	negative regulation of intracellular protein transport	0.0010604756176341	True	"""Any process that decreases the frequency, rate or extent of the directed movement of proteins within cells."" [GOC:tb]"	44	97	4	17376	0.0412371134020618	0.0909090909090909	query_1	['GO:0006886', 'GO:0032387', 'GO:0033157', 'GO:0051224']	['UBAC2', 'SUMO1', 'BARD1', 'UFM1']
374	REAC	REAC:R-HSA-9609507	Protein localization	0.0011245519559213	True	Protein localization	152	97	6	17376	0.0618556701030927	0.0394736842105263	query_1	['REAC:0000000']	['OTC', 'HSPA9', 'PMPCA', 'HSPD1', 'VDAC1', 'PMPCB']
375	GO:BP	GO:0098655	monoatomic cation transmembrane transport	0.0011537969837492	True	"""The process in which a monoatomic cation is transported across a membrane. Monatomic cations (also called simple cations) are positively charged ions consisting of exactly one atom."" [GOC:dos, GOC:vw]"	786	97	14	17376	0.1443298969072164	0.0178117048346055	query_1	['GO:0006812', 'GO:0034220']	['PPIF', 'MAIP1', 'MCUB', 'PHB2', 'METTL21C', 'MCU', 'SUMO1', 'VDAC1', 'AFG3L2', 'ISCU', 'MICU1', 'SMDT1', 'MICU2', 'PMPCB']
376	GO:BP	GO:0070647	protein modification by small protein conjugation or removal	0.0011701883553793	True	"""A protein modification process in which one or more groups of a small protein, such as ubiquitin or a ubiquitin-like protein, are covalently attached to or removed from a target protein."" [GOC:mah]"	994	97	16	17376	0.1649484536082474	0.0160965794768611	query_1	['GO:0036211']	['UBE2I', 'CDK5RAP3', 'PAXIP1', 'DDRGK1', 'UFL1', 'BRCA2', 'SUMO1', 'PIAS1', 'RAD51', 'HDAC6', 'MOCS3', 'BRCA1', 'TRIM28', 'BARD1', 'UBA5', 'UFM1']
377	GO:CC	GO:0031090	organelle membrane	0.0012069220394	True	"""A membrane that is one of the two lipid bilayers of an organelle envelope or the outermost membrane of single membrane bound organelle."" [GOC:dos, GOC:mah]"	3435	97	34	17376	0.3505154639175257	0.0098981077147016	query_1	['GO:0016020', 'GO:0043227']	['PPIF', 'SNX6', 'SPG7', 'SNX1', 'MAIP1', 'OTC', 'HSPA9', 'MCUB', 'UBAC2', 'DDRGK1', 'UFL1', 'PMPCA', 'PHB2', 'SDHD', 'MCU', 'SUMO1', 'HSPD1', 'VDAC1', 'AFG3L2', 'SDHB', 'FAF2', 'NDUFAB1', 'SDHA', 'MICU1', 'SMDT1', 'SDHC', 'NDUFV3', 'MICU2', 'MFN1', 'ABHD6', 'PMPCB', 'UBA5', 'OGDH', 'PHB1']
378	GO:CC	GO:0005730	nucleolus	0.001237656883965	True	"""A small, dense body one or more of which are present in the nucleus of eukaryotic cells. It is rich in RNA and protein, is not bounded by a limiting membrane, and is not seen during mitosis. Its prime function is the transcription of the nucleolar DNA into 45S ribosomal-precursor RNA, the processing of this RNA into 5.8S, 18S, and 28S components of ribosomal RNA, and the association of these components with 5S RNA and proteins synthesized outside the nucleolus. This association results in the formation of ribonucleoprotein precursors; these pass into the cytoplasm and mature into the 40S and 60S subunits of the ribosome."" [ISBN:0198506732]"	974	97	15	17376	0.1546391752577319	0.015400410677618	query_1	['GO:0031981', 'GO:0043232']	['CDK5RAP3', 'NBN', 'HSPA9', 'XRCC6', 'PDHA2', 'DDRGK1', 'PHB2', 'BCKDHB', 'PDHA1', 'SUMO1', 'PDK3', 'ARL14EP', 'BLM', 'CBX5', 'SDHA']
379	GO:BP	GO:0006996	organelle organization	0.0012511976606723	True	"""A process that is carried out at the cellular level which results in the assembly, arrangement of constituent parts, or disassembly of an organelle within a cell. An organelle is an organized structure of distinctive morphology and function. Includes the nucleus, mitochondria, plastids, vacuoles, vesicles, ribosomes and the cytoskeleton. Excludes the plasma membrane."" [GOC:mah]"	3431	97	35	17376	0.3608247422680412	0.0102011075488195	query_1	['GO:0016043']	['PPIF', 'UBE2I', 'SPG7', 'MAIP1', 'NBN', 'ATF7IP', 'HSPA9', 'RAD50', 'XRCC6', 'SETDB2', 'DDRGK1', 'UFL1', 'PMPCA', 'PHB2', 'BRCA2', 'MCU', 'SETDB1', 'SUMO1', 'HSPD1', 'RPA1', 'BLM', 'MRE11', 'VDAC1', 'RAD51', 'AFG3L2', 'HDAC6', 'FAF2', 'NDUFAB1', 'BRCA1', 'TRIM28', 'MFN1', 'PMPCB', 'UBA5', 'PHB1', 'UFM1']
380	GO:BP	GO:0014070	response to organic cyclic compound	0.0012511976606723	True	"""Any process that results in a change in state or activity of a cell or an organism (in terms of movement, secretion, enzyme production, gene expression, etc.) as a result of an organic cyclic compound stimulus."" [GOC:ef]"	895	97	15	17376	0.1546391752577319	0.0167597765363128	query_1	['GO:0010033']	['OTC', 'DDRGK1', 'UFL1', 'PHB2', 'METTL21C', 'BCKDHB', 'BLM', 'RAD51', 'HDAC6', 'GPD1', 'BRCA1', 'UBA5', 'PHB1', 'UFM1', 'STAT5B']
381	GO:BP	GO:0019217	regulation of fatty acid metabolic process	0.0012511976606723	True	"""Any process that modulates the frequency, rate or extent of the chemical reactions and pathways involving fatty acids."" [GOC:go_curators]"	87	97	5	17376	0.0515463917525773	0.057471264367816	query_1	['GO:0006631', 'GO:0010565', 'GO:0019216']	['PDK4', 'PDK3', 'PDK1', 'BRCA1', 'PDK2']
382	GO:BP	GO:0000278	mitotic cell cycle	0.0012539051568369	True	"""Progression through the phases of the mitotic cell cycle, the most common eukaryotic cell cycle, which canonically comprises four successive phases called G1, S, G2, and M and includes replication of the genome and the subsequent segregation of chromosomes into daughter cells. In some variant cell cycles nuclear replication or nuclear division may not be followed by cell division, or G1 and G2 phases may be absent."" [GOC:mah, ISBN:0815316194, Reactome:69278]"	896	97	15	17376	0.1546391752577319	0.0167410714285714	query_1	['GO:0007049']	['RBBP8', 'UBE2I', 'CDK5RAP3', 'NBN', 'RAD50', 'SETDB2', 'MDC1', 'PHB2', 'BRCA2', 'BLM', 'MRE11', 'RAD51', 'BRCA1', 'BARD1', 'STAT5B']
383	REAC	REAC:R-HSA-74160	Gene expression (Transcription)	0.0013317442945602	True	Gene expression (Transcription)	1407	97	19	17376	0.1958762886597938	0.013503909026297	query_1	['REAC:0000000']	['RBBP8', 'UBE2I', 'NBN', 'RAD50', 'ZNF45', 'ZNF350', 'H2AX', 'MDC1', 'SUMO1', 'HSPD1', 'RPA1', 'BLM', 'MRE11', 'RAD51', 'HDAC6', 'CBX5', 'BRCA1', 'TRIM28', 'BARD1']
384	GO:BP	GO:0016574	histone ubiquitination	0.0013332481196535	True	"""The modification of histones by addition of ubiquitin groups."" [GOC:ai]"	47	97	4	17376	0.0412371134020618	0.0851063829787234	query_1	['GO:0016567', 'GO:0016570']	['BRCA2', 'RAD51', 'BRCA1', 'BARD1']
385	GO:BP	GO:0042592	homeostatic process	0.0014285725722133	True	"""Any biological process involved in the maintenance of an internal steady state."" [GOC:jl, ISBN:0395825172]"	1586	97	21	17376	0.2164948453608247	0.0132408575031525	query_1	['GO:0008150']	['PDK4', 'MAIP1', 'CDK5RAP3', 'OTC', 'HSPA9', 'MCUB', 'UFL1', 'METTL21C', 'MCU', 'PDK3', 'AFG3L2', 'ISCU', 'MICU1', 'SMDT1', 'DLD', 'PDK2', 'BARD1', 'MICU2', 'ABHD6', 'UBA5', 'STAT5B']
386	GO:BP	GO:0022402	cell cycle process	0.0014285725722133	True	"""The cellular process that ensures successive accurate and complete genome replication and chromosome segregation."" [GOC:isa_complete, GOC:mtg_cell_cycle]"	1235	97	18	17376	0.1855670103092783	0.0145748987854251	query_1	['GO:0007049', 'GO:0009987']	['RBBP8', 'UBE2I', 'CDK5RAP3', 'NBN', 'TP53BP1', 'RAD50', 'PAXIP1', 'SETDB2', 'H2AX', 'DDRGK1', 'MDC1', 'PHB2', 'BRCA2', 'BLM', 'MRE11', 'RAD51', 'BRCA1', 'BARD1']
387	GO:BP	GO:1901976	regulation of cell cycle checkpoint	0.0014304532902986	True	"""Any process that modulates the frequency, rate or extent of cell cycle checkpoint."" [GOC:mtg_cell_cycle, GOC:TermGenie, PMID:23028116]"	48	97	4	17376	0.0412371134020618	0.0833333333333333	query_1	['GO:0000075', 'GO:1901987', 'GO:1902531']	['BRCA2', 'RAD51', 'BRCA1', 'BARD1']
388	GO:BP	GO:0044282	small molecule catabolic process	0.0014357913548708	True	"""The chemical reactions and pathways resulting in the breakdown of small molecules, any low molecular weight, monomeric, non-encoded molecule."" [GOC:curators, GOC:vw]"	350	97	9	17376	0.0927835051546391	0.0257142857142857	query_1	['GO:0009056', 'GO:0044281']	['GCSH', 'OTC', 'DLST', 'MCAT', 'DBT', 'BCKDK', 'BCKDHB', 'DLD', 'BCKDHA']
389	GO:BP	GO:0009314	response to radiation	0.0014609098459264	True	"""Any process that results in a change in state or activity of a cell or an organism (in terms of movement, secretion, enzyme production, gene expression, etc.) as a result of an electromagnetic radiation stimulus. Electromagnetic radiation is a propagating wave in space with electric and magnetic components. These components oscillate at right angles to each other and to the direction of propagation."" [GOC:jl, Wikipedia:Electromagnetic_radiation]"	433	97	10	17376	0.1030927835051546	0.023094688221709	query_1	['GO:0009628']	['TP53BP1', 'XRCC6', 'PAXIP1', 'H2AX', 'BRCA2', 'BLM', 'RAD51', 'BRCA1', 'BARD1', 'GJA10']
390	GO:BP	GO:0006120	mitochondrial electron transport, NADH to ubiquinone	0.0015304068154096	True	"""The transfer of electrons from NADH to ubiquinone that occurs during oxidative phosphorylation."" [ISBN:0716731363]"	49	97	4	17376	0.0412371134020618	0.0816326530612244	query_1	['GO:0019646', 'GO:0042775']	['ISCU', 'NDUFAB1', 'DLD', 'NDUFV3']
391	GO:BP	GO:0051321	meiotic cell cycle	0.0015304068154096	True	"""Progression through the phases of the meiotic cell cycle, in which canonically a cell replicates to produce four offspring with half the chromosomal content of the progenitor cell via two nuclear divisions."" [GOC:ai]"	277	97	8	17376	0.0824742268041237	0.0288808664259927	query_1	['GO:0007049', 'GO:0019953', 'GO:0022414']	['RBBP8', 'NBN', 'RAD50', 'H2AX', 'BRCA2', 'RPA1', 'MRE11', 'RAD51']
392	GO:CC	GO:0046930	pore complex	0.0015355053119445	True	"""A protein complex providing a discrete opening in a membrane that allows the passage of gases and/or liquids."" [ISBN:0198506732]"	26	97	3	17376	0.0309278350515463	0.1153846153846153	query_1	['GO:0098796']	['PPIF', 'SPG7', 'VDAC1']
393	GO:CC	GO:1990351	transporter complex	0.0015355053119445	True	"""A protein complex facilitating transport of molecules (proteins, small molecules, nucleic acids) into, out of or within a cell, or between cells."" [GOC:bhm, PMID:15449578]"	400	97	9	17376	0.0927835051546391	0.0225	query_1	['GO:0032991']	['MCUB', 'MCU', 'SUMO1', 'NDUFAB1', 'MICU1', 'SMDT1', 'NDUFV3', 'MICU2', 'ABHD6']
394	GO:BP	GO:0012501	programmed cell death	0.0016081717158119	True	"""A process which begins when a cell receives an internal or external signal and activates a series of biochemical events (signaling pathway). The process ends with the death of the cell."" [GOC:lr, GOC:mtg_apoptosis]"	1849	97	23	17376	0.2371134020618556	0.012439156300703	query_1	['GO:0008219']	['PPIF', 'SNX6', 'PDK4', 'SPG7', 'CDK5RAP3', 'NBN', 'HSPA9', 'DDRGK1', 'UFL1', 'PHB2', 'METTL21C', 'BRCA2', 'HSPD1', 'MRE11', 'VDAC1', 'HDAC6', 'PDK1', 'BRCA1', 'PDK2', 'BARD1', 'PHB1', 'UFM1', 'STAT5B']
395	GO:BP	GO:0006282	regulation of DNA repair	0.0016081717158119	True	"""Any process that modulates the frequency, rate or extent of DNA repair."" [GOC:go_curators]"	209	97	7	17376	0.0721649484536082	0.0334928229665071	query_1	['GO:0006281', 'GO:0051052', 'GO:0080135']	['RBBP8', 'TP53BP1', 'H2AX', 'RAD51', 'BRCA1', 'TRIM28', 'BARD1']
396	REAC	REAC:R-HSA-4090294	SUMOylation of intracellular receptors	0.0016435012472924	True	SUMOylation of intracellular receptors	24	97	3	17376	0.0309278350515463	0.125	query_1	['REAC:R-HSA-3108232']	['UBE2I', 'SUMO1', 'PIAS1']
397	GO:BP	GO:0051253	negative regulation of RNA metabolic process	0.001696781240384	True	"""Any process that stops, prevents, or reduces the frequency, rate or extent of the chemical reactions and pathways involving RNA."" [GOC:ai]"	1371	97	19	17376	0.1958762886597938	0.0138584974471188	query_1	['GO:0010605', 'GO:0016070', 'GO:0045934', 'GO:0051252']	['RBBP8', 'SNX6', 'UBE2I', 'ATF7IP', 'ZNF350', 'XRCC6', 'SETDB2', 'PHB2', 'SETDB1', 'SUMO1', 'FLYWCH1', 'PIAS1', 'HDAC6', 'CBX5', 'BRCA1', 'MBD1', 'TRIM28', 'BARD1', 'PHB1']
398	GO:BP	GO:0097411	hypoxia-inducible factor-1alpha signaling pathway	0.0017163751944598	True	"""The series of molecular signals mediated by hypoxia-inducible factor (HIF1) in response to lowered oxygen levels (hypoxia). Under hypoxic conditions, the oxygen-sensitive alpha-subunit of hypoxia-inducible factor (HIF)-1 dimerizes with a HIF1-beta subunit (also called ARNT or aryl-hydrocarbon-receptor nuclear translocator), translocates to the nucleus and activates transcription of genes whose products participate in responding to hypoxia."" [GOC:bf, GOC:jc, http://www.sabiosciences.com/pathway.php?sn=HIF1Alpha_Pathway]"	4	97	2	17376	0.0206185567010309	0.5	query_1	['GO:0007165', 'GO:0071456']	['PDK3', 'PDK1']
399	GO:BP	GO:0072757	cellular response to camptothecin	0.0017163751944598	True	"""Any process that results in a change in state or activity of a cell (in terms of movement, secretion, enzyme production, gene expression, etc.) as a result of a camptothecin stimulus."" [GOC:mah]"	4	97	2	17376	0.0206185567010309	0.5	query_1	['GO:0071312', 'GO:0071407', 'GO:0097306', 'GO:1901563']	['BLM', 'RAD51']
400	GO:BP	GO:0033600	negative regulation of mammary gland epithelial cell proliferation	0.0017163751944598	True	"""Any process that stops, prevents or reduces the rate or extent of mammary gland epithelial cell proliferation."" [GOC:mah]"	4	97	2	17376	0.0206185567010309	0.5	query_1	['GO:0033598', 'GO:0033599', 'GO:0050680', 'GO:0051241']	['PHB2', 'BRCA2']
401	GO:BP	GO:1900542	regulation of purine nucleotide metabolic process	0.0017355364110829	True	"""Any process that modulates the frequency, rate or extent of purine nucleotide metabolic process."" [GOC:TermGenie]"	51	97	4	17376	0.0412371134020618	0.0784313725490196	query_1	['GO:0006140', 'GO:0006163']	['PDK4', 'PDK3', 'PDK1', 'PDK2']
402	GO:BP	GO:0034620	cellular response to unfolded protein	0.0017646466461107	True	"""Any process that results in a change in state or activity of a cell (in terms of movement, secretion, enzyme production, gene expression, etc.) as a result of an unfolded protein stimulus."" [GOC:mah]"	95	97	5	17376	0.0515463917525773	0.0526315789473684	query_1	['GO:0006986', 'GO:0035967']	['CDK5RAP3', 'HSPA9', 'DDRGK1', 'UFL1', 'HSPD1']
403	GO:BP	GO:1902679	negative regulation of RNA biosynthetic process	0.0017862618295569	True	"""Any process that stops, prevents or reduces the frequency, rate or extent of RNA biosynthetic process."" [GO:jl, GO_REF:0000058, GOC:TermGenie]"	1263	97	18	17376	0.1855670103092783	0.014251781472684	query_1	['GO:0010558', 'GO:0031327', 'GO:0032774', 'GO:0051253', 'GO:2001141']	['RBBP8', 'SNX6', 'UBE2I', 'ATF7IP', 'ZNF350', 'XRCC6', 'SETDB2', 'PHB2', 'SETDB1', 'SUMO1', 'FLYWCH1', 'PIAS1', 'HDAC6', 'CBX5', 'BRCA1', 'MBD1', 'TRIM28', 'PHB1']
404	GO:BP	GO:0002639	positive regulation of immunoglobulin production	0.0018432499311957	True	"""Any process that activates or increases the frequency, rate, or extent of immunoglobulin production."" [GOC:add]"	52	97	4	17376	0.0412371134020618	0.0769230769230769	query_1	['GO:0002377', 'GO:0002637', 'GO:0002702']	['TP53BP1', 'PAXIP1', 'PHB2', 'PHB1']
405	GO:BP	GO:0006140	regulation of nucleotide metabolic process	0.0018432499311957	True	"""Any process that modulates the frequency, rate or extent of the chemical reactions and pathways involving nucleotides."" [GOC:go_curators]"	52	97	4	17376	0.0412371134020618	0.0769230769230769	query_1	['GO:0009117', 'GO:0019219', 'GO:0019220', 'GO:0062012']	['PDK4', 'PDK3', 'PDK1', 'PDK2']
406	GO:BP	GO:0006874	intracellular calcium ion homeostasis	0.0018591082879841	True	"""A homeostatic process involved in the maintenance of a steady state level of calcium ions within a cell."" [GOC:ceb, GOC:mah]"	287	97	8	17376	0.0824742268041237	0.0278745644599303	query_1	['GO:0030003', 'GO:0055074']	['MAIP1', 'MCUB', 'METTL21C', 'MCU', 'AFG3L2', 'MICU1', 'SMDT1', 'MICU2']
407	GO:BP	GO:0051567	histone H3-K9 methylation	0.0018957245141294	True	"""The modification of histone H3 by addition of one or more methyl groups to lysine at position 9 of the histone."" [GOC:ai, GOC:pr]"	21	97	3	17376	0.0309278350515463	0.1428571428571428	query_1	['GO:0034968', 'GO:0061647']	['SETDB2', 'SETDB1', 'BRCA1']
408	GO:BP	GO:1902275	regulation of chromatin organization	0.0019402877594936	True	"""Any process that modulates the frequency, rate or extent of chromatin organization."" [GO_REF:0000058, GOC:bf, GOC:TermGenie, GOC:vw, PMID:18314879]"	53	97	4	17376	0.0412371134020618	0.0754716981132075	query_1	['GO:0006325', 'GO:0051128']	['ATF7IP', 'SETDB2', 'SETDB1', 'TRIM28']
409	GO:BP	GO:0002208	somatic diversification of immunoglobulins involved in immune response	0.0019402877594936	True	"""The somatic process that results in the generation of sequence diversity of immunoglobulins after induction, and contributes to an immune response."" [GOC:add, ISBN:0781735149, PMID:14991701]"	53	97	4	17376	0.0412371134020618	0.0754716981132075	query_1	['GO:0002381', 'GO:0016445']	['NBN', 'TP53BP1', 'PAXIP1', 'HSPD1']
410	GO:BP	GO:0045190	isotype switching	0.0019402877594936	True	"""The switching of activated B cells from IgM biosynthesis to biosynthesis of other isotypes of immunoglobulin, accomplished through a recombination process involving an intrachromosomal deletion involving switch regions that reside 5' of each constant region gene segment in the immunoglobulin heavy chain locus."" [ISBN:0781735149]"	53	97	4	17376	0.0412371134020618	0.0754716981132075	query_1	['GO:0002204', 'GO:0002312']	['NBN', 'TP53BP1', 'PAXIP1', 'HSPD1']
411	GO:BP	GO:0002204	somatic recombination of immunoglobulin genes involved in immune response	0.0019402877594936	True	"""The process in which immunoglobulin genes are formed through recombination of the germline genetic elements, also known as immunoglobulin gene segments, within a single locus following the induction of and contributing to an immune response."" [GOC:add, ISBN:0781735149]"	53	97	4	17376	0.0412371134020618	0.0754716981132075	query_1	['GO:0002208', 'GO:0016447']	['NBN', 'TP53BP1', 'PAXIP1', 'HSPD1']
412	GO:BP	GO:0043066	negative regulation of apoptotic process	0.0019605075765623	True	"""Any process that stops, prevents, or reduces the frequency, rate or extent of cell death by apoptotic process."" [GOC:jl, GOC:mtg_apoptosis]"	837	97	14	17376	0.1443298969072164	0.016726403823178	query_1	['GO:0006915', 'GO:0042981', 'GO:0043069']	['PPIF', 'SNX6', 'PDK4', 'HSPA9', 'DDRGK1', 'UFL1', 'PHB2', 'HSPD1', 'MRE11', 'VDAC1', 'BRCA1', 'BARD1', 'UFM1', 'STAT5B']
413	GO:BP	GO:1901575	organic substance catabolic process	0.0020159961772813	True	"""The chemical reactions and pathways resulting in the breakdown of an organic substance, any molecular entity containing carbon."" [GOC:pr, GOC:TermGenie]"	2014	97	24	17376	0.2474226804123711	0.0119165839126117	query_1	['GO:0009056', 'GO:0071704']	['UBE2I', 'GCSH', 'SNX1', 'CDK5RAP3', 'OTC', 'DLST', 'UBAC2', 'DDRGK1', 'UFL1', 'MCAT', 'DBT', 'BCKDK', 'BCKDHB', 'SUMO1', 'PIAS1', 'HDAC6', 'GPD1', 'FAF2', 'DLD', 'BARD1', 'ABHD6', 'OGDH', 'PHB1', 'BCKDHA']
414	GO:CC	GO:0000803	sex chromosome	0.0021046212512496	True	"""A chromosome involved in sex determination."" [GOC:elh]"	29	97	3	17376	0.0309278350515463	0.1034482758620689	query_1	['GO:0005694']	['H2AX', 'SUMO1', 'BRCA1']
415	GO:BP	GO:0006268	DNA unwinding involved in DNA replication	0.0021290767982463	True	"""The process in which interchain hydrogen bonds between two strands of DNA are broken or 'melted', generating unpaired template strands for DNA replication."" [ISBN:071673706X, ISBN:0815316194]"	22	97	3	17376	0.0309278350515463	0.1363636363636363	query_1	['GO:0006261', 'GO:0032508']	['RPA1', 'BLM', 'RAD51']
416	GO:BP	GO:0098660	inorganic ion transmembrane transport	0.0022349372291098	True	"""The process in which an inorganic ion is transported across a membrane."" [GOC:mah]"	849	97	14	17376	0.1443298969072164	0.0164899882214369	query_1	['GO:0055085']	['PPIF', 'MAIP1', 'MCUB', 'PHB2', 'METTL21C', 'MCU', 'SUMO1', 'VDAC1', 'AFG3L2', 'ISCU', 'MICU1', 'SMDT1', 'MICU2', 'PMPCB']
417	GO:BP	GO:1903047	mitotic cell cycle process	0.0022349372291098	True	"""A process that is part of the mitotic cell cycle."" [GO_REF:0000060, GOC:mtg_cell_cycle, GOC:TermGenie]"	746	97	13	17376	0.134020618556701	0.017426273458445	query_1	['GO:0000278', 'GO:0022402']	['RBBP8', 'UBE2I', 'CDK5RAP3', 'NBN', 'RAD50', 'MDC1', 'PHB2', 'BRCA2', 'BLM', 'MRE11', 'RAD51', 'BRCA1', 'BARD1']
418	REAC	REAC:R-HSA-1643685	Disease	0.0023223191691657	True	Disease	1725	97	21	17376	0.2164948453608247	0.0121739130434782	query_1	['REAC:0000000']	['RBBP8', 'UBE2I', 'NBN', 'RAD50', 'XRCC6', 'TALDO1', 'H2AX', 'BRCA2', 'SUMO1', 'RPA1', 'BLM', 'MRE11', 'RAD51', 'HDAC6', 'ISCU', 'BRCA1', 'STAT5A', 'TRIM28', 'BARD1', 'PHB1', 'STAT5B']
419	REAC	REAC:R-HSA-3065678	SUMO is transferred from E1 to E2 (UBE2I, UBC9)	0.0023223191691657	True	SUMO is transferred from E1 to E2 (UBE2I, UBC9)	6	97	2	17376	0.0206185567010309	0.3333333333333333	query_1	['REAC:R-HSA-3215018']	['UBE2I', 'SUMO1']
420	REAC	REAC:R-HSA-9645135	STAT5 Activation	0.0023223191691657	True	STAT5 Activation	6	97	2	17376	0.0206185567010309	0.3333333333333333	query_1	['REAC:R-HSA-9607240']	['STAT5A', 'STAT5B']
421	GO:BP	GO:0010906	regulation of glucose metabolic process	0.0023238384691199	True	"""Any process that modulates the rate, frequency or extent of glucose metabolism. Glucose metabolic processes are the chemical reactions and pathways involving glucose, the aldohexose gluco-hexose."" [GOC:BHF, GOC:tb]"	102	97	5	17376	0.0515463917525773	0.0490196078431372	query_1	['GO:0006006', 'GO:0006109', 'GO:0062012']	['PDK4', 'BCKDK', 'PDK3', 'PDK1', 'PDK2']
422	GO:BP	GO:0010332	response to gamma radiation	0.0023409404430107	True	"""Any process that results in a change in state or activity of a cell or an organism (in terms of movement, secretion, enzyme production, gene expression, etc.) as a result of a gamma radiation stimulus. Gamma radiation is a form of electromagnetic radiation (EMR) or light emission of a specific frequency produced from sub-atomic particle interaction, such as electron-positron annihilation and radioactive decay. Gamma rays are generally characterized as EMR having the highest frequency and energy, and also the shortest wavelength, within the electromagnetic radiation spectrum."" [GOC:tair_curators]"	56	97	4	17376	0.0412371134020618	0.0714285714285714	query_1	['GO:0010212']	['XRCC6', 'H2AX', 'BRCA2', 'RAD51']
423	GO:BP	GO:0009892	negative regulation of metabolic process	0.0023412267852388	True	"""Any process that stops, prevents, or reduces the frequency, rate or extent of the chemical reactions and pathways within a cell or an organism."" [GOC:go_curators]"	2845	97	30	17376	0.3092783505154639	0.0105448154657293	query_1	['GO:0008152', 'GO:0019222', 'GO:0048519']	['PPIF', 'RBBP8', 'SNX6', 'UBE2I', 'CDK5RAP3', 'NBN', 'ATF7IP', 'TP53BP1', 'RAD50', 'ZNF350', 'XRCC6', 'SETDB2', 'DDRGK1', 'UFL1', 'PHB2', 'SETDB1', 'BCKDK', 'SUMO1', 'FLYWCH1', 'BLM', 'PIAS1', 'VDAC1', 'HDAC6', 'CBX5', 'BRCA1', 'MBD1', 'TRIM28', 'BARD1', 'ABHD6', 'PHB1']
424	GO:BP	GO:0046823	negative regulation of nucleocytoplasmic transport	0.0023851468096175	True	"""Any process that stops, prevents, or reduces the frequency, rate or extent of the directed movement of substances between the cytoplasm and the nucleus."" [GOC:bf]"	23	97	3	17376	0.0309278350515463	0.1304347826086956	query_1	['GO:0006913', 'GO:0032387', 'GO:0046822']	['SUMO1', 'BARD1', 'UFM1']
425	GO:BP	GO:0043069	negative regulation of programmed cell death	0.0023861235758886	True	"""Any process that stops, prevents, or reduces the frequency, rate or extent of programmed cell death, cell death resulting from activation of endogenous cellular processes."" [GOC:jl]"	856	97	14	17376	0.1443298969072164	0.0163551401869158	query_1	['GO:0012501', 'GO:0043067', 'GO:0060548']	['PPIF', 'SNX6', 'PDK4', 'HSPA9', 'DDRGK1', 'UFL1', 'PHB2', 'HSPD1', 'MRE11', 'VDAC1', 'BRCA1', 'BARD1', 'UFM1', 'STAT5B']
426	GO:BP	GO:0002381	immunoglobulin production involved in immunoglobulin-mediated immune response	0.0024705774251959	True	"""The appearance of immunoglobulin due to biosynthesis or secretion following a cellular stimulus during an immune response, resulting in an increase in its intracellular or extracellular levels."" [GOC:add, ISBN:0781735149, PMID:9185563]"	57	97	4	17376	0.0412371134020618	0.0701754385964912	query_1	['GO:0002377', 'GO:0016064']	['NBN', 'TP53BP1', 'PAXIP1', 'HSPD1']
427	REAC	REAC:R-HSA-4551638	SUMOylation of chromatin organization proteins	0.0025024090458356	True	SUMOylation of chromatin organization proteins	66	97	4	17376	0.0412371134020618	0.0606060606060606	query_1	['REAC:R-HSA-3108232']	['UBE2I', 'SUMO1', 'PIAS1', 'CBX5']
428	GO:BP	GO:1901563	response to camptothecin	0.0025137234778709	True	"""Any process that results in a change in state or activity of a cell or an organism (in terms of movement, secretion, enzyme production, gene expression, etc.) as a result of a camptothecin stimulus."" [GOC:TermGenie]"	5	97	2	17376	0.0206185567010309	0.4	query_1	['GO:0014070', 'GO:0043279', 'GO:0097305']	['BLM', 'RAD51']
429	GO:BP	GO:0055080	monoatomic cation homeostasis	0.0025137234778709	True	"""Any process involved in the maintenance of an internal steady state of monoatomic cations within an organism or cell. Monatomic cations (also called simple cations) are cations consisting of exactly one atom."" [GOC:ceb, GOC:jid, GOC:mah]"	564	97	11	17376	0.1134020618556701	0.0195035460992907	query_1	['GO:0050801']	['PDK4', 'MAIP1', 'MCUB', 'METTL21C', 'MCU', 'AFG3L2', 'ISCU', 'MICU1', 'SMDT1', 'PDK2', 'MICU2']
430	GO:BP	GO:0043545	molybdopterin cofactor metabolic process	0.0025137234778709	True	"""The chemical reactions and pathways involving the molybdopterin cofactor (Moco), essential for the catalytic activity of some enzymes, e.g. sulfite oxidase, xanthine dehydrogenase, and aldehyde oxidase. The cofactor consists of a mononuclear molybdenum (Mo-molybdopterin) or tungsten ion (W-molybdopterin) coordinated by one or two molybdopterin ligands."" [ISSN:09498257]"	5	97	2	17376	0.0206185567010309	0.4	query_1	['GO:0006796', 'GO:0019637', 'GO:0046483', 'GO:0051189', 'GO:1901360', 'GO:1901564']	['MOCS3', 'NFS1']
431	GO:BP	GO:0009249	protein lipoylation	0.0025137234778709	True	"""The lipoylation of peptidyl-lysine to form peptidyl-N6-lipoyl-L-lysine."" [RESID:AA0118]"	5	97	2	17376	0.0206185567010309	0.4	query_1	['GO:0018205', 'GO:0051604']	['GCSH', 'NDUFAB1']
432	GO:BP	GO:0006777	Mo-molybdopterin cofactor biosynthetic process	0.0025137234778709	True	"""The chemical reactions and pathways resulting in the formation of the Mo-molybdopterin cofactor, essential for the catalytic activity of some enzymes. The cofactor consists of a mononuclear molybdenum (Mo) ion coordinated by one or two molybdopterin ligands."" [http://www.sunysb.edu/biochem/BIOCHEM/facultypages/schindelin/, ISSN:09498257, PMID:22370186, PMID:23201473]"	5	97	2	17376	0.0206185567010309	0.4	query_1	['GO:0019720', 'GO:0032324']	['MOCS3', 'NFS1']
433	GO:BP	GO:0044248	cellular catabolic process	0.0025137234778709	True	"""The chemical reactions and pathways resulting in the breakdown of substances, carried out by individual cells."" [GOC:jl]"	1429	97	19	17376	0.1958762886597938	0.013296011196641	query_1	['GO:0009056', 'GO:0044237']	['SNX6', 'GCSH', 'OTC', 'DLST', 'DDRGK1', 'UFL1', 'PHB2', 'MCAT', 'DBT', 'BCKDK', 'BCKDHB', 'VDAC1', 'HDAC6', 'GPD1', 'DLD', 'ABHD6', 'UBA5', 'UFM1', 'BCKDHA']
434	GO:BP	GO:0051189	prosthetic group metabolic process	0.0025137234778709	True	"""The chemical reactions and pathways involving a prosthetic group, the non-amino acid portion of certain protein molecules. Prosthetic groups may be inorganic or organic and are usually required for the biological activity of the protein."" [GOC:ai]"	5	97	2	17376	0.0206185567010309	0.4	query_1	['GO:0008152', 'GO:0019538']	['MOCS3', 'NFS1']
435	GO:BP	GO:0006105	succinate metabolic process	0.0025137234778709	True	"""The chemical reactions and pathways involving succinate, also known as butanedioate or ethane dicarboxylate, the dianion of succinic acid. Succinate is an important intermediate in metabolism and a component of the TCA cycle."" [ISBN:0198506732]"	5	97	2	17376	0.0206185567010309	0.4	query_1	['GO:0043648']	['SDHB', 'SDHA']
436	GO:BP	GO:0019720	Mo-molybdopterin cofactor metabolic process	0.0025137234778709	True	"""The chemical reactions and pathways involving the Mo-molybdopterin cofactor, essential for the catalytic activity of some enzymes. The cofactor consists of a mononuclear molybdenum (Mo) ion coordinated by one or two molybdopterin ligands."" [http://www.sunysb.edu/biochem/BIOCHEM/facultypages/schindelin/, ISSN:09498257]"	5	97	2	17376	0.0206185567010309	0.4	query_1	['GO:0043545']	['MOCS3', 'NFS1']
437	GO:BP	GO:0032324	molybdopterin cofactor biosynthetic process	0.0025137234778709	True	"""The chemical reactions and pathways resulting in the formation of the molybdopterin cofactor (Moco), essential for the catalytic activity of some enzymes, e.g. sulfite oxidase, xanthine dehydrogenase, and aldehyde oxidase. The cofactor consists of a mononuclear molybdenum (Mo-molybdopterin) or tungsten ion (W-molybdopterin) coordinated by one or two molybdopterin ligands."" [GOC:mah]"	5	97	2	17376	0.0206185567010309	0.4	query_1	['GO:0018130', 'GO:0043545', 'GO:0090407', 'GO:1901362', 'GO:1901566']	['MOCS3', 'NFS1']
438	GO:BP	GO:1903895	negative regulation of IRE1-mediated unfolded protein response	0.0025137234778709	True	"""Any process that stops, prevents or reduces the frequency, rate or extent of the IRE1-mediated unfolded protein response."" [GO_REF:0000058, GOC:bf, GOC:PARL, GOC:TermGenie, PMID:22013210]"	5	97	2	17376	0.0206185567010309	0.4	query_1	['GO:0036498', 'GO:1900102', 'GO:1903894']	['DDRGK1', 'UFL1']
439	GO:BP	GO:1990051	activation of protein kinase C activity	0.0025137234778709	True	"""Any process that initiates the activity of the inactive enzyme protein kinase C."" [PMID:3156004]"	5	97	2	17376	0.0206185567010309	0.4	query_1	['GO:0032147']	['PHB2', 'PHB1']
440	GO:BP	GO:0043414	macromolecule methylation	0.002521854240484	True	"""The covalent attachment of a methyl residue to one or more monomeric units in a polypeptide, polynucleotide, polysaccharide, or other biological macromolecule."" [GOC:go_curators]"	305	97	8	17376	0.0824742268041237	0.0262295081967213	query_1	['GO:0032259', 'GO:0043412']	['ATF7IP', 'PAXIP1', 'SETDB2', 'METTL21C', 'SETDB1', 'NSUN6', 'BRCA1', 'TRIM28']
441	GO:CC	GO:0034703	cation channel complex	0.0025649237516739	True	"""An ion channel complex through which cations pass."" [GOC:mah]"	190	97	6	17376	0.0618556701030927	0.031578947368421	query_1	['GO:0034702']	['MCUB', 'MCU', 'SUMO1', 'MICU1', 'SMDT1', 'MICU2']
442	GO:CC	GO:0016363	nuclear matrix	0.002686146877633	True	"""The dense fibrillar network lying on the inner side of the nuclear membrane."" [ISBN:0582227089]"	127	97	5	17376	0.0515463917525773	0.0393700787401574	query_1	['GO:0034399', 'GO:0110165']	['ZNF350', 'PAXIP1', 'PHB2', 'BLM', 'MBD1']
443	GO:BP	GO:0016570	histone modification	0.0026927489821877	True	"""The covalent alteration of one or more amino acid residues within a histone protein."" [GOC:krc]"	477	97	10	17376	0.1030927835051546	0.020964360587002	query_1	['GO:0036211']	['PAXIP1', 'SETDB2', 'UFL1', 'BRCA2', 'SETDB1', 'RAD51', 'HDAC6', 'BRCA1', 'BARD1', 'PHB1']
444	GO:BP	GO:0055074	calcium ion homeostasis	0.0027925553289103	True	"""Any process involved in the maintenance of an internal steady state of calcium ions within an organism or cell."" [GOC:ceb, GOC:jid, GOC:mah]"	310	97	8	17376	0.0824742268041237	0.0258064516129032	query_1	['GO:0055080', 'GO:0098771']	['MAIP1', 'MCUB', 'METTL21C', 'MCU', 'AFG3L2', 'MICU1', 'SMDT1', 'MICU2']
445	GO:BP	GO:0032387	negative regulation of intracellular transport	0.0028461708169985	True	"""Any process that stops, prevents, or reduces the frequency, rate or extent of the directed movement of substances within cells."" [GOC:mah]"	60	97	4	17376	0.0412371134020618	0.0666666666666666	query_1	['GO:0032386', 'GO:0046907', 'GO:0048523', 'GO:0051051']	['UBAC2', 'SUMO1', 'BARD1', 'UFM1']
446	GO:BP	GO:0016447	somatic recombination of immunoglobulin gene segments	0.0030123249727616	True	"""The process in which immunoglobulin genes are formed through recombination of the germline genetic elements, as known as immunoglobulin gene segments, within a single locus."" [GOC:add, ISBN:0781735149]"	61	97	4	17376	0.0412371134020618	0.0655737704918032	query_1	['GO:0002562', 'GO:0016445']	['NBN', 'TP53BP1', 'PAXIP1', 'HSPD1']
447	GO:BP	GO:0016236	macroautophagy	0.0030123249727616	True	"""The major inducible pathway for the general turnover of cytoplasmic constituents in eukaryotic cells, it is also responsible for the degradation of active cytoplasmic enzymes and organelles during nutrient starvation. Macroautophagy involves the formation of double-membrane-bounded autophagosomes which enclose the cytoplasmic constituent targeted for degradation in a membrane-bounded structure. Autophagosomes then fuse with a lysosome (or vacuole) releasing single-membrane-bounded autophagic bodies that are then degraded within the lysosome (or vacuole). Some types of macroautophagy, e.g. pexophagy, mitophagy, involve selective targeting of the targets to be degraded."" [PMID:11099404, PMID:12914914, PMID:15798367, PMID:16973210, PMID:20159618, PMID:9412464]"	314	97	8	17376	0.0824742268041237	0.0254777070063694	query_1	['GO:0006914']	['SNX6', 'DDRGK1', 'UFL1', 'PHB2', 'VDAC1', 'HDAC6', 'UBA5', 'UFM1']
448	GO:CC	GO:0070531	BRCA1-A complex	0.0030876411133318	True	"""A protein complex that contains the BRCA1-BARD1 heterodimer, RAP80/UIMC1, BRCC3/BRCC36, BRE/BRCC45, FAM175A/CCDC98/Abraxas and MERIT40/NBA1, and specifically recognizes and binds K63-linked polyubiquitin chains present on histone H2A and H2AX at DNA damage sites."" [GOC:mah, PMID:19261749]"	8	97	2	17376	0.0206185567010309	0.25	query_1	['GO:0140513']	['BRCA1', 'BARD1']
449	REAC	REAC:R-HSA-9027283	Erythropoietin activates STAT5	0.0031122101373012	True	Erythropoietin activates STAT5	7	97	2	17376	0.0206185567010309	0.2857142857142857	query_1	['REAC:R-HSA-9006335']	['STAT5A', 'STAT5B']
450	GO:BP	GO:0040029	epigenetic regulation of gene expression	0.0031487444521966	True	"""A process that modulates the frequency, rate or extent of gene expression through chromatin remodelling either by modifying higher order chromatin fiber structure, nucleosomal histones, or the DNA. Once established, this regulation may be maintained over many cell divisions. It can also be heritable in the absence of the instigating signal."" [PMID:10521337, PMID:11498582, PMID:22243696, PMID:34414474]"	171	97	6	17376	0.0618556701030927	0.0350877192982456	query_1	['GO:0006338', 'GO:0010468']	['ATF7IP', 'SETDB2', 'SETDB1', 'HDAC6', 'BRCA1', 'TRIM28']
451	GO:BP	GO:0008150	biological_process	0.0031487444521966	True	"""A biological process is the execution of a genetically-encoded biological module or program. It consists of all the steps required to achieve the specific biological objective of the module. A biological process is accomplished by a particular set of molecular functions carried out by specific gene products (or macromolecular complexes), often in a highly regulated manner and in a particular temporal sequence."" [GOC:pdt]"	15627	97	96	17376	0.9896907216494846	0.0061432136686504	query_1	[]	['PPIF', 'RBBP8', 'SNX6', 'UBE2I', 'PDK4', 'GCSH', 'SPG7', 'PPM1K', 'SNX1', 'LYRM4', 'ADSL', 'MAIP1', 'CDK5RAP3', 'NBN', 'OTC', 'ATF7IP', 'DLST', 'HSPA9', 'MCUB', 'TP53BP1', 'RAD50', 'ZNF45', 'UBAC2', 'ZNF350', 'XRCC6', 'TALDO1', 'PAXIP1', 'DLAT', 'PDHA2', 'PDHX', 'SETDB2', 'PDHB', 'H2AX', 'DDRGK1', 'UFL1', 'MDC1', 'PMPCA', 'PHB2', 'MCAT', 'METTL21C', 'SDHD', 'DBT', 'BRCA2', 'MCU', 'SIL1', 'SETDB1', 'BCKDK', 'CDNF', 'BCKDHB', 'PDHA1', 'SUMO1', 'HSPD1', 'RPA1', 'PDK3', 'FLYWCH1', 'BLM', 'PIAS1', 'MRE11', 'VDAC1', 'RAD51', 'AFG3L2', 'HDAC6', 'MOCS3', 'ISCU', 'GPD1', 'PDK1', 'NSUN6', 'SDHB', 'FAF2', 'NFS1', 'CBX5', 'NDUFAB1', 'BRCA1', 'SDHA', 'MICU1', 'STAT5A', 'SMDT1', 'SDHC', 'DLD', 'PDK2', 'MBD1', 'NDUFV3', 'TRIM28', 'BARD1', 'MICU2', 'MFN1', 'ABHD6', 'PEPD', 'PMPCB', 'UBA5', 'OGDH', 'GJA10', 'PHB1', 'UFM1', 'STAT5B', 'BCKDHA']
452	GO:BP	GO:0071396	cellular response to lipid	0.0031729340742873	True	"""Any process that results in a change in state or activity of a cell (in terms of movement, secretion, enzyme production, gene expression, etc.) as a result of a lipid stimulus."" [GOC:mah]"	582	97	11	17376	0.1134020618556701	0.0189003436426116	query_1	['GO:0033993', 'GO:0071310']	['PDK4', 'DDRGK1', 'UFL1', 'PHB2', 'METTL21C', 'PDK3', 'HDAC6', 'BRCA1', 'UBA5', 'PHB1', 'UFM1']
453	GO:BP	GO:0007006	mitochondrial membrane organization	0.0035337986816152	True	"""A process that is carried out at the cellular level which results in the assembly, arrangement of constituent parts, or disassembly of a mitochondrial membrane, either of the lipid bilayer surrounding a mitochondrion."" [GOC:ai, GOC:dph, GOC:jl, GOC:mah]"	114	97	5	17376	0.0515463917525773	0.043859649122807	query_1	['GO:0007005', 'GO:0061024']	['PPIF', 'SPG7', 'MAIP1', 'HSPA9', 'AFG3L2']
454	GO:BP	GO:0061734	parkin-mediated stimulation of mitophagy in response to mitochondrial depolarization	0.003606583127581	True	"""A positive regulation of the macromitophagy pathway that is triggered by mitochondrial depolarization and requires the function of a parkin-family molecule."" [GOC:autophagy, GOC:dph, GOC:pad, GOC:PARL, PMID:25349190]"	6	97	2	17376	0.0206185567010309	0.3333333333333333	query_1	['GO:0098779']	['VDAC1', 'HDAC6']
455	GO:BP	GO:0000019	regulation of mitotic recombination	0.003606583127581	True	"""Any process that modulates the frequency, rate or extent of DNA recombination during mitosis."" [GOC:go_curators]"	6	97	2	17376	0.0206185567010309	0.3333333333333333	query_1	['GO:0000018', 'GO:0006312']	['RAD50', 'MRE11']
456	GO:BP	GO:0006109	regulation of carbohydrate metabolic process	0.0037158711833625	True	"""Any process that modulates the frequency, rate or extent of the chemical reactions and pathways involving carbohydrates."" [GOC:go_curators]"	177	97	6	17376	0.0618556701030927	0.0338983050847457	query_1	['GO:0005975', 'GO:0080090']	['PDK4', 'BCKDK', 'PDK3', 'GPD1', 'PDK1', 'PDK2']
457	GO:BP	GO:0016925	protein sumoylation	0.0037279932755832	True	"""The process in which a SUMO protein (small ubiquitin-related modifier) is conjugated to a target protein via an isopeptide bond between the carboxy-terminus of SUMO with an epsilon-amino group of a lysine residue of the target protein."" [GOC:jl, PMID:11265250]"	65	97	4	17376	0.0412371134020618	0.0615384615384615	query_1	['GO:0018205', 'GO:0032446']	['UBE2I', 'SUMO1', 'PIAS1', 'TRIM28']
458	GO:BP	GO:0010243	response to organonitrogen compound	0.0037279932755832	True	"""Any process that results in a change in state or activity of a cell or an organism (in terms of movement, secretion, enzyme production, gene expression, etc.) as a result of an organonitrogen stimulus. An organonitrogen compound is formally a compound containing at least one carbon-nitrogen bond."" [PMID:9869419]"	1013	97	15	17376	0.1546391752577319	0.014807502467917	query_1	['GO:0010033', 'GO:1901698']	['SNX6', 'PDK4', 'OTC', 'UBAC2', 'UFL1', 'BCKDHB', 'BLM', 'RAD51', 'HDAC6', 'GPD1', 'FAF2', 'BRCA1', 'STAT5A', 'PDK2', 'STAT5B']
459	GO:CC	GO:0034702	monoatomic ion channel complex	0.0038322861679114	True	"""A protein complex that spans a membrane and forms a water-filled channel across the phospholipid bilayer allowing selective monoatomic ion transport down its electrochemical gradient."" [GOC:mah, ISBN:071673706X]"	284	97	7	17376	0.0721649484536082	0.0246478873239436	query_1	['GO:1902495']	['MCUB', 'MCU', 'SUMO1', 'MICU1', 'SMDT1', 'MICU2', 'ABHD6']
460	GO:BP	GO:0061647	histone H3-K9 modification	0.0038715450976885	True	"""The modification of histone H3 at a lysine in position 9 of the histone."" [GOC:vw]"	28	97	3	17376	0.0309278350515463	0.1071428571428571	query_1	['GO:0016570']	['SETDB2', 'SETDB1', 'BRCA1']
461	GO:BP	GO:0031954	positive regulation of protein autophosphorylation	0.0038715450976885	True	"""Any process that activates or increases the frequency, rate or extent of the phosphorylation by a protein of one or more of its own residues."" [GOC:mah]"	28	97	3	17376	0.0309278350515463	0.1071428571428571	query_1	['GO:0001934', 'GO:0031952', 'GO:0046777']	['NBN', 'RAD50', 'MRE11']
462	GO:BP	GO:0019216	regulation of lipid metabolic process	0.0038715450976885	True	"""Any process that modulates the frequency, rate or extent of the chemical reactions and pathways involving lipids."" [GOC:go_curators]"	328	97	8	17376	0.0824742268041237	0.024390243902439	query_1	['GO:0006629', 'GO:0080090']	['PDK4', 'PHB2', 'PDK3', 'PDK1', 'BRCA1', 'PDK2', 'ABHD6', 'STAT5B']
463	GO:BP	GO:0045892	negative regulation of DNA-templated transcription	0.0039325584636579	True	"""Any process that stops, prevents, or reduces the frequency, rate or extent of cellular DNA-templated transcription."" [GOC:go_curators, GOC:txnOH]"	1249	97	17	17376	0.1752577319587628	0.0136108887109687	query_1	['GO:0006351', 'GO:0006355', 'GO:1903507']	['RBBP8', 'SNX6', 'UBE2I', 'ATF7IP', 'ZNF350', 'XRCC6', 'SETDB2', 'PHB2', 'SUMO1', 'FLYWCH1', 'PIAS1', 'HDAC6', 'CBX5', 'BRCA1', 'MBD1', 'TRIM28', 'PHB1']
464	GO:BP	GO:1903507	negative regulation of nucleic acid-templated transcription	0.003992023858684	True	"""Any process that stops, prevents or reduces the frequency, rate or extent of nucleic acid-templated transcription."" [GO_REF:0000058, GOC:pr, GOC:TermGenie, GOC:txnOH, GOC:vw]"	1251	97	17	17376	0.1752577319587628	0.0135891286970423	query_1	['GO:0097659', 'GO:1902679', 'GO:1903506']	['RBBP8', 'SNX6', 'UBE2I', 'ATF7IP', 'ZNF350', 'XRCC6', 'SETDB2', 'PHB2', 'SUMO1', 'FLYWCH1', 'PIAS1', 'HDAC6', 'CBX5', 'BRCA1', 'MBD1', 'TRIM28', 'PHB1']
465	GO:BP	GO:1901566	organonitrogen compound biosynthetic process	0.0040002651061209	True	"""The chemical reactions and pathways resulting in the formation of organonitrogen compound."" [GOC:pr, GOC:TermGenie]"	1615	97	20	17376	0.2061855670103092	0.0123839009287925	query_1	['GO:1901564', 'GO:1901576']	['PDK4', 'ADSL', 'OTC', 'DLAT', 'PDHA2', 'PDHX', 'PDHB', 'SDHD', 'PDHA1', 'PDK3', 'MOCS3', 'PDK1', 'SDHB', 'NFS1', 'NDUFAB1', 'SDHA', 'SDHC', 'DLD', 'PDK2', 'NDUFV3']
466	GO:BP	GO:0034976	response to endoplasmic reticulum stress	0.0040140636371285	True	"""Any process that results in a change in state or activity of a cell (in terms of movement, secretion, enzyme production, gene expression, etc.) as a result of a stress acting at the endoplasmic reticulum. ER stress usually results from the accumulation of unfolded or misfolded proteins in the ER lumen."" [GOC:cjm, GOC:mah]"	252	97	7	17376	0.0721649484536082	0.0277777777777777	query_1	['GO:0033554']	['CDK5RAP3', 'UBAC2', 'DDRGK1', 'UFL1', 'FAF2', 'UBA5', 'UFM1']
467	GO:BP	GO:0033044	regulation of chromosome organization	0.0040140636371285	True	"""Any process that modulates the frequency, rate or extent of a process involved in the formation, arrangement of constituent parts, or disassembly of a chromosome."" [GOC:mah]"	252	97	7	17376	0.0721649484536082	0.0277777777777777	query_1	['GO:0033043', 'GO:0051276']	['NBN', 'ATF7IP', 'RAD50', 'SETDB2', 'SETDB1', 'MRE11', 'TRIM28']
468	GO:BP	GO:0016445	somatic diversification of immunoglobulins	0.0040639964833141	True	"""The somatic process that results in the generation of sequence diversity of immunoglobulins."" [GOC:add, GOC:ma, ISBN:0781735149]"	67	97	4	17376	0.0412371134020618	0.0597014925373134	query_1	['GO:0002200', 'GO:0002377']	['NBN', 'TP53BP1', 'PAXIP1', 'HSPD1']
469	GO:BP	GO:0018022	peptidyl-lysine methylation	0.0040819559996327	True	"""The methylation of peptidyl-lysine to form either the mono-, di- or trimethylated derivative."" [GOC:ai]"	119	97	5	17376	0.0515463917525773	0.042016806722689	query_1	['GO:0006479', 'GO:0018205']	['PAXIP1', 'SETDB2', 'METTL21C', 'SETDB1', 'BRCA1']
470	GO:BP	GO:0010638	positive regulation of organelle organization	0.0040819559996327	True	"""Any process that increases the frequency, rate or extent of a process involved in the formation, arrangement of constituent parts, or disassembly of an organelle."" [GOC:dph, GOC:tb]"	508	97	10	17376	0.1030927835051546	0.0196850393700787	query_1	['GO:0006996', 'GO:0033043', 'GO:0051130']	['PPIF', 'NBN', 'ATF7IP', 'RAD50', 'SETDB2', 'MCU', 'SETDB1', 'MRE11', 'VDAC1', 'TRIM28']
471	GO:BP	GO:0098771	inorganic ion homeostasis	0.0041234844217696	True	"""Any process involved in the maintenance of an internal steady state of inorganic ions within an organism or cell."" [GOC:dos]"	509	97	10	17376	0.1030927835051546	0.0196463654223968	query_1	['GO:0048878']	['MAIP1', 'OTC', 'MCUB', 'METTL21C', 'MCU', 'AFG3L2', 'ISCU', 'MICU1', 'SMDT1', 'MICU2']
472	GO:BP	GO:0071480	cellular response to gamma radiation	0.0041515982381149	True	"""Any process that results in a change in state or activity of a cell (in terms of movement, secretion, enzyme production, gene expression, etc.) as a result of a gamma radiation stimulus. Gamma radiation is a form of electromagnetic radiation (EMR) or light emission of a specific frequency produced from sub-atomic particle interaction, such as electron-positron annihilation and radioactive decay. Gamma rays are generally characterized as EMR having the highest frequency and energy, and also the shortest wavelength, within the electromagnetic radiation spectrum."" [GOC:mah]"	29	97	3	17376	0.0309278350515463	0.1034482758620689	query_1	['GO:0010332', 'GO:0071479']	['XRCC6', 'H2AX', 'RAD51']
473	GO:BP	GO:0039694	viral RNA genome replication	0.0041515982381149	True	"""The replication of a viral RNA genome."" [GOC:bf, GOC:jl]"	29	97	3	17376	0.0309278350515463	0.1034482758620689	query_1	['GO:0019079', 'GO:0032774']	['SETDB1', 'TRIM28', 'PHB1']
474	GO:BP	GO:0080134	regulation of response to stress	0.0042178666243041	True	"""Any process that modulates the frequency, rate or extent of a response to stress. Response to stress is a change in state or activity of a cell or an organism (in terms of movement, secretion, enzyme production, gene expression, etc.) as a result of a disturbance in organismal or cellular homeostasis, usually, but not necessarily, exogenous (e.g. temperature, humidity, ionizing radiation)."" [GOC:dhl]"	1380	97	18	17376	0.1855670103092783	0.0130434782608695	query_1	['GO:0006950', 'GO:0048583']	['RBBP8', 'TP53BP1', 'XRCC6', 'H2AX', 'DDRGK1', 'UFL1', 'PHB2', 'BRCA2', 'HSPD1', 'VDAC1', 'RAD51', 'HDAC6', 'BRCA1', 'MICU1', 'TRIM28', 'BARD1', 'PHB1', 'STAT5B']
475	GO:BP	GO:0008219	cell death	0.0042178666243041	True	"""Any biological process that results in permanent cessation of all vital functions of a cell. A cell should be considered dead when any one of the following molecular or morphological criteria is met: (1) the cell has lost the integrity of its plasma membrane; (2) the cell, including its nucleus, has undergone complete fragmentation into discrete bodies (frequently referred to as apoptotic bodies). The cell corpse (or its fragments) may be engulfed by an adjacent cell in vivo, but engulfment of whole cells should not be considered a strict criteria to define cell death as, under some circumstances, live engulfed cells can be released from phagosomes (see PMID:18045538)."" [GOC:mah, GOC:mtg_apoptosis, PMID:25236395]"	2010	97	23	17376	0.2371134020618556	0.0114427860696517	query_1	['GO:0009987']	['PPIF', 'SNX6', 'PDK4', 'SPG7', 'CDK5RAP3', 'NBN', 'HSPA9', 'DDRGK1', 'UFL1', 'PHB2', 'METTL21C', 'BRCA2', 'HSPD1', 'MRE11', 'VDAC1', 'HDAC6', 'PDK1', 'BRCA1', 'PDK2', 'BARD1', 'PHB1', 'UFM1', 'STAT5B']
476	GO:BP	GO:0033365	protein localization to organelle	0.0044139991967096	True	"""A process in which a protein is transported to, or maintained in, a location within an organelle."" [GOC:mah]"	924	97	14	17376	0.1443298969072164	0.0151515151515151	query_1	['GO:0008104']	['MAIP1', 'CDK5RAP3', 'UBAC2', 'DDRGK1', 'PMPCA', 'PHB2', 'BRCA2', 'SUMO1', 'HSPD1', 'RPA1', 'TRIM28', 'BARD1', 'PMPCB', 'UFM1']
477	REAC	REAC:R-HSA-3232142	SUMOylation of ubiquitinylation proteins	0.0046821379360072	True	SUMOylation of ubiquitinylation proteins	35	97	3	17376	0.0309278350515463	0.0857142857142857	query_1	['REAC:R-HSA-3108232']	['UBE2I', 'SUMO1', 'PIAS1']
478	GO:BP	GO:0046543	development of secondary female sexual characteristics	0.0046871189871392	True	"""The process whose specific outcome is the progression of the secondary female sexual characteristics over time, from their formation to the mature structures. In female humans, these include growth of axillary and pubic hair, breast development and menstrual periods. Their development occurs in response to sex hormone secretion."" [GOC:ai]"	7	97	2	17376	0.0206185567010309	0.2857142857142857	query_1	['GO:0045136']	['PHB2', 'STAT5B']
479	GO:BP	GO:0006627	protein processing involved in protein targeting to mitochondrion	0.0046871189871392	True	"""The cleavage of peptide bonds in proteins, usually near the N terminus, contributing to the process of import into the mitochondrion. Several different peptidases mediate cleavage of proteins destined for different mitochondrial compartments."" [GOC:mcc, PMID:12191769]"	7	97	2	17376	0.0206185567010309	0.2857142857142857	query_1	['GO:0006626', 'GO:0034982']	['PMPCA', 'PMPCB']
480	REAC	REAC:R-HSA-2559586	DNA Damage/Telomere Stress Induced Senescence	0.0047439950818238	True	DNA Damage/Telomere Stress Induced Senescence	79	97	4	17376	0.0412371134020618	0.050632911392405	query_1	['REAC:R-HSA-2559583']	['NBN', 'RAD50', 'H2AX', 'MRE11']
481	GO:BP	GO:0006839	mitochondrial transport	0.0047580578451385	True	"""Transport of substances into, out of or within a mitochondrion."" [GOC:ai]"	188	97	6	17376	0.0618556701030927	0.0319148936170212	query_1	['GO:0046907']	['PPIF', 'SPG7', 'MAIP1', 'PMPCA', 'HSPD1', 'PMPCB']
482	GO:BP	GO:0016444	somatic cell DNA recombination	0.0048330135007184	True	"""Recombination occurring within or between DNA molecules in somatic cells."" [GOC:ma]"	71	97	4	17376	0.0412371134020618	0.056338028169014	query_1	['GO:0006310']	['NBN', 'TP53BP1', 'PAXIP1', 'HSPD1']
483	GO:BP	GO:0051174	regulation of phosphorus metabolic process	0.0048330135007184	True	"""Any process that modulates the frequency, rate or extent of the chemical reactions and pathways involving phosphorus or compounds containing phosphorus."" [GOC:ai]"	1279	97	17	17376	0.1752577319587628	0.0132916340891321	query_1	['GO:0006793', 'GO:0031323']	['SNX6', 'PDK4', 'CDK5RAP3', 'NBN', 'RAD50', 'XRCC6', 'DDRGK1', 'PHB2', 'PDK3', 'BLM', 'MRE11', 'RAD51', 'HDAC6', 'PDK1', 'PDK2', 'BARD1', 'PHB1']
484	GO:BP	GO:0019220	regulation of phosphate metabolic process	0.0048330135007184	True	"""Any process that modulates the frequency, rate or extent of the chemical reactions and pathways involving phosphates."" [GOC:go_curators]"	1278	97	17	17376	0.1752577319587628	0.0133020344287949	query_1	['GO:0006796', 'GO:0051174']	['SNX6', 'PDK4', 'CDK5RAP3', 'NBN', 'RAD50', 'XRCC6', 'DDRGK1', 'PHB2', 'PDK3', 'BLM', 'MRE11', 'RAD51', 'HDAC6', 'PDK1', 'PDK2', 'BARD1', 'PHB1']
485	GO:BP	GO:0002562	somatic diversification of immune receptors via germline recombination within a single locus	0.0048330135007184	True	"""The process in which immune receptor genes are diversified through recombination of the germline genetic elements within a single genetic locus."" [GOC:add, ISBN:0781735149, PMID:16102575, PMID:16166509]"	71	97	4	17376	0.0412371134020618	0.056338028169014	query_1	['GO:0002200', 'GO:0016444']	['NBN', 'TP53BP1', 'PAXIP1', 'HSPD1']
486	REAC	REAC:R-HSA-3215018	Processing and activation of SUMO	0.0048443413774516	True	Processing and activation of SUMO	9	97	2	17376	0.0206185567010309	0.2222222222222222	query_1	['REAC:R-HSA-2990846']	['UBE2I', 'SUMO1']
487	REAC	REAC:R-HSA-8866904	Negative regulation of activity of TFAP2 (AP-2) family transcription factors	0.0048443413774516	True	Negative regulation of activity of TFAP2 (AP-2) family transcription factors	9	97	2	17376	0.0206185567010309	0.2222222222222222	query_1	['REAC:R-HSA-8864260']	['UBE2I', 'SUMO1']
488	REAC	REAC:R-HSA-9683610	Maturation of nucleoprotein	0.0048443413774516	True	Maturation of nucleoprotein	9	97	2	17376	0.0206185567010309	0.2222222222222222	query_1	['REAC:R-HSA-9683701']	['UBE2I', 'SUMO1']
489	REAC	REAC:R-HSA-2586552	Signaling by Leptin	0.0048443413774516	True	Signaling by Leptin	9	97	2	17376	0.0206185567010309	0.2222222222222222	query_1	['REAC:R-HSA-162582']	['STAT5A', 'STAT5B']
490	REAC	REAC:R-HSA-8985947	Interleukin-9 signaling	0.0048443413774516	True	Interleukin-9 signaling	9	97	2	17376	0.0206185567010309	0.2222222222222222	query_1	['REAC:R-HSA-451927']	['STAT5A', 'STAT5B']
491	GO:BP	GO:0070887	cellular response to chemical stimulus	0.0049022993441149	True	"""Any process that results in a change in state or activity of a cell (in terms of movement, secretion, enzyme production, gene expression, etc.) as a result of a chemical stimulus."" [GOC:mah]"	2577	97	27	17376	0.2783505154639175	0.0104772991850989	query_1	['GO:0042221', 'GO:0051716']	['PPIF', 'SNX6', 'PDK4', 'CDK5RAP3', 'HSPA9', 'DDRGK1', 'UFL1', 'PHB2', 'METTL21C', 'SDHD', 'MCU', 'SUMO1', 'HSPD1', 'PDK3', 'BLM', 'RAD51', 'HDAC6', 'GPD1', 'PDK1', 'BRCA1', 'MICU1', 'STAT5A', 'PDK2', 'UBA5', 'PHB1', 'UFM1', 'STAT5B']
492	GO:CC	GO:0110165	cellular anatomical entity	0.0049040098530429	True	"""A part of a cellular organism that is either an immaterial entity or a material entity with granularity above the level of a protein complex but below that of an anatomical system. Or, a substance produced by a cellular organism with granularity above the level of a protein complex."" [GOC:kmv]"	16238	97	97	17376	1.0	0.005973642074147	query_1	['GO:0005575']	['PPIF', 'RBBP8', 'SNX6', 'UBE2I', 'PDK4', 'GCSH', 'SPG7', 'PPM1K', 'SNX1', 'LYRM4', 'ADSL', 'MAIP1', 'CDK5RAP3', 'NBN', 'OTC', 'ATF7IP', 'DLST', 'HSPA9', 'MCUB', 'TP53BP1', 'RAD50', 'ZNF45', 'UBAC2', 'ZNF350', 'XRCC6', 'TALDO1', 'PAXIP1', 'DLAT', 'PDHA2', 'PDHX', 'SETDB2', 'PDHB', 'H2AX', 'DDRGK1', 'UFL1', 'MDC1', 'PMPCA', 'PHB2', 'MCAT', 'METTL21C', 'SDHD', 'DBT', 'BRCA2', 'MCU', 'SIL1', 'SETDB1', 'BCKDK', 'CDNF', 'BCKDHB', 'PDHA1', 'SUMO1', 'HSPD1', 'RPA1', 'PDK3', 'ARL14EP', 'FLYWCH1', 'BLM', 'PIAS1', 'MRE11', 'VDAC1', 'RAD51', 'AFG3L2', 'HDAC6', 'MOCS3', 'ISCU', 'GPD1', 'PDK1', 'NSUN6', 'SDHB', 'FAF2', 'NFS1', 'CBX5', 'NDUFAB1', 'BRCA1', 'SDHA', 'MICU1', 'STAT5A', 'SMDT1', 'SDHC', 'DLD', 'PDK2', 'MBD1', 'NDUFV3', 'TRIM28', 'BARD1', 'MICU2', 'MFN1', 'ABHD6', 'PEPD', 'PMPCB', 'UBA5', 'OGDH', 'GJA10', 'PHB1', 'UFM1', 'STAT5B', 'BCKDHA']
493	GO:BP	GO:0031507	heterochromatin formation	0.0050487490197445	True	"""An epigenetic gene silencing mechanism in which chromatin is compacted into heterochromatin, resulting in a chromatin conformation refractory to transcription. This process starts with heterochromatin nucleation, its spreading, and ends with heterochromatin boundary formation."" [PMID:25192661, PMID:33827924]"	72	97	4	17376	0.0412371134020618	0.0555555555555555	query_1	['GO:0045814', 'GO:0070828']	['ATF7IP', 'SETDB2', 'SETDB1', 'TRIM28']
494	GO:BP	GO:0018193	peptidyl-amino acid modification	0.0050487490197445	True	"""The alteration of an amino acid residue in a peptide."" [GOC:mah]"	1167	97	16	17376	0.1649484536082474	0.0137103684661525	query_1	['GO:0036211']	['PPIF', 'SNX6', 'UBE2I', 'GCSH', 'PAXIP1', 'SETDB2', 'METTL21C', 'BRCA2', 'SETDB1', 'SUMO1', 'PDK3', 'PIAS1', 'HDAC6', 'NDUFAB1', 'BRCA1', 'TRIM28']
495	REAC	REAC:R-HSA-8864260	Transcriptional regulation by the AP-2 (TFAP2) family of transcription factors	0.0050487707906233	True	Transcriptional regulation by the AP-2 (TFAP2) family of transcription factors	37	97	3	17376	0.0309278350515463	0.081081081081081	query_1	['REAC:R-HSA-212436']	['UBE2I', 'SUMO1', 'HSPD1']
496	GO:BP	GO:0034220	monoatomic ion transmembrane transport	0.005359504038725	True	"""A process in which a monoatomic ion is transported across a membrane. Monatomic ions (also called simple ions) are ions consisting of exactly one atom."" [GOC:mah]"	946	97	14	17376	0.1443298969072164	0.014799154334038	query_1	['GO:0006811', 'GO:0055085']	['PPIF', 'MAIP1', 'MCUB', 'PHB2', 'METTL21C', 'MCU', 'SUMO1', 'VDAC1', 'AFG3L2', 'ISCU', 'MICU1', 'SMDT1', 'MICU2', 'PMPCB']
497	GO:BP	GO:0032259	methylation	0.005359504038725	True	"""The process in which a methyl group is covalently attached to a molecule."" [GOC:mah]"	349	97	8	17376	0.0824742268041237	0.0229226361031518	query_1	['GO:0008152']	['ATF7IP', 'PAXIP1', 'SETDB2', 'METTL21C', 'SETDB1', 'NSUN6', 'BRCA1', 'TRIM28']
498	GO:CC	GO:0034399	nuclear periphery	0.0053835473410269	True	"""The portion of the nuclear lumen proximal to the inner nuclear membrane."" [GOC:krc, GOC:mah]"	150	97	5	17376	0.0515463917525773	0.0333333333333333	query_1	['GO:0031981', 'GO:0110165']	['ZNF350', 'PAXIP1', 'PHB2', 'BLM', 'MBD1']
499	REAC	REAC:R-HSA-5696399	Global Genome Nucleotide Excision Repair (GG-NER)	0.0054672153617393	True	Global Genome Nucleotide Excision Repair (GG-NER)	84	97	4	17376	0.0412371134020618	0.0476190476190476	query_1	['REAC:R-HSA-5696398']	['UBE2I', 'SUMO1', 'RPA1', 'PIAS1']
500	GO:BP	GO:0030218	erythrocyte differentiation	0.0055354236276168	True	"""The process in which a myeloid precursor cell acquires specializes features of an erythrocyte."" [GOC:mah]"	129	97	5	17376	0.0515463917525773	0.0387596899224806	query_1	['GO:0030099', 'GO:0034101']	['CDK5RAP3', 'HSPA9', 'UFL1', 'UBA5', 'STAT5B']
501	GO:BP	GO:0002637	regulation of immunoglobulin production	0.0055354236276168	True	"""Any process that modulates the frequency, rate, or extent of immunoglobulin production."" [GOC:add]"	74	97	4	17376	0.0412371134020618	0.054054054054054	query_1	['GO:0002377', 'GO:0002700']	['TP53BP1', 'PAXIP1', 'PHB2', 'PHB1']
502	GO:BP	GO:0006915	apoptotic process	0.0056484965325206	True	"""A programmed cell death process which begins when a cell receives an internal (e.g. DNA damage) or external signal (e.g. an extracellular death ligand), and proceeds through a series of biochemical events (signaling pathway phase) which trigger an execution phase. The execution phase is the last step of an apoptotic process, and is typically characterized by rounding-up of the cell, retraction of pseudopodes, reduction of cellular volume (pyknosis), chromatin condensation, nuclear fragmentation (karyorrhexis), plasma membrane blebbing and fragmentation of the cell into apoptotic bodies. When the execution phase is completed, the cell has died."" [GOC:cjm, GOC:dhl, GOC:ecd, GOC:go_curators, GOC:mtg_apoptosis, GOC:tb, ISBN:0198506732, PMID:18846107, PMID:21494263]"	1798	97	21	17376	0.2164948453608247	0.0116796440489432	query_1	['GO:0012501']	['PPIF', 'SNX6', 'PDK4', 'CDK5RAP3', 'NBN', 'HSPA9', 'DDRGK1', 'UFL1', 'PHB2', 'METTL21C', 'BRCA2', 'HSPD1', 'MRE11', 'VDAC1', 'PDK1', 'BRCA1', 'PDK2', 'BARD1', 'PHB1', 'UFM1', 'STAT5B']
503	GO:BP	GO:0060548	negative regulation of cell death	0.0056901099257634	True	"""Any process that decreases the rate or frequency of cell death. Cell death is the specific activation or halting of processes within a cell so that its vital functions markedly cease, rather than simply deteriorating gradually over time, which culminates in cell death."" [GOC:BHF, GOC:dph, GOC:tb]"	953	97	14	17376	0.1443298969072164	0.0146904512067156	query_1	['GO:0008219', 'GO:0010941', 'GO:0048523']	['PPIF', 'SNX6', 'PDK4', 'HSPA9', 'DDRGK1', 'UFL1', 'PHB2', 'HSPD1', 'MRE11', 'VDAC1', 'BRCA1', 'BARD1', 'UFM1', 'STAT5B']
504	REAC	REAC:R-HSA-9702518	STAT5 activation downstream of FLT3 ITD mutants	0.0057527930636985	True	STAT5 activation downstream of FLT3 ITD mutants	10	97	2	17376	0.0206185567010309	0.2	query_1	['REAC:R-HSA-9703648']	['STAT5A', 'STAT5B']
505	REAC	REAC:R-HSA-9020958	Interleukin-21 signaling	0.0057527930636985	True	Interleukin-21 signaling	10	97	2	17376	0.0206185567010309	0.2	query_1	['REAC:R-HSA-451927']	['STAT5A', 'STAT5B']
506	GO:BP	GO:0045647	negative regulation of erythrocyte differentiation	0.0059145017272267	True	"""Any process that stops, prevents, or reduces the frequency, rate or extent of erythrocyte differentiation."" [GOC:go_curators]"	8	97	2	17376	0.0206185567010309	0.25	query_1	['GO:0030218', 'GO:0045638', 'GO:0045646']	['HSPA9', 'STAT5B']
507	GO:BP	GO:1904354	negative regulation of telomere capping	0.0059145017272267	True	"""Any process that stops, prevents or reduces the frequency, rate or extent of telomere capping."" [GO_REF:0000058, GOC:BHF, GOC:BHF_telomere, GOC:nc, GOC:TermGenie, PMID:23959892]"	8	97	2	17376	0.0206185567010309	0.25	query_1	['GO:0016233', 'GO:0032205', 'GO:1904353']	['NBN', 'RAD50']
508	GO:BP	GO:0070537	histone H2A K63-linked deubiquitination	0.0059145017272267	True	"""A protein deubiquitination process in which a K63-linked ubiquitin chain, i.e. a polymer of ubiquitin formed by linkages between lysine residues at position 63 of the ubiquitin monomers, is removed from a lysine residue in histone H2A or the variant H2AX."" [GOC:mah, PMID:19202061, PMID:19214193]"	8	97	2	17376	0.0206185567010309	0.25	query_1	['GO:0016578', 'GO:0070536']	['BRCA1', 'BARD1']
509	GO:BP	GO:0046907	intracellular transport	0.0059514500635986	True	"""The directed movement of substances within a cell."" [GOC:ai]"	1553	97	19	17376	0.1958762886597938	0.0122343850611719	query_1	['GO:0006810', 'GO:0051641', 'GO:0051649']	['PPIF', 'SNX6', 'UBE2I', 'SPG7', 'SNX1', 'MAIP1', 'HSPA9', 'UBAC2', 'PMPCA', 'PHB2', 'SIL1', 'SUMO1', 'HSPD1', 'HDAC6', 'FAF2', 'TRIM28', 'BARD1', 'PMPCB', 'UFM1']
510	GO:BP	GO:0044772	mitotic cell cycle phase transition	0.0059946581291919	True	"""The cell cycle process by which a cell commits to entering the next mitotic cell cycle phase."" [GOC:mtg_cell_cycle]"	446	97	9	17376	0.0927835051546391	0.0201793721973094	query_1	['GO:0044770', 'GO:1903047']	['RBBP8', 'CDK5RAP3', 'NBN', 'RAD50', 'PHB2', 'BLM', 'MRE11', 'BRCA1', 'BARD1']
511	GO:BP	GO:0072594	establishment of protein localization to organelle	0.0059946581291919	True	"""The directed movement of a protein to a specific location on or in an organelle. Encompasses establishment of localization in the membrane or lumen of a membrane-bounded organelle."" [GOC:mah]"	446	97	9	17376	0.0927835051546391	0.0201793721973094	query_1	['GO:0033365', 'GO:0045184']	['MAIP1', 'PMPCA', 'PHB2', 'BRCA2', 'SUMO1', 'HSPD1', 'TRIM28', 'PMPCB', 'UFM1']
512	GO:BP	GO:0042176	regulation of protein catabolic process	0.0059946581291919	True	"""Any process that modulates the frequency, rate or extent of the chemical reactions and pathways resulting in the breakdown of a protein by the destruction of the native, active configuration, with or without the hydrolysis of peptide bonds."" [GOC:go_curators, GOC:jl]"	357	97	8	17376	0.0824742268041237	0.0224089635854341	query_1	['GO:0009894', 'GO:0030163', 'GO:0051246']	['SNX1', 'CDK5RAP3', 'DDRGK1', 'UFL1', 'SUMO1', 'PIAS1', 'BARD1', 'PHB1']
513	GO:BP	GO:1901698	response to nitrogen compound	0.0063995667019555	True	"""Any process that results in a change in state or activity of a cell or an organism (in terms of movement, secretion, enzyme production, gene expression, etc.) as a result of a nitrogen compound stimulus."" [GOC:pr, GOC:TermGenie]"	1081	97	15	17376	0.1546391752577319	0.0138760407030527	query_1	['GO:0042221']	['SNX6', 'PDK4', 'OTC', 'UBAC2', 'UFL1', 'BCKDHB', 'BLM', 'RAD51', 'HDAC6', 'GPD1', 'FAF2', 'BRCA1', 'STAT5A', 'PDK2', 'STAT5B']
514	GO:BP	GO:0002200	somatic diversification of immune receptors	0.0065271933272544	True	"""The somatic process allowing for the production of immune receptors whose specificity is not encoded in the germline genomic sequences."" [GOC:add, ISBN:0781735149, PMID:16102575, PMID:16166509]"	78	97	4	17376	0.0412371134020618	0.0512820512820512	query_1	['GO:0002376', 'GO:0002520']	['NBN', 'TP53BP1', 'PAXIP1', 'HSPD1']
515	GO:BP	GO:0033144	negative regulation of intracellular steroid hormone receptor signaling pathway	0.0066498733086818	True	"""Any process that stops, prevents, or reduces the frequency, rate or extent of the activity of any intracellular steroid hormone receptor signaling pathway."" [GOC:mah]"	35	97	3	17376	0.0309278350515463	0.0857142857142857	query_1	['GO:0009968', 'GO:0030518', 'GO:0033143']	['PHB2', 'BRCA1', 'PHB1']
516	GO:BP	GO:0051053	negative regulation of DNA metabolic process	0.0067575322697939	True	"""Any process that stops, prevents, or reduces the frequency, rate or extent of the chemical reactions and pathways involving DNA."" [GOC:ai]"	136	97	5	17376	0.0515463917525773	0.0367647058823529	query_1	['GO:0006259', 'GO:0010605', 'GO:0045934', 'GO:0051052']	['NBN', 'TP53BP1', 'RAD50', 'BLM', 'TRIM28']
517	GO:BP	GO:0048519	negative regulation of biological process	0.0067859313390938	True	"""Any process that stops, prevents, or reduces the frequency, rate or extent of a biological process. Biological processes are regulated by many means; examples include the control of gene expression, protein modification or interaction with a protein or substrate molecule."" [GOC:jid]"	5057	97	43	17376	0.4432989690721649	0.0085030650583349	query_1	['GO:0008150', 'GO:0050789']	['PPIF', 'RBBP8', 'SNX6', 'UBE2I', 'PDK4', 'CDK5RAP3', 'NBN', 'ATF7IP', 'HSPA9', 'TP53BP1', 'RAD50', 'UBAC2', 'ZNF350', 'XRCC6', 'SETDB2', 'H2AX', 'DDRGK1', 'UFL1', 'MDC1', 'PHB2', 'METTL21C', 'BRCA2', 'SETDB1', 'BCKDK', 'SUMO1', 'HSPD1', 'FLYWCH1', 'BLM', 'PIAS1', 'MRE11', 'VDAC1', 'RAD51', 'HDAC6', 'ISCU', 'CBX5', 'BRCA1', 'MBD1', 'TRIM28', 'BARD1', 'ABHD6', 'PHB1', 'UFM1', 'STAT5B']
518	REAC	REAC:R-HSA-4755510	SUMOylation of immune response proteins	0.0069251213387065	True	SUMOylation of immune response proteins	11	97	2	17376	0.0206185567010309	0.1818181818181818	query_1	['REAC:R-HSA-3108232']	['UBE2I', 'SUMO1']
519	GO:CC	GO:0009295	nucleoid	0.0069494011095556	True	"""The region of a virus, bacterial cell, mitochondrion or chloroplast to which the nucleic acid is confined."" [GOC:bm, GOC:ma, ISBN:3540076689]"	45	97	3	17376	0.0309278350515463	0.0666666666666666	query_1	['GO:0110165']	['HSPA9', 'DBT', 'VDAC1']
520	GO:CC	GO:0042645	mitochondrial nucleoid	0.0069494011095556	True	"""The region of a mitochondrion to which the DNA is confined."" [GOC:jl]"	45	97	3	17376	0.0309278350515463	0.0666666666666666	query_1	['GO:0005759', 'GO:0009295', 'GO:0043232']	['HSPA9', 'DBT', 'VDAC1']
521	GO:CC	GO:0005667	transcription regulator complex	0.0069572149954277	True	"""A protein complex that is capable of associating with DNA by direct binding, or via other DNA-binding proteins or complexes, and regulating transcription."" [GOC:jl]"	505	97	9	17376	0.0927835051546391	0.0178217821782178	query_1	['GO:0032991']	['RBBP8', 'ATF7IP', 'ZNF350', 'XRCC6', 'FLYWCH1', 'CBX5', 'STAT5A', 'TRIM28', 'STAT5B']
522	GO:BP	GO:0006812	monoatomic cation transport	0.0071059575298277	True	"""The directed movement of a monoatomic cation, into, out of or within a cell, or between cells, by means of some agent such as a transporter or pore. Monatomic cations (also called simple cations) are positively charged ions consisting of exactly one atom."" [GOC:ai]"	979	97	14	17376	0.1443298969072164	0.0143003064351378	query_1	['GO:0006811']	['PPIF', 'MAIP1', 'MCUB', 'PHB2', 'METTL21C', 'MCU', 'SUMO1', 'VDAC1', 'AFG3L2', 'ISCU', 'MICU1', 'SMDT1', 'MICU2', 'PMPCB']
523	GO:BP	GO:0006631	fatty acid metabolic process	0.0071315934694851	True	"""The chemical reactions and pathways involving fatty acids, aliphatic monocarboxylic acids liberated from naturally occurring fats and oils by hydrolysis."" [ISBN:0198547684]"	368	97	8	17376	0.0824742268041237	0.0217391304347826	query_1	['GO:0032787', 'GO:0044255']	['PDK4', 'MCAT', 'PDK3', 'PDK1', 'NDUFAB1', 'BRCA1', 'PDK2', 'ABHD6']
524	GO:BP	GO:0034101	erythrocyte homeostasis	0.0071315934694851	True	"""Any process of regulating the production and elimination of erythrocytes within an organism."" [GOC:add, PMID:10694114, PMID:14754397]"	138	97	5	17376	0.0515463917525773	0.036231884057971	query_1	['GO:0002262']	['CDK5RAP3', 'HSPA9', 'UFL1', 'UBA5', 'STAT5B']
525	GO:BP	GO:0031323	regulation of cellular metabolic process	0.0071956413472192	True	"""Any process that modulates the frequency, rate or extent of the chemical reactions and pathways by which individual cells transform chemical substances."" [GOC:mah]"	5073	97	43	17376	0.4432989690721649	0.0084762467967671	query_1	['GO:0019222', 'GO:0044237', 'GO:0050794']	['PPIF', 'RBBP8', 'SNX6', 'UBE2I', 'PDK4', 'CDK5RAP3', 'NBN', 'ATF7IP', 'TP53BP1', 'RAD50', 'ZNF45', 'ZNF350', 'XRCC6', 'PAXIP1', 'SETDB2', 'H2AX', 'DDRGK1', 'UFL1', 'PHB2', 'BRCA2', 'SETDB1', 'BCKDK', 'SUMO1', 'PDK3', 'FLYWCH1', 'BLM', 'PIAS1', 'MRE11', 'VDAC1', 'RAD51', 'HDAC6', 'ISCU', 'GPD1', 'PDK1', 'CBX5', 'BRCA1', 'STAT5A', 'PDK2', 'MBD1', 'TRIM28', 'BARD1', 'PHB1', 'STAT5B']
526	GO:BP	GO:0019694	alkanesulfonate metabolic process	0.0072148992076111	True	"""The chemical reactions and pathways involving alkanesulfonates, the anion of alkanesulfonic acids, sulfonic acid derivatives containing an aliphatic hydrocarbon group."" [GOC:ai]"	9	97	2	17376	0.0206185567010309	0.2222222222222222	query_1	['GO:0006082', 'GO:0006790']	['STAT5A', 'STAT5B']
527	GO:BP	GO:0006104	succinyl-CoA metabolic process	0.0072148992076111	True	"""The chemical reactions and pathways involving succinyl-CoA, a compound composed of the monovalent acyl group 3-carboxypropanoyl, derived from succinic acid by loss of one OH group, linked to coenzyme A."" [GOC:ai]"	9	97	2	17376	0.0206185567010309	0.2222222222222222	query_1	['GO:0006637']	['DLST', 'OGDH']
528	GO:BP	GO:0019530	taurine metabolic process	0.0072148992076111	True	"""The chemical reactions and pathways involving taurine (2-aminoethanesulfonic acid), a sulphur-containing amino acid derivative important in the metabolism of fats."" [GOC:jl, ISBN:0198600461]"	9	97	2	17376	0.0206185567010309	0.2222222222222222	query_1	['GO:0019694', 'GO:1901564']	['STAT5A', 'STAT5B']
529	GO:BP	GO:0085020	protein K6-linked ubiquitination	0.0072148992076111	True	"""A protein ubiquitination process in which a polymer of ubiquitin, formed by linkages between lysine residues at position 6 of the ubiquitin monomers, is added to a protein. K6-linked ubiquitination is involved in DNA repair."" [GOC:sp]"	9	97	2	17376	0.0206185567010309	0.2222222222222222	query_1	['GO:0000209']	['BRCA1', 'BARD1']
530	GO:BP	GO:0070828	heterochromatin organization	0.0072236077100297	True	"""Any process that results in the specification, formation or maintenance of the physical structure of eukaryotic heterochromatin, a compact and highly condensed form of chromatin."" [GOC:mah]"	81	97	4	17376	0.0412371134020618	0.0493827160493827	query_1	['GO:0006338']	['ATF7IP', 'SETDB2', 'SETDB1', 'TRIM28']
531	GO:BP	GO:0010833	telomere maintenance via telomere lengthening	0.0072236077100297	True	"""Any process that contributes to the maintenance of proper telomeric length and structure by affecting and monitoring the activity of telomeric proteins and lengthening the telomeric DNA."" [GOC:dph, GOC:tb]"	81	97	4	17376	0.0412371134020618	0.0493827160493827	query_1	['GO:0000723']	['RAD50', 'RPA1', 'MRE11', 'RAD51']
532	GO:BP	GO:0006513	protein monoubiquitination	0.0072236077100297	True	"""Addition of a single ubiquitin group to a protein."" [GOC:ai]"	81	97	4	17376	0.0412371134020618	0.0493827160493827	query_1	['GO:0016567']	['BRCA2', 'RAD51', 'BRCA1', 'BARD1']
533	GO:BP	GO:0000423	mitophagy	0.0074785479153727	True	"""The selective autophagy process in which a mitochondrion is degraded by macroautophagy."" [PMID:15798367]"	37	97	3	17376	0.0309278350515463	0.081081081081081	query_1	['GO:0000422', 'GO:0061912']	['PHB2', 'VDAC1', 'HDAC6']
534	GO:BP	GO:0051865	protein autoubiquitination	0.0074785479153727	True	"""The ubiquitination by a protein of one or more of its own amino acid residues, or residues on an identical protein. Ubiquitination occurs on the lysine residue by formation of an isopeptide crosslink."" [GOC:ai]"	82	97	4	17376	0.0412371134020618	0.048780487804878	query_1	['GO:0016567']	['BRCA2', 'RAD51', 'BRCA1', 'BARD1']
535	GO:BP	GO:0033260	nuclear DNA replication	0.0074785479153727	True	"""The DNA-dependent DNA replication that occurs in the nucleus of eukaryotic organisms as part of the cell cycle."" [GOC:mtg_cell_cycle]"	37	97	3	17376	0.0309278350515463	0.081081081081081	query_1	['GO:0044786']	['BRCA2', 'BLM', 'RAD51']
536	GO:BP	GO:0022616	DNA strand elongation	0.0074785479153727	True	"""The DNA metabolic process in which an existing DNA strand is extended by activities including the addition of nucleotides to the 3' end of the strand."" [GOC:isa_complete, GOC:mah]"	37	97	3	17376	0.0309278350515463	0.081081081081081	query_1	['GO:0006259']	['NBN', 'RAD50', 'MRE11']
537	GO:BP	GO:0042113	B cell activation	0.0075045544331907	True	"""The change in morphology and behavior of a mature or immature B cell resulting from exposure to a mitogen, cytokine, chemokine, cellular ligand, or an antigen for which it is specific."" [GOC:mgi_curators, ISBN:0781735149]"	288	97	7	17376	0.0721649484536082	0.0243055555555555	query_1	['GO:0046649']	['NBN', 'TP53BP1', 'PAXIP1', 'PHB2', 'HSPD1', 'PHB1', 'STAT5B']
538	GO:BP	GO:0010558	negative regulation of macromolecule biosynthetic process	0.0076696508030797	True	"""Any process that decreases the rate, frequency or extent of the chemical reactions and pathways resulting in the formation of a macromolecule, any molecule of high relative molecular mass, the structure of which essentially comprises the multiple repetition of units derived, actually or conceptually, from molecules of low relative molecular mass."" [GOC:dph, GOC:tb]"	1470	97	18	17376	0.1855670103092783	0.0122448979591836	query_1	['GO:0009059', 'GO:0009890', 'GO:0010556', 'GO:0010605']	['RBBP8', 'SNX6', 'UBE2I', 'ATF7IP', 'ZNF350', 'XRCC6', 'SETDB2', 'PHB2', 'SETDB1', 'SUMO1', 'FLYWCH1', 'PIAS1', 'HDAC6', 'CBX5', 'BRCA1', 'MBD1', 'TRIM28', 'PHB1']
539	GO:BP	GO:0010033	response to organic substance	0.0077427867586597	True	"""Any process that results in a change in state or activity of a cell or an organism (in terms of movement, secretion, enzyme production, gene expression, etc.) as a result of an organic substance stimulus."" [GOC:sm, PMID:23356676]"	2673	97	27	17376	0.2783505154639175	0.0101010101010101	query_1	['GO:0042221']	['PPIF', 'SNX6', 'PDK4', 'CDK5RAP3', 'OTC', 'HSPA9', 'UBAC2', 'DDRGK1', 'UFL1', 'PHB2', 'METTL21C', 'SETDB1', 'BCKDHB', 'HSPD1', 'PDK3', 'BLM', 'RAD51', 'HDAC6', 'GPD1', 'FAF2', 'BRCA1', 'STAT5A', 'PDK2', 'UBA5', 'PHB1', 'UFM1', 'STAT5B']
540	GO:BP	GO:0043170	macromolecule metabolic process	0.0077429541028617	True	"""The chemical reactions and pathways involving macromolecules, any molecule of high relative molecular mass, the structure of which essentially comprises the multiple repetition of units derived, actually or conceptually, from molecules of low relative molecular mass."" [GOC:mah]"	8540	97	63	17376	0.6494845360824743	0.0073770491803278	query_1	['GO:0071704']	['PPIF', 'RBBP8', 'SNX6', 'UBE2I', 'PDK4', 'GCSH', 'SPG7', 'PPM1K', 'SNX1', 'CDK5RAP3', 'NBN', 'ATF7IP', 'DLST', 'TP53BP1', 'RAD50', 'ZNF45', 'UBAC2', 'ZNF350', 'XRCC6', 'PAXIP1', 'SETDB2', 'H2AX', 'DDRGK1', 'UFL1', 'MDC1', 'PMPCA', 'PHB2', 'METTL21C', 'BRCA2', 'SETDB1', 'BCKDK', 'SUMO1', 'HSPD1', 'RPA1', 'PDK3', 'FLYWCH1', 'BLM', 'PIAS1', 'MRE11', 'RAD51', 'AFG3L2', 'HDAC6', 'MOCS3', 'PDK1', 'NSUN6', 'FAF2', 'NFS1', 'CBX5', 'NDUFAB1', 'BRCA1', 'STAT5A', 'DLD', 'PDK2', 'MBD1', 'TRIM28', 'BARD1', 'PEPD', 'PMPCB', 'UBA5', 'OGDH', 'PHB1', 'UFM1', 'STAT5B']
541	REAC	REAC:R-HSA-9020558	Interleukin-2 signaling	0.0080039672129744	True	Interleukin-2 signaling	12	97	2	17376	0.0206185567010309	0.1666666666666666	query_1	['REAC:R-HSA-451927']	['STAT5A', 'STAT5B']
542	REAC	REAC:R-HSA-877312	Regulation of IFNG signaling	0.0080039672129744	True	Regulation of IFNG signaling	12	97	2	17376	0.0206185567010309	0.1666666666666666	query_1	['REAC:R-HSA-877300']	['SUMO1', 'PIAS1']
543	REAC	REAC:R-HSA-3371511	HSF1 activation	0.0080039672129744	True	HSF1 activation	12	97	2	17376	0.0206185567010309	0.1666666666666666	query_1	['REAC:R-HSA-3371556']	['RPA1', 'HDAC6']
544	GO:BP	GO:0045814	negative regulation of gene expression, epigenetic	0.0080691785073319	True	"""An epigenetic process that silences gene expression at specific genomic regions through chromatin remodelling either by modifying higher order chromatin fiber structure, nucleosomal histones, or the DNA."" [PMID:22243696]"	84	97	4	17376	0.0412371134020618	0.0476190476190476	query_1	['GO:0010629', 'GO:0040029']	['ATF7IP', 'SETDB2', 'SETDB1', 'TRIM28']
545	GO:BP	GO:0033993	response to lipid	0.0080734827529246	True	"""Any process that results in a change in state or activity of a cell or an organism (in terms of movement, secretion, enzyme production, gene expression, etc.) as a result of a lipid stimulus."" [GOC:sl]"	885	97	13	17376	0.134020618556701	0.0146892655367231	query_1	['GO:0010033']	['PDK4', 'DDRGK1', 'UFL1', 'PHB2', 'METTL21C', 'BCKDHB', 'PDK3', 'HDAC6', 'BRCA1', 'UBA5', 'PHB1', 'UFM1', 'STAT5B']
546	GO:BP	GO:0006468	protein phosphorylation	0.0081102099760003	True	"""The process of introducing a phosphate group on to a protein."" [GOC:hb]"	1479	97	18	17376	0.1855670103092783	0.0121703853955375	query_1	['GO:0016310', 'GO:0036211']	['SNX6', 'PDK4', 'CDK5RAP3', 'NBN', 'RAD50', 'XRCC6', 'DDRGK1', 'PHB2', 'BCKDK', 'PDK3', 'BLM', 'MRE11', 'RAD51', 'HDAC6', 'PDK1', 'PDK2', 'TRIM28', 'PHB1']
547	GO:BP	GO:0002440	production of molecular mediator of immune response	0.0083015036055076	True	"""The synthesis or release of any molecular mediator of the immune response, resulting in an increase in its intracellular or extracellular levels."" [GO_REF:0000022, GOC:add, ISBN:0781735149]"	215	97	6	17376	0.0618556701030927	0.027906976744186	query_1	['GO:0002376', 'GO:0010467']	['NBN', 'TP53BP1', 'PAXIP1', 'PHB2', 'HSPD1', 'PHB1']
548	GO:BP	GO:0007007	inner mitochondrial membrane organization	0.0084981891052113	True	"""A process that is carried out at the cellular level which results in the assembly, arrangement of constituent parts, or disassembly of the mitochondrial inner membrane."" [GOC:ai, GOC:dph, GOC:jl, GOC:mah]"	39	97	3	17376	0.0309278350515463	0.0769230769230769	query_1	['GO:0007006']	['MAIP1', 'HSPA9', 'AFG3L2']
549	GO:BP	GO:0045136	development of secondary sexual characteristics	0.0085305613286355	True	"""The process whose specific outcome is the progression of the secondary sexual characteristics over time, from their formation to the mature structures. In humans, these include growth of axillary, chest, and pubic hair, voice changes, testicular/penile enlargement, breast development and menstrual periods. Development occurs in response to sex hormone secretion."" [GOC:ai]"	10	97	2	17376	0.0206185567010309	0.2	query_1	['GO:0003006']	['PHB2', 'STAT5B']
550	GO:BP	GO:0098779	positive regulation of mitophagy in response to mitochondrial depolarization	0.0085305613286355	True	"""Any process that activates or increases the frequency, rate or extent of mitophagy in response to mitochondrial depolarization."" [GOC:PARL, PMID:18200046, PMID:23985961]"	10	97	2	17376	0.0206185567010309	0.2	query_1	['GO:0000423', 'GO:1904925']	['VDAC1', 'HDAC6']
551	GO:BP	GO:0060397	growth hormone receptor signaling pathway via JAK-STAT	0.0085305613286355	True	"""The process in which STAT proteins (Signal Transducers and Activators of Transcription) are activated by members of the JAK (janus activated kinase) family of tyrosine kinases, following the binding of physiological ligands to the growth hormone receptor. Once activated, STATs dimerize and translocate to the nucleus and modulate the expression of target genes."" [GOC:BHF, GOC:dph, PMID:11445442]"	10	97	2	17376	0.0206185567010309	0.2	query_1	['GO:0060396']	['STAT5A', 'STAT5B']
552	GO:CC	GO:0005575	cellular_component	0.0085566899947119	True	"""A location, relative to cellular compartments and structures, occupied by a macromolecular machine when it carries out a molecular function. There are two ways in which the gene ontology describes locations of gene products: (1) relative to cellular structures (e.g., cytoplasmic side of plasma membrane) or compartments (e.g., mitochondrion), and (2) the stable macromolecular complexes of which they are parts (e.g., the ribosome)."" [GOC:pdt, NIF_Subcellular:sao1337158144]"	16341	97	97	17376	1.0	0.0059359892295453	query_1	[]	['PPIF', 'RBBP8', 'SNX6', 'UBE2I', 'PDK4', 'GCSH', 'SPG7', 'PPM1K', 'SNX1', 'LYRM4', 'ADSL', 'MAIP1', 'CDK5RAP3', 'NBN', 'OTC', 'ATF7IP', 'DLST', 'HSPA9', 'MCUB', 'TP53BP1', 'RAD50', 'ZNF45', 'UBAC2', 'ZNF350', 'XRCC6', 'TALDO1', 'PAXIP1', 'DLAT', 'PDHA2', 'PDHX', 'SETDB2', 'PDHB', 'H2AX', 'DDRGK1', 'UFL1', 'MDC1', 'PMPCA', 'PHB2', 'MCAT', 'METTL21C', 'SDHD', 'DBT', 'BRCA2', 'MCU', 'SIL1', 'SETDB1', 'BCKDK', 'CDNF', 'BCKDHB', 'PDHA1', 'SUMO1', 'HSPD1', 'RPA1', 'PDK3', 'ARL14EP', 'FLYWCH1', 'BLM', 'PIAS1', 'MRE11', 'VDAC1', 'RAD51', 'AFG3L2', 'HDAC6', 'MOCS3', 'ISCU', 'GPD1', 'PDK1', 'NSUN6', 'SDHB', 'FAF2', 'NFS1', 'CBX5', 'NDUFAB1', 'BRCA1', 'SDHA', 'MICU1', 'STAT5A', 'SMDT1', 'SDHC', 'DLD', 'PDK2', 'MBD1', 'NDUFV3', 'TRIM28', 'BARD1', 'MICU2', 'MFN1', 'ABHD6', 'PEPD', 'PMPCB', 'UBA5', 'OGDH', 'GJA10', 'PHB1', 'UFM1', 'STAT5B', 'BCKDHA']
553	GO:BP	GO:0002312	B cell activation involved in immune response	0.0086183046923965	True	"""The change in morphology and behavior of a mature or immature B cell during an immune response, resulting from exposure to a mitogen, cytokine, chemokine, cellular ligand, or an antigen for which it is specific."" [GOC:jal]"	86	97	4	17376	0.0412371134020618	0.0465116279069767	query_1	['GO:0002285', 'GO:0042113']	['NBN', 'TP53BP1', 'PAXIP1', 'HSPD1']
554	GO:BP	GO:0007049	cell cycle	0.0089373974498378	True	"""The progression of biochemical and morphological phases and events that occur in a cell during successive cell replication or nuclear replication events. Canonically, the cell cycle comprises the replication and segregation of genetic material followed by the division of the cell, but in endocycles or syncytial cells nuclear replication or nuclear division may not be followed by cell division."" [GOC:go_curators, GOC:mtg_cell_cycle]"	1750	97	20	17376	0.2061855670103092	0.0114285714285714	query_1	['GO:0009987']	['RBBP8', 'UBE2I', 'CDK5RAP3', 'NBN', 'TP53BP1', 'RAD50', 'PAXIP1', 'SETDB2', 'H2AX', 'DDRGK1', 'MDC1', 'PHB2', 'BRCA2', 'RPA1', 'BLM', 'MRE11', 'RAD51', 'BRCA1', 'BARD1', 'STAT5B']
555	GO:BP	GO:0043648	dicarboxylic acid metabolic process	0.0089478044831847	True	"""The chemical reactions and pathways involving dicarboxylic acids, any organic acid containing two carboxyl (COOH) groups or anions (COO-)."" [ISBN:0198506732]"	87	97	4	17376	0.0412371134020618	0.0459770114942528	query_1	['GO:0019752']	['DLST', 'SDHB', 'SDHA', 'OGDH']
556	GO:BP	GO:0016233	telomere capping	0.008981257349698	True	"""A process in which telomeres are protected from degradation and fusion, thereby ensuring chromosome stability by protecting the ends from both degradation and from being recognized as damaged DNA. May be mediated by specific single- or double-stranded telomeric DNA binding proteins."" [GOC:mah, GOC:rn, PMID:11349150, PMID:11352055]"	40	97	3	17376	0.0309278350515463	0.075	query_1	['GO:0000723']	['NBN', 'RAD50', 'MRE11']
557	GO:BP	GO:0009719	response to endogenous stimulus	0.0090578550984389	True	"""Any process that results in a change in state or activity of a cell or an organism (in terms of movement, secretion, enzyme production, gene expression, etc.) as a result of a stimulus arising within the organism."" [GOC:sm]"	1624	97	19	17376	0.1958762886597938	0.0116995073891625	query_1	['GO:0050896']	['SNX6', 'PDK4', 'OTC', 'DDRGK1', 'UFL1', 'PHB2', 'METTL21C', 'BCKDHB', 'BLM', 'RAD51', 'HDAC6', 'GPD1', 'BRCA1', 'STAT5A', 'PDK2', 'UBA5', 'PHB1', 'UFM1', 'STAT5B']
558	REAC	REAC:R-HSA-9694631	Maturation of nucleoprotein	0.0092200067463025	True	Maturation of nucleoprotein	13	97	2	17376	0.0206185567010309	0.1538461538461538	query_1	['REAC:R-HSA-9694635']	['UBE2I', 'SUMO1']
559	REAC	REAC:R-HSA-3270619	IRF3-mediated induction of type I IFN	0.0092200067463025	True	IRF3-mediated induction of type I IFN	13	97	2	17376	0.0206185567010309	0.1538461538461538	query_1	['REAC:R-HSA-1834941']	['XRCC6', 'MRE11']
560	GO:BP	GO:1904063	negative regulation of cation transmembrane transport	0.009260712679318	True	"""Any process that stops, prevents or reduces the frequency, rate or extent of cation transmembrane transport."" [GO_REF:0000058, GOC:TermGenie, PMID:15304482]"	88	97	4	17376	0.0412371134020618	0.0454545454545454	query_1	['GO:0034766', 'GO:0098655', 'GO:1904062']	['PPIF', 'SUMO1', 'VDAC1', 'ISCU']
561	GO:BP	GO:0031327	negative regulation of cellular biosynthetic process	0.0097080747413957	True	"""Any process that stops, prevents, or reduces the frequency, rate or extent of the chemical reactions and pathways resulting in the formation of substances, carried out by individual cells."" [GOC:mah]"	1507	97	18	17376	0.1855670103092783	0.0119442601194426	query_1	['GO:0009890', 'GO:0031324', 'GO:0031326', 'GO:0044249']	['RBBP8', 'SNX6', 'UBE2I', 'ATF7IP', 'ZNF350', 'XRCC6', 'SETDB2', 'PHB2', 'SETDB1', 'SUMO1', 'FLYWCH1', 'PIAS1', 'HDAC6', 'CBX5', 'BRCA1', 'MBD1', 'TRIM28', 'PHB1']
562	GO:BP	GO:0071495	cellular response to endogenous stimulus	0.0098476150163274	True	"""Any process that results in a change in state or activity of a cell (in terms of movement, secretion, enzyme production, gene expression, etc.) as a result of a stimulus arising within the organism."" [GOC:mah]"	1384	97	17	17376	0.1752577319587628	0.0122832369942196	query_1	['GO:0009719']	['SNX6', 'PDK4', 'DDRGK1', 'UFL1', 'PHB2', 'METTL21C', 'BLM', 'RAD51', 'HDAC6', 'GPD1', 'BRCA1', 'STAT5A', 'PDK2', 'UBA5', 'PHB1', 'UFM1', 'STAT5B']
563	GO:BP	GO:0052646	alditol phosphate metabolic process	0.0100672803682908	True	"""The chemical reactions and pathways involving alditol phosphates, any phosphorylated polyhydric alcohol derived from the acyclic form of a monosaccharide by reduction of its aldehyde or keto group to an alcoholic group."" [PMID:30240188]"	11	97	2	17376	0.0206185567010309	0.1818181818181818	query_1	['GO:0006796', 'GO:0019637', 'GO:1901135']	['GPD1', 'ABHD6']
564	GO:BP	GO:0006734	NADH metabolic process	0.0100672803682908	True	"""The chemical reactions and pathways involving reduced nicotinamide adenine dinucleotide (NADH), a coenzyme present in most living cells and derived from the B vitamin nicotinic acid."" [GOC:jl, ISBN:0618254153]"	11	97	2	17376	0.0206185567010309	0.1818181818181818	query_1	['GO:0019674']	['GPD1', 'OGDH']
565	GO:BP	GO:0072711	cellular response to hydroxyurea	0.0100672803682908	True	"""Any process that results in a change in state or activity of a cell (in terms of movement, secretion, enzyme production, gene expression, etc.) as a result of a hydroxyurea stimulus."" [GOC:mah]"	11	97	2	17376	0.0206185567010309	0.1818181818181818	query_1	['GO:0071241', 'GO:0072710', 'GO:1901699']	['BLM', 'RAD51']
566	GO:BP	GO:0042221	response to chemical	0.0100672803682908	True	"""Any process that results in a change in state or activity of a cell or an organism (in terms of movement, secretion, enzyme production, gene expression, etc.) as a result of a chemical stimulus."" [GOC:jl]"	3610	97	33	17376	0.3402061855670103	0.0091412742382271	query_1	['GO:0050896']	['PPIF', 'SNX6', 'PDK4', 'ADSL', 'CDK5RAP3', 'OTC', 'HSPA9', 'UBAC2', 'DDRGK1', 'UFL1', 'PHB2', 'METTL21C', 'SDHD', 'MCU', 'SETDB1', 'BCKDHB', 'SUMO1', 'HSPD1', 'PDK3', 'BLM', 'RAD51', 'HDAC6', 'GPD1', 'PDK1', 'FAF2', 'BRCA1', 'MICU1', 'STAT5A', 'PDK2', 'UBA5', 'PHB1', 'UFM1', 'STAT5B']
567	GO:BP	GO:0044786	cell cycle DNA replication	0.0101117967370126	True	"""The DNA-dependent DNA replication that takes place as part of the cell cycle."" [GOC:mtg_cell_cycle]"	42	97	3	17376	0.0309278350515463	0.0714285714285714	query_1	['GO:0006261', 'GO:0022402']	['BRCA2', 'BLM', 'RAD51']
568	GO:BP	GO:0030003	intracellular monoatomic cation homeostasis	0.010159934039175	True	"""A homeostatic process involved in the maintenance of a steady state level of monoatomic cations within a cell. Monatomic cations (also called simple cations) are cations consisting of exactly one atom."" [GOC:ceb, GOC:mah]"	490	97	9	17376	0.0927835051546391	0.0183673469387755	query_1	['GO:0006873', 'GO:0055080']	['MAIP1', 'MCUB', 'METTL21C', 'MCU', 'AFG3L2', 'ISCU', 'MICU1', 'SMDT1', 'MICU2']
569	GO:CC	GO:0043232	intracellular non-membrane-bounded organelle	0.0102909518521304	True	"""Organized structure of distinctive morphology and function, not bounded by a lipid bilayer membrane and occurring within the cell. Includes ribosomes, the cytoskeleton and chromosomes."" [GOC:go_curators]"	5008	97	41	17376	0.422680412371134	0.0081869009584664	query_1	['GO:0043228', 'GO:0043229']	['RBBP8', 'UBE2I', 'CDK5RAP3', 'NBN', 'HSPA9', 'TP53BP1', 'RAD50', 'XRCC6', 'PAXIP1', 'PDHA2', 'SETDB2', 'H2AX', 'DDRGK1', 'UFL1', 'MDC1', 'PHB2', 'DBT', 'BRCA2', 'SETDB1', 'BCKDHB', 'PDHA1', 'SUMO1', 'RPA1', 'PDK3', 'ARL14EP', 'FLYWCH1', 'BLM', 'MRE11', 'VDAC1', 'RAD51', 'HDAC6', 'FAF2', 'CBX5', 'NDUFAB1', 'BRCA1', 'SDHA', 'STAT5A', 'MBD1', 'TRIM28', 'BARD1', 'STAT5B']
570	GO:CC	GO:0043228	non-membrane-bounded organelle	0.0102909518521304	True	"""Organized structure of distinctive morphology and function, not bounded by a lipid bilayer membrane. Includes ribosomes, the cytoskeleton and chromosomes."" [GOC:go_curators]"	5009	97	41	17376	0.422680412371134	0.0081852665202635	query_1	['GO:0043226']	['RBBP8', 'UBE2I', 'CDK5RAP3', 'NBN', 'HSPA9', 'TP53BP1', 'RAD50', 'XRCC6', 'PAXIP1', 'PDHA2', 'SETDB2', 'H2AX', 'DDRGK1', 'UFL1', 'MDC1', 'PHB2', 'DBT', 'BRCA2', 'SETDB1', 'BCKDHB', 'PDHA1', 'SUMO1', 'RPA1', 'PDK3', 'ARL14EP', 'FLYWCH1', 'BLM', 'MRE11', 'VDAC1', 'RAD51', 'HDAC6', 'FAF2', 'CBX5', 'NDUFAB1', 'BRCA1', 'SDHA', 'STAT5A', 'MBD1', 'TRIM28', 'BARD1', 'STAT5B']
571	REAC	REAC:R-HSA-1170546	Prolactin receptor signaling	0.0104896079266256	True	Prolactin receptor signaling	14	97	2	17376	0.0206185567010309	0.1428571428571428	query_1	['REAC:R-HSA-1280215']	['STAT5A', 'STAT5B']
572	REAC	REAC:R-HSA-8983432	Interleukin-15 signaling	0.0104896079266256	True	Interleukin-15 signaling	14	97	2	17376	0.0206185567010309	0.1428571428571428	query_1	['REAC:R-HSA-451927']	['STAT5A', 'STAT5B']
573	GO:BP	GO:2000378	negative regulation of reactive oxygen species metabolic process	0.0107709478829925	True	"""Any process that stops, prevents or reduces the frequency, rate or extent of reactive oxygen species metabolic process."" [GOC:mah]"	43	97	3	17376	0.0309278350515463	0.0697674418604651	query_1	['GO:0031324', 'GO:0072593', 'GO:2000377']	['VDAC1', 'HDAC6', 'BRCA1']
574	GO:BP	GO:0071310	cellular response to organic substance	0.0107846510273488	True	"""Any process that results in a change in state or activity of a cell (in terms of movement, secretion, enzyme production, gene expression, etc.) as a result of an organic substance stimulus."" [GOC:mah]"	1915	97	21	17376	0.2164948453608247	0.0109660574412532	query_1	['GO:0010033', 'GO:0070887']	['SNX6', 'PDK4', 'CDK5RAP3', 'HSPA9', 'DDRGK1', 'UFL1', 'PHB2', 'METTL21C', 'HSPD1', 'PDK3', 'BLM', 'RAD51', 'HDAC6', 'GPD1', 'BRCA1', 'STAT5A', 'PDK2', 'UBA5', 'PHB1', 'UFM1', 'STAT5B']
575	GO:BP	GO:0007584	response to nutrient	0.0109882758124342	True	"""Any process that results in a change in state or activity of a cell or an organism (in terms of movement, secretion, enzyme production, gene expression, etc.) as a result of a nutrient stimulus."" [GOC:go_curators]"	156	97	5	17376	0.0515463917525773	0.032051282051282	query_1	['GO:0031667', 'GO:0042221']	['ADSL', 'OTC', 'SETDB1', 'BCKDHB', 'PDK2']
576	GO:BP	GO:0062012	regulation of small molecule metabolic process	0.0109882758124342	True	"""Any process that modulates the rate, frequency or extent of a small molecule metabolic process."" [GOC:vw]"	312	97	7	17376	0.0721649484536082	0.0224358974358974	query_1	['GO:0019222', 'GO:0044281']	['PDK4', 'BCKDK', 'PDK3', 'GPD1', 'PDK1', 'BRCA1', 'PDK2']
577	GO:CC	GO:0001673	male germ cell nucleus	0.0110718569269955	True	"""The nucleus of a male germ cell, a reproductive cell in males."" [CL:0000015, GOC:hjd, GOC:mtg_sensu]"	54	97	3	17376	0.0309278350515463	0.0555555555555555	query_1	['GO:0043073']	['H2AX', 'RAD51', 'BRCA1']
578	GO:BP	GO:0006873	intracellular monoatomic ion homeostasis	0.0113352820842012	True	"""A homeostatic process involved in the maintenance of a steady state level of monoatomic ions within a cell. Monatomic ions (also called simple ions) are ions consisting of exactly one atom."" [GOC:mah]"	499	97	9	17376	0.0927835051546391	0.0180360721442885	query_1	['GO:0050801', 'GO:0055082']	['MAIP1', 'MCUB', 'METTL21C', 'MCU', 'AFG3L2', 'ISCU', 'MICU1', 'SMDT1', 'MICU2']
579	GO:BP	GO:0031647	regulation of protein stability	0.0113352820842012	True	"""Any process that affects the structure and integrity of a protein, altering the likelihood of its degradation or aggregation."" [GOC:dph, GOC:mah, GOC:tb]"	314	97	7	17376	0.0721649484536082	0.0222929936305732	query_1	['GO:0065008']	['ATF7IP', 'DDRGK1', 'PHB2', 'SUMO1', 'HSPD1', 'HDAC6', 'PHB1']
580	GO:BP	GO:0031952	regulation of protein autophosphorylation	0.0113381603939134	True	"""Any process that modulates the frequency, rate or extent of addition of the phosphorylation by a protein of one or more of its own residues."" [GOC:mah]"	44	97	3	17376	0.0309278350515463	0.0681818181818181	query_1	['GO:0001932', 'GO:0046777']	['NBN', 'RAD50', 'MRE11']
581	REAC	REAC:R-HSA-4655427	SUMOylation of DNA methylation proteins	0.0116865198456038	True	SUMOylation of DNA methylation proteins	15	97	2	17376	0.0206185567010309	0.1333333333333333	query_1	['REAC:R-HSA-3108232']	['UBE2I', 'SUMO1']
582	REAC	REAC:R-HSA-1834941	STING mediated induction of host immune responses	0.0116865198456038	True	STING mediated induction of host immune responses	15	97	2	17376	0.0206185567010309	0.1333333333333333	query_1	['REAC:R-HSA-1834949']	['XRCC6', 'MRE11']
583	REAC	REAC:R-HSA-9703648	Signaling by FLT3 ITD and TKD mutants	0.0116865198456038	True	Signaling by FLT3 ITD and TKD mutants	15	97	2	17376	0.0206185567010309	0.1333333333333333	query_1	['REAC:R-HSA-9682385']	['STAT5A', 'STAT5B']
584	GO:BP	GO:0072710	response to hydroxyurea	0.0117324571731786	True	"""Any process that results in a change in state or activity of a cell or an organism (in terms of movement, secretion, enzyme production, gene expression, etc.) as a result of a hydroxyurea stimulus."" [GOC:mah]"	12	97	2	17376	0.0206185567010309	0.1666666666666666	query_1	['GO:0010033', 'GO:1901698']	['BLM', 'RAD51']
585	REAC	REAC:R-HSA-5696398	Nucleotide Excision Repair	0.0121537157876579	True	Nucleotide Excision Repair	109	97	4	17376	0.0412371134020618	0.036697247706422	query_1	['REAC:R-HSA-73894']	['UBE2I', 'SUMO1', 'RPA1', 'PIAS1']
586	GO:BP	GO:0034766	negative regulation of monoatomic ion transmembrane transport	0.0122079968158007	True	"""Any process that stops, prevents, or reduces the frequency, rate or extent of the directed movement of ions from one side of a membrane to the other."" [GOC:mah]"	96	97	4	17376	0.0412371134020618	0.0416666666666666	query_1	['GO:0034220', 'GO:0034763', 'GO:0034765', 'GO:0043271']	['PPIF', 'SUMO1', 'VDAC1', 'ISCU']
587	GO:BP	GO:0051604	protein maturation	0.0124862682920271	True	"""Any process leading to the attainment of the full functional capacity of a protein."" [GOC:ai]"	320	97	7	17376	0.0721649484536082	0.021875	query_1	['GO:0010467', 'GO:0019538']	['GCSH', 'SPG7', 'PMPCA', 'HSPD1', 'AFG3L2', 'NDUFAB1', 'PMPCB']
588	GO:BP	GO:0010605	negative regulation of macromolecule metabolic process	0.0129014639452447	True	"""Any process that decreases the frequency, rate or extent of the chemical reactions and pathways involving macromolecules, any molecule of high relative molecular mass, the structure of which essentially comprises the multiple repetition of units derived, actually or conceptually, from molecules of low relative molecular mass."" [GOC:dph, GOC:tb]"	2639	97	26	17376	0.268041237113402	0.0098522167487684	query_1	['GO:0009892', 'GO:0043170', 'GO:0060255']	['RBBP8', 'SNX6', 'UBE2I', 'CDK5RAP3', 'NBN', 'ATF7IP', 'TP53BP1', 'RAD50', 'ZNF350', 'XRCC6', 'SETDB2', 'DDRGK1', 'UFL1', 'PHB2', 'SETDB1', 'SUMO1', 'FLYWCH1', 'BLM', 'PIAS1', 'HDAC6', 'CBX5', 'BRCA1', 'MBD1', 'TRIM28', 'BARD1', 'PHB1']
589	GO:BP	GO:0009890	negative regulation of biosynthetic process	0.0129170211110555	True	"""Any process that stops, prevents, or reduces the rate of the chemical reactions and pathways resulting in the formation of substances."" [GOC:go_curators]"	1553	97	18	17376	0.1855670103092783	0.0115904700579523	query_1	['GO:0009058', 'GO:0009889', 'GO:0009892']	['RBBP8', 'SNX6', 'UBE2I', 'ATF7IP', 'ZNF350', 'XRCC6', 'SETDB2', 'PHB2', 'SETDB1', 'SUMO1', 'FLYWCH1', 'PIAS1', 'HDAC6', 'CBX5', 'BRCA1', 'MBD1', 'TRIM28', 'PHB1']
590	REAC	REAC:R-HSA-1839117	Signaling by cytosolic FGFR1 fusion mutants	0.0130387594409272	True	Signaling by cytosolic FGFR1 fusion mutants	16	97	2	17376	0.0206185567010309	0.125	query_1	['REAC:R-HSA-1839124']	['STAT5A', 'STAT5B']
591	GO:BP	GO:0030001	metal ion transport	0.0135269269753478	True	"""The directed movement of metal ions, any metal ion with an electric charge, into, out of or within a cell, or between cells, by means of some agent such as a transporter or pore."" [GOC:ai]"	833	97	12	17376	0.1237113402061855	0.0144057623049219	query_1	['GO:0006812']	['MAIP1', 'MCUB', 'METTL21C', 'MCU', 'SUMO1', 'VDAC1', 'AFG3L2', 'ISCU', 'MICU1', 'SMDT1', 'MICU2', 'PMPCB']
592	GO:BP	GO:0033147	negative regulation of intracellular estrogen receptor signaling pathway	0.0135759232796408	True	"""Any process that stops, prevents, or reduces the frequency, rate or extent of the activity of an intracellular estrogen receptor signaling pathway."" [GOC:mah]"	13	97	2	17376	0.0206185567010309	0.1538461538461538	query_1	['GO:0030520', 'GO:0033144', 'GO:0033146']	['PHB2', 'BRCA1']
593	GO:BP	GO:0071481	cellular response to X-ray	0.0135759232796408	True	"""Any process that results in a change in state or activity of a cell (in terms of movement, secretion, enzyme production, gene expression, etc.) as a result of X-ray radiation. An X-ray is a form of electromagnetic radiation with a wavelength in the range of 10 nanometers to 100 picometers (corresponding to frequencies in the range 30 PHz to 3 EHz)."" [GOC:mah]"	13	97	2	17376	0.0206185567010309	0.1538461538461538	query_1	['GO:0010165', 'GO:0071479']	['TP53BP1', 'XRCC6']
594	GO:BP	GO:0051169	nuclear transport	0.0136197651259851	True	"""The directed movement of substances into, out of, or within the nucleus."" [GOC:ai]"	326	97	7	17376	0.0721649484536082	0.0214723926380368	query_1	['GO:0046907']	['UBE2I', 'HSPA9', 'PHB2', 'SUMO1', 'TRIM28', 'BARD1', 'UFM1']
595	GO:BP	GO:0006913	nucleocytoplasmic transport	0.0136197651259851	True	"""The directed movement of molecules between the nucleus and the cytoplasm."" [GOC:go_curators]"	326	97	7	17376	0.0721649484536082	0.0214723926380368	query_1	['GO:0051169']	['UBE2I', 'HSPA9', 'PHB2', 'SUMO1', 'TRIM28', 'BARD1', 'UFM1']
596	GO:BP	GO:0031399	regulation of protein modification process	0.0138240122597785	True	"""Any process that modulates the frequency, rate or extent of the covalent alteration of one or more amino acid residues within a protein."" [GOC:mah, GOC:tb]"	1437	97	17	17376	0.1752577319587628	0.0118302018093249	query_1	['GO:0036211', 'GO:0051246']	['SNX6', 'UBE2I', 'CDK5RAP3', 'NBN', 'RAD50', 'XRCC6', 'PAXIP1', 'DDRGK1', 'UFL1', 'PHB2', 'BLM', 'PIAS1', 'MRE11', 'RAD51', 'HDAC6', 'BRCA1', 'PHB1']
597	GO:BP	GO:0048878	chemical homeostasis	0.0140777053448845	True	"""Any biological process involved in the maintenance of an internal steady state of a chemical."" [GOC:isa_complete]"	953	97	13	17376	0.134020618556701	0.0136411332633788	query_1	['GO:0042592']	['PDK4', 'MAIP1', 'OTC', 'MCUB', 'METTL21C', 'MCU', 'PDK3', 'AFG3L2', 'ISCU', 'MICU1', 'SMDT1', 'PDK2', 'MICU2']
598	REAC	REAC:R-HSA-9670439	Signaling by phosphorylated juxtamembrane, extracellular and kinase domain KIT mutants	0.0142906574833223	True	Signaling by phosphorylated juxtamembrane, extracellular and kinase domain KIT mutants	17	97	2	17376	0.0206185567010309	0.1176470588235294	query_1	['REAC:R-HSA-9669938']	['STAT5A', 'STAT5B']
599	REAC	REAC:R-HSA-9703465	Signaling by FLT3 fusion proteins	0.0142906574833223	True	Signaling by FLT3 fusion proteins	17	97	2	17376	0.0206185567010309	0.1176470588235294	query_1	['REAC:R-HSA-9682385']	['STAT5A', 'STAT5B']
600	REAC	REAC:R-HSA-9669938	Signaling by KIT in disease	0.0142906574833223	True	Signaling by KIT in disease	17	97	2	17376	0.0206185567010309	0.1176470588235294	query_1	['REAC:R-HSA-5663202']	['STAT5A', 'STAT5B']
601	GO:BP	GO:0016310	phosphorylation	0.0143533261618748	True	"""The process of introducing a phosphate group into a molecule, usually with the formation of a phosphoric ester, a phosphoric anhydride or a phosphoric amide."" [ISBN:0198506732]"	1701	97	19	17376	0.1958762886597938	0.0111699000587889	query_1	['GO:0006796']	['SNX6', 'PDK4', 'CDK5RAP3', 'NBN', 'RAD50', 'XRCC6', 'DDRGK1', 'PHB2', 'BCKDK', 'PDK3', 'BLM', 'MRE11', 'RAD51', 'HDAC6', 'PDK1', 'PDK2', 'TRIM28', 'BARD1', 'PHB1']
602	GO:BP	GO:0002262	myeloid cell homeostasis	0.0145116100051309	True	"""The process of regulating the proliferation and elimination of myeloid cells such that the total number of myeloid cells within a whole or part of an organism is stable over time in the absence of an outside stimulus."" [CL:0000763, GOC:add]"	168	97	5	17376	0.0515463917525773	0.0297619047619047	query_1	['GO:0002376', 'GO:0048872']	['CDK5RAP3', 'HSPA9', 'UFL1', 'UBA5', 'STAT5B']
603	GO:BP	GO:0043543	protein acylation	0.0147812998968732	True	"""The addition of an acyl group, any group or radical of the form RCO- where R is an organic group, to a protein amino acid."" [GOC:jl]"	246	97	6	17376	0.0618556701030927	0.024390243902439	query_1	['GO:0036211']	['DLST', 'BRCA2', 'HDAC6', 'BRCA1', 'DLD', 'OGDH']
604	GO:BP	GO:0043433	negative regulation of DNA-binding transcription factor activity	0.015199326420566	True	"""Any process that stops, prevents, or reduces the frequency, rate or extent of the activity of a transcription factor, any factor involved in the initiation or regulation of transcription."" [GOC:jl]"	170	97	5	17376	0.0515463917525773	0.0294117647058823	query_1	['GO:0044092', 'GO:0051090']	['CDK5RAP3', 'PAXIP1', 'UFL1', 'PHB2', 'SUMO1']
605	GO:BP	GO:0034968	histone lysine methylation	0.0152005080380892	True	"""The modification of a histone by addition of one or more methyl groups to a lysine residue."" [GOC:mah, GOC:pr]"	103	97	4	17376	0.0412371134020618	0.0388349514563106	query_1	['GO:0016571', 'GO:0018022']	['PAXIP1', 'SETDB2', 'SETDB1', 'BRCA1']
606	GO:BP	GO:0002699	positive regulation of immune effector process	0.0152761667251697	True	"""Any process that activates or increases the frequency, rate, or extent of an immune effector process."" [GOC:add]"	248	97	6	17376	0.0618556701030927	0.0241935483870967	query_1	['GO:0002252', 'GO:0002684', 'GO:0002697']	['TP53BP1', 'PAXIP1', 'PHB2', 'HSPD1', 'PHB1', 'STAT5B']
607	GO:BP	GO:1904925	positive regulation of autophagy of mitochondrion in response to mitochondrial depolarization	0.0152891284138615	True	"""Any process that activates or increases the frequency, rate or extent of autophagy of the mitochondrion in response to mitochondrial depolarization."" [GO_REF:0000058, GOC:pad, GOC:PARL, GOC:TermGenie, PMID:22020285]"	14	97	2	17376	0.0206185567010309	0.1428571428571428	query_1	['GO:0000422', 'GO:1904923']	['VDAC1', 'HDAC6']
608	GO:BP	GO:1902969	mitotic DNA replication	0.0152891284138615	True	"""Any nuclear DNA replication that is involved in a mitotic cell cycle."" [GO_REF:0000060, GOC:TermGenie]"	14	97	2	17376	0.0206185567010309	0.1428571428571428	query_1	['GO:0033260', 'GO:1903047']	['BRCA2', 'RAD51']
609	GO:BP	GO:0045869	negative regulation of single stranded viral RNA replication via double stranded DNA intermediate	0.0152891284138615	True	"""Any process that stops, prevents, or reduces the frequency, rate or extent of single stranded viral RNA replication via double stranded DNA intermediate."" [GOC:go_curators]"	14	97	2	17376	0.0206185567010309	0.1428571428571428	query_1	['GO:0039692', 'GO:0045071', 'GO:0045091', 'GO:1902679']	['SETDB1', 'TRIM28']
610	GO:BP	GO:1903320	regulation of protein modification by small protein conjugation or removal	0.0154348977713923	True	"""Any process that modulates the frequency, rate or extent of protein modification by small protein conjugation or removal."" [GO_REF:0000058, GOC:TermGenie, GOC:vw]"	249	97	6	17376	0.0618556701030927	0.0240963855421686	query_1	['GO:0031399', 'GO:0070647']	['UBE2I', 'CDK5RAP3', 'PAXIP1', 'UFL1', 'PIAS1', 'BRCA1']
611	GO:BP	GO:1903894	regulation of IRE1-mediated unfolded protein response	0.0172059640057113	True	"""Any process that modulates the frequency, rate or extent of the IRE1-mediated unfolded protein response."" [GO_REF:0000058, GOC:bf, GOC:PARL, GOC:TermGenie, PMID:22013210]"	15	97	2	17376	0.0206185567010309	0.1333333333333333	query_1	['GO:0036498', 'GO:1900101']	['DDRGK1', 'UFL1']
612	GO:BP	GO:0090656	t-circle formation	0.0172059640057113	True	"""A telomere maintenance process that results in the formation of a telomeric circle, or t-circle. A t-circle is an extrachromosomal duplex or single-stranded circular DNA molecule composed of t-arrays. T-circles are involved in the control of telomere length via alternative-lengthening of telomeres (ALT) pathway and telomere rapid deletion (TRD)."" [GOC:BHF, GOC:BHF_telomere, GOC:nc, PMID:19214183, PMID:19581589, PMID:19809492, PMID:19858100]"	15	97	2	17376	0.0206185567010309	0.1333333333333333	query_1	['GO:0001325', 'GO:0090737']	['NBN', 'BLM']
613	GO:BP	GO:0072331	signal transduction by p53 class mediator	0.0172059640057113	True	"""An intracellular signaling process that is induced by the cell cycle regulator phosphoprotein p53 or an equivalent protein."" [GOC:mah]"	176	97	5	17376	0.0515463917525773	0.0284090909090909	query_1	['GO:0035556']	['CDK5RAP3', 'NBN', 'PAXIP1', 'BRCA2', 'PDK2']
614	GO:BP	GO:0001325	formation of extrachromosomal circular DNA	0.0172059640057113	True	"""Excision from the chromosome and circularization of a region of chromosomal DNA, generally, but not always, via homologous recombination between direct tandem repeats."" [GOC:jh, PMID:12044938]"	15	97	2	17376	0.0206185567010309	0.1333333333333333	query_1	['GO:0006259', 'GO:0022607']	['NBN', 'BLM']
615	GO:BP	GO:0048291	isotype switching to IgG isotypes	0.0172059640057113	True	"""The switching of activated B cells from IgM biosynthesis to biosynthesis of an IgG isotype, accomplished through a recombination process involving an intrachromosomal deletion between switch regions that reside 5' of the IgM and one of the IgG constant region gene segments in the immunoglobulin heavy chain locus."" [ISBN:0781735149, PMID:12370374, PMID:2113175, PMID:9186655]"	15	97	2	17376	0.0206185567010309	0.1333333333333333	query_1	['GO:0045190']	['PAXIP1', 'HSPD1']
616	GO:BP	GO:0042308	negative regulation of protein import into nucleus	0.0172059640057113	True	"""Any process that stops, prevents, or reduces the frequency, rate or extent of the movement of proteins from the cytoplasm into the nucleus."" [GOC:jl]"	15	97	2	17376	0.0206185567010309	0.1333333333333333	query_1	['GO:0006606', 'GO:0042306', 'GO:0046823', 'GO:0090317', 'GO:1900181']	['SUMO1', 'UFM1']
617	GO:BP	GO:0090737	telomere maintenance via telomere trimming	0.0172059640057113	True	"""A process that contributes to the maintenance of proper telomeric length and structure via the activation of telomere shortening pathways that compensate telomerase-dependent excessive telomere elongation. Telomere attrition is mediated by a mechanism which involves the generation of single-stranded C-rich telomeric DNA, and the formation and removal of double-stranded telomeric circular DNA (T-circles). Telomere trimming is an independent pathway to recombination-mediated telomere elongation and the well-documented gradual telomere attrition that accompanies cellular replication."" [GOC:BHF, GOC:BHF_telomere, GOC:nc, PMID:27918544]"	15	97	2	17376	0.0206185567010309	0.1333333333333333	query_1	['GO:0000723']	['NBN', 'BLM']
618	GO:BP	GO:1904923	regulation of autophagy of mitochondrion in response to mitochondrial depolarization	0.0172059640057113	True	"""Any process that modulates the frequency, rate or extent of autophagy of mitochondrion in response to mitochondrial depolarization."" [GO_REF:0000058, GOC:pad, GOC:PARL, GOC:TermGenie, PMID:22020285]"	15	97	2	17376	0.0206185567010309	0.1333333333333333	query_1	['GO:0000422', 'GO:0098780']	['VDAC1', 'HDAC6']
619	REAC	REAC:R-HSA-174414	Processive synthesis on the C-strand of the telomere	0.0176652938920938	True	Processive synthesis on the C-strand of the telomere	19	97	2	17376	0.0206185567010309	0.1052631578947368	query_1	['REAC:R-HSA-174417']	['RPA1', 'BLM']
620	GO:BP	GO:0006479	protein methylation	0.017830623560995	True	"""The addition of a methyl group to a protein amino acid. A methyl group is derived from methane by the removal of a hydrogen atom."" [GOC:ai]"	178	97	5	17376	0.0515463917525773	0.0280898876404494	query_1	['GO:0008213', 'GO:0043414']	['PAXIP1', 'SETDB2', 'METTL21C', 'SETDB1', 'BRCA1']
621	GO:BP	GO:0008213	protein alkylation	0.017830623560995	True	"""The addition of an alkyl group to a protein amino acid. Alkyl groups are derived from alkanes by removal of one hydrogen atom."" [GOC:ma]"	178	97	5	17376	0.0515463917525773	0.0280898876404494	query_1	['GO:0036211']	['PAXIP1', 'SETDB2', 'METTL21C', 'SETDB1', 'BRCA1']
622	GO:CC	GO:0033593	BRCA2-MAGE-D1 complex	0.017960805508846	True	"""A heterodimeric protein complex formed of BRCA2 and MAGE-D1; may mediate the synergistic activities of the two proteins in regulating cell growth."" [PMID:15930293]"	1	97	1	17376	0.0103092783505154	1.0	query_1	['GO:0140535']	['BRCA2']
623	GO:BP	GO:0046822	regulation of nucleocytoplasmic transport	0.0185506989928065	True	"""Any process that modulates the frequency, rate or extent of the directed movement of substances between the nucleus and the cytoplasm."" [GOC:bf]"	110	97	4	17376	0.0412371134020618	0.0363636363636363	query_1	['GO:0006913', 'GO:0032386']	['SUMO1', 'TRIM28', 'BARD1', 'UFM1']
624	GO:BP	GO:0140527	reciprocal homologous recombination	0.0187409073837258	True	"""A DNA recombination process that results in the bidirectional exchange of genetic material between highly homologous DNA molecules."" [PMID:17846636]"	54	97	3	17376	0.0309278350515463	0.0555555555555555	query_1	['GO:0035825']	['RAD50', 'MRE11', 'RAD51']
625	GO:BP	GO:0007131	reciprocal meiotic recombination	0.0187409073837258	True	"""The cell cycle process in which double strand breaks are formed and repaired through a single or double Holliday junction intermediate. This results in the equal exchange of genetic material between non-sister chromatids in a pair of homologous chromosomes. These reciprocal recombinant products ensure the proper segregation of homologous chromosomes during meiosis I and create genetic diversity."" [PMID:2087779]"	54	97	3	17376	0.0309278350515463	0.0555555555555555	query_1	['GO:0007127', 'GO:0140527', 'GO:1903046']	['RAD50', 'MRE11', 'RAD51']
626	GO:BP	GO:0006266	DNA ligation	0.0192315111891077	True	"""The re-formation of a broken phosphodiester bond in the DNA backbone, carried out by DNA ligase."" [ISBN:0815316194]"	16	97	2	17376	0.0206185567010309	0.125	query_1	['GO:0006259']	['XRCC6', 'RAD51']
627	GO:BP	GO:1900102	negative regulation of endoplasmic reticulum unfolded protein response	0.0192315111891077	True	"""Any process that stops, prevents or reduces the frequency, rate or extent of endoplasmic reticulum unfolded protein response."" [GOC:TermGenie]"	16	97	2	17376	0.0206185567010309	0.125	query_1	['GO:0009968', 'GO:0030968', 'GO:1900101', 'GO:1903573']	['DDRGK1', 'UFL1']
628	GO:BP	GO:0023035	CD40 signaling pathway	0.0192315111891077	True	"""The series of molecular signals initiated by the binding of the cell surface receptor CD40 to one of its physiological ligands, and ending with the regulation of a downstream cellular process, e.g. transcription."" [GOC:mtg_signal, GOC:signaling, PMID:11348017]"	16	97	2	17376	0.0206185567010309	0.125	query_1	['GO:0007166']	['PHB2', 'PHB1']
629	GO:CC	GO:0030904	retromer complex	0.0192386749776535	True	"""A conserved hetero-pentameric membrane-associated complex involved in retrograde transport from endosomes to the Golgi apparatus. The budding yeast retromer comprises Vps35p, Vps29p, Vps26p, Vps5p, and Vps17p. The mammalian complex shows slight variation in composition compared to yeast, and comprises SNX1 or SNX2, SNX5 or SNX6, VPS26A or VPS26B, VPS29, and VPS35."" [GOC:bf, PMID:26220253, PMID:27385586, PMID:9700157]"	21	97	2	17376	0.0206185567010309	0.0952380952380952	query_1	['GO:0012505', 'GO:0098796']	['SNX6', 'SNX1']
630	REAC	REAC:R-HSA-6791462	TALDO1 deficiency: failed conversion of  Fru(6)P, E4P to SH7P, GA3P	0.0193277867542286	True	TALDO1 deficiency: failed conversion of  Fru(6)P, E4P to SH7P, GA3P	1	97	1	17376	0.0103092783505154	1.0	query_1	['REAC:R-HSA-6791465']	['TALDO1']
631	REAC	REAC:R-HSA-9694301	Maturation of replicase proteins	0.0193277867542286	True	Maturation of replicase proteins	1	97	1	17376	0.0103092783505154	1.0	query_1	['REAC:R-HSA-9694676']	['ISCU']
632	REAC	REAC:R-HSA-6791055	TALDO1 deficiency: failed conversion of SH7P, GA3P to Fru(6)P, E4P	0.0193277867542286	True	TALDO1 deficiency: failed conversion of SH7P, GA3P to Fru(6)P, E4P	1	97	1	17376	0.0103092783505154	1.0	query_1	['REAC:R-HSA-6791465']	['TALDO1']
633	GO:BP	GO:0019725	cellular homeostasis	0.0193827870947173	True	"""Any process involved in the maintenance of an internal steady state at the level of the cell."" [GOC:isa_complete, GOC:jl, ISBN:0395825172]"	765	97	11	17376	0.1134020618556701	0.0143790849673202	query_1	['GO:0042592']	['MAIP1', 'MCUB', 'METTL21C', 'MCU', 'PDK3', 'AFG3L2', 'ISCU', 'MICU1', 'SMDT1', 'DLD', 'MICU2']
634	GO:BP	GO:0090304	nucleic acid metabolic process	0.0197103765415146	True	"""Any cellular metabolic process involving nucleic acids."" [GOC:dph, GOC:tb]"	4724	97	39	17376	0.4020618556701031	0.0082557154953429	query_1	['GO:0006139', 'GO:0043170']	['RBBP8', 'SNX6', 'UBE2I', 'CDK5RAP3', 'NBN', 'ATF7IP', 'TP53BP1', 'RAD50', 'ZNF45', 'ZNF350', 'XRCC6', 'PAXIP1', 'SETDB2', 'H2AX', 'DDRGK1', 'UFL1', 'MDC1', 'PHB2', 'BRCA2', 'SETDB1', 'SUMO1', 'HSPD1', 'RPA1', 'FLYWCH1', 'BLM', 'PIAS1', 'MRE11', 'RAD51', 'HDAC6', 'MOCS3', 'NSUN6', 'CBX5', 'BRCA1', 'STAT5A', 'MBD1', 'TRIM28', 'BARD1', 'PHB1', 'STAT5B']
635	GO:BP	GO:0045184	establishment of protein localization	0.020533477253854	True	"""The directed movement of a protein to a specific location."" [GOC:bf]"	1634	97	18	17376	0.1855670103092783	0.011015911872705	query_1	['GO:0008104', 'GO:0051234']	['SNX6', 'SNX1', 'MAIP1', 'HSPA9', 'UBAC2', 'PMPCA', 'PHB2', 'BRCA2', 'MCU', 'SIL1', 'SUMO1', 'HSPD1', 'HDAC6', 'FAF2', 'TRIM28', 'BARD1', 'PMPCB', 'UFM1']
636	GO:BP	GO:0002708	positive regulation of lymphocyte mediated immunity	0.020649028065229	True	"""Any process that activates or increases the frequency, rate, or extent of lymphocyte mediated immunity."" [GOC:add]"	114	97	4	17376	0.0412371134020618	0.0350877192982456	query_1	['GO:0002449', 'GO:0002705', 'GO:0002706']	['TP53BP1', 'PAXIP1', 'HSPD1', 'STAT5B']
637	GO:BP	GO:0006103	2-oxoglutarate metabolic process	0.0212755271600509	True	"""The chemical reactions and pathways involving oxoglutarate, the dianion of 2-oxoglutaric acid. It is a key constituent of the TCA cycle and a key intermediate in amino-acid metabolism."" [ISBN:0198506732]"	17	97	2	17376	0.0206185567010309	0.1176470588235294	query_1	['GO:0043648']	['DLST', 'OGDH']
638	GO:BP	GO:0033599	regulation of mammary gland epithelial cell proliferation	0.0212755271600509	True	"""Any process that modulates the frequency, rate or extent of mammary gland epithelial cell proliferation."" [GOC:mah]"	17	97	2	17376	0.0206185567010309	0.1176470588235294	query_1	['GO:0033598', 'GO:0050678']	['PHB2', 'BRCA2']
639	GO:BP	GO:0045091	regulation of single stranded viral RNA replication via double stranded DNA intermediate	0.0212755271600509	True	"""Any process that modulates the frequency, rate or extent of single stranded viral RNA replication via double stranded DNA intermediate."" [GOC:go_curators]"	17	97	2	17376	0.0206185567010309	0.1176470588235294	query_1	['GO:0039692', 'GO:0045069', 'GO:2001141']	['SETDB1', 'TRIM28']
640	GO:BP	GO:0055082	intracellular chemical homeostasis	0.0212755271600509	True	"""A homeostatic process involved in the maintenance of a steady state level of a chemical within a cell."" [GOC:isa_complete, GOC:jid]"	665	97	10	17376	0.1030927835051546	0.0150375939849624	query_1	['GO:0019725', 'GO:0048878']	['MAIP1', 'MCUB', 'METTL21C', 'MCU', 'PDK3', 'AFG3L2', 'ISCU', 'MICU1', 'SMDT1', 'MICU2']
641	GO:BP	GO:0031573	mitotic intra-S DNA damage checkpoint signaling	0.0212755271600509	True	"""A mitotic cell cycle checkpoint that slows DNA synthesis in response to DNA damage by the prevention of new origin firing and the stabilization of slow replication fork progression."" [GOC:vw]"	17	97	2	17376	0.0206185567010309	0.1176470588235294	query_1	['GO:0044773']	['MDC1', 'MRE11']
642	GO:BP	GO:0080090	regulation of primary metabolic process	0.0213177068340751	True	"""Any process that modulates the frequency, rate or extent of the chemical reactions and pathways within a cell or an organism involving those compounds formed as a part of the normal anabolic and catabolic processes. These processes take place in most, if not all, cells of the organism."" [PMID:19211694]"	5398	97	43	17376	0.4432989690721649	0.0079659133012226	query_1	['GO:0019222', 'GO:0044238']	['RBBP8', 'SNX6', 'UBE2I', 'PDK4', 'SNX1', 'CDK5RAP3', 'NBN', 'ATF7IP', 'TP53BP1', 'RAD50', 'ZNF45', 'ZNF350', 'XRCC6', 'PAXIP1', 'SETDB2', 'H2AX', 'DDRGK1', 'UFL1', 'PHB2', 'BRCA2', 'SETDB1', 'BCKDK', 'SUMO1', 'HSPD1', 'PDK3', 'FLYWCH1', 'BLM', 'PIAS1', 'MRE11', 'RAD51', 'HDAC6', 'GPD1', 'PDK1', 'CBX5', 'BRCA1', 'STAT5A', 'PDK2', 'MBD1', 'TRIM28', 'BARD1', 'ABHD6', 'PHB1', 'STAT5B']
643	GO:CC	GO:0043073	germ cell nucleus	0.021318924094653	True	"""The nucleus of a germ cell, a reproductive cell in multicellular organisms."" [CL:0000586, GOC:go_curators]"	69	97	3	17376	0.0309278350515463	0.0434782608695652	query_1	['GO:0005634']	['H2AX', 'RAD51', 'BRCA1']
644	GO:CC	GO:0098799	outer mitochondrial membrane protein complex	0.0225262858817408	True	"""Any protein complex that is part of the outer mitochondrial membrane."" [GOC:dos]"	23	97	2	17376	0.0206185567010309	0.0869565217391304	query_1	['GO:0005741', 'GO:0098796', 'GO:0098798']	['HSPA9', 'MFN1']
645	REAC	REAC:R-HSA-5205685	PINK1-PRKN Mediated Mitophagy	0.0227231200785088	True	PINK1-PRKN Mediated Mitophagy	22	97	2	17376	0.0206185567010309	0.0909090909090909	query_1	['REAC:R-HSA-5205647']	['VDAC1', 'MFN1']
646	GO:BP	GO:0009889	regulation of biosynthetic process	0.0230023522743051	True	"""Any process that modulates the frequency, rate or extent of the chemical reactions and pathways resulting in the formation of substances."" [GOC:go_curators]"	3823	97	33	17376	0.3402061855670103	0.0086319644258435	query_1	['GO:0009058', 'GO:0019222']	['RBBP8', 'SNX6', 'UBE2I', 'PDK4', 'CDK5RAP3', 'ATF7IP', 'TP53BP1', 'ZNF45', 'ZNF350', 'XRCC6', 'PAXIP1', 'SETDB2', 'DDRGK1', 'UFL1', 'PHB2', 'BRCA2', 'SETDB1', 'SUMO1', 'PDK3', 'FLYWCH1', 'BLM', 'PIAS1', 'HDAC6', 'PDK1', 'CBX5', 'BRCA1', 'STAT5A', 'PDK2', 'MBD1', 'TRIM28', 'ABHD6', 'PHB1', 'STAT5B']
647	REAC	REAC:R-HSA-3214841	PKMTs methylate histone lysines	0.0230061387455374	True	PKMTs methylate histone lysines	69	97	3	17376	0.0309278350515463	0.0434782608695652	query_1	['REAC:R-HSA-3247509']	['ATF7IP', 'SETDB2', 'SETDB1']
648	GO:CC	GO:1990234	transferase complex	0.0230276718076694	True	"""A protein complex capable of catalyzing the transfer of a group, e.g. a methyl group, glycosyl group, acyl group, phosphorus-containing, or other groups, from one compound (generally regarded as the donor) to another compound (generally regarded as the acceptor)."" [GOC:bhm, PMID:16540464]"	846	97	11	17376	0.1134020618556701	0.0130023640661938	query_1	['GO:1902494']	['UBE2I', 'DLST', 'XRCC6', 'PAXIP1', 'BRCA2', 'RAD51', 'CBX5', 'BRCA1', 'DLD', 'BARD1', 'OGDH']
649	GO:BP	GO:0015031	protein transport	0.023276643912975	True	"""The directed movement of proteins into, out of or within a cell, or between cells, by means of some agent such as a transporter or pore."" [GOC:ai]"	1525	97	17	17376	0.1752577319587628	0.0111475409836065	query_1	['GO:0045184', 'GO:0071702', 'GO:0071705']	['SNX6', 'SNX1', 'MAIP1', 'HSPA9', 'UBAC2', 'PMPCA', 'PHB2', 'MCU', 'SIL1', 'SUMO1', 'HSPD1', 'HDAC6', 'FAF2', 'TRIM28', 'BARD1', 'PMPCB', 'UFM1']
650	GO:BP	GO:0039692	single stranded viral RNA replication via double stranded DNA intermediate	0.0236348567844803	True	"""A viral genome replication where the template is single-stranded RNA (ssRNA), and which proceeds via a double stranded DNA (dsDNA) intermediate molecule. Viral genomic RNA is first reverse transcribed into dsDNA, which integrates into the host chromosomal DNA, where it is transcribed by host RNA polymerase II."" [GOC:bf, GOC:jl, ISBN:0198506732, VZ:1937]"	18	97	2	17376	0.0206185567010309	0.1111111111111111	query_1	['GO:0039694']	['SETDB1', 'TRIM28']
651	GO:BP	GO:0051247	positive regulation of protein metabolic process	0.0237527574990357	True	"""Any process that activates or increases the frequency, rate or extent of the chemical reactions and pathways involving a protein."" [GOC:ai]"	1399	97	16	17376	0.1649484536082474	0.0114367405289492	query_1	['GO:0010604', 'GO:0019538', 'GO:0051173', 'GO:0051246']	['SNX1', 'CDK5RAP3', 'NBN', 'RAD50', 'XRCC6', 'PAXIP1', 'DDRGK1', 'PHB2', 'SUMO1', 'HSPD1', 'PIAS1', 'MRE11', 'HDAC6', 'BRCA1', 'BARD1', 'PHB1']
652	GO:BP	GO:0071702	organic substance transport	0.0240303283864539	True	"""The directed movement of organic substances into, out of or within a cell, or between cells, or within a multicellular organism by means of some agent such as a transporter or pore. An organic substance is a molecular entity that contains carbon."" [GOC:mah]"	2637	97	25	17376	0.2577319587628865	0.0094804702313234	query_1	['GO:0006810']	['SNX6', 'SNX1', 'MAIP1', 'HSPA9', 'MCUB', 'UBAC2', 'PMPCA', 'PHB2', 'METTL21C', 'SDHD', 'MCU', 'SIL1', 'SUMO1', 'HSPD1', 'VDAC1', 'AFG3L2', 'HDAC6', 'FAF2', 'MICU1', 'SMDT1', 'TRIM28', 'BARD1', 'MICU2', 'PMPCB', 'UFM1']
653	REAC	REAC:R-HSA-9006335	Signaling by Erythropoietin	0.0241209753460348	True	Signaling by Erythropoietin	23	97	2	17376	0.0206185567010309	0.0869565217391304	query_1	['REAC:R-HSA-162582']	['STAT5A', 'STAT5B']
654	REAC	REAC:R-HSA-982772	Growth hormone receptor signaling	0.0241209753460348	True	Growth hormone receptor signaling	23	97	2	17376	0.0206185567010309	0.0869565217391304	query_1	['REAC:R-HSA-1280215']	['STAT5A', 'STAT5B']
655	GO:BP	GO:0002520	immune system development	0.0244410681207611	True	"""The process whose specific outcome is the progression of an organismal system whose objective is to provide calibrated responses by an organism to a potential internal or invasive threat, over time, from its formation to the mature structure. A system is a regularly interacting or interdependent group of organs or tissues that work together to carry out a given biological process."" [GOC:add, GOC:dph]"	194	97	5	17376	0.0515463917525773	0.0257731958762886	query_1	['GO:0002376', 'GO:0048731']	['NBN', 'TP53BP1', 'PAXIP1', 'HSPD1', 'STAT5B']
656	GO:BP	GO:0043067	regulation of programmed cell death	0.0245892201951922	True	"""Any process that modulates the frequency, rate or extent of programmed cell death, cell death resulting from activation of endogenous cellular processes."" [GOC:jl]"	1405	97	16	17376	0.1649484536082474	0.0113879003558718	query_1	['GO:0010941', 'GO:0012501']	['PPIF', 'SNX6', 'PDK4', 'HSPA9', 'DDRGK1', 'UFL1', 'PHB2', 'HSPD1', 'MRE11', 'VDAC1', 'HDAC6', 'BRCA1', 'BARD1', 'PHB1', 'UFM1', 'STAT5B']
657	GO:BP	GO:0051224	negative regulation of protein transport	0.0246780277336365	True	"""Any process that stops, prevents, or reduces the frequency, rate or extent of the directed movement of a protein into, out of or within a cell, or between cells, by means of some agent such as a transporter or pore."" [GOC:ai]"	121	97	4	17376	0.0412371134020618	0.0330578512396694	query_1	['GO:0015031', 'GO:0051051', 'GO:0051223', 'GO:1904950']	['UBAC2', 'SUMO1', 'BARD1', 'UFM1']
658	GO:BP	GO:0072655	establishment of protein localization to mitochondrion	0.0246780277336365	True	"""The directed movement of a protein to the mitochondrion or a part of the mitochondrion."" [GOC:mah]"	121	97	4	17376	0.0412371134020618	0.0330578512396694	query_1	['GO:0070585', 'GO:0072594']	['MAIP1', 'PMPCA', 'HSPD1', 'PMPCB']
659	GO:BP	GO:0042306	regulation of protein import into nucleus	0.0250995987942361	True	"""Any process that modulates the frequency, rate or extent of movement of proteins from the cytoplasm to the nucleus."" [GOC:jl]"	61	97	3	17376	0.0309278350515463	0.0491803278688524	query_1	['GO:0006606', 'GO:0033157', 'GO:0046822', 'GO:1900180']	['SUMO1', 'TRIM28', 'UFM1']
660	GO:BP	GO:0055085	transmembrane transport	0.0253927537982682	True	"""The process in which a solute is transported across a lipid bilayer, from one side of a membrane to the other."" [GOC:dph, GOC:jid]"	1411	97	16	17376	0.1649484536082474	0.0113394755492558	query_1	['GO:0006810', 'GO:0009987']	['PPIF', 'MAIP1', 'MCUB', 'PHB2', 'METTL21C', 'MCU', 'SUMO1', 'HSPD1', 'VDAC1', 'AFG3L2', 'ISCU', 'MICU1', 'SMDT1', 'MICU2', 'PMPCB', 'GJA10']
661	REAC	REAC:R-HSA-9615933	Postmitotic nuclear pore complex (NPC) reformation	0.0259825080830921	True	Postmitotic nuclear pore complex (NPC) reformation	24	97	2	17376	0.0206185567010309	0.0833333333333333	query_1	['REAC:R-HSA-2995410']	['UBE2I', 'SUMO1']
662	GO:BP	GO:0034763	negative regulation of transmembrane transport	0.0267216874496837	True	"""Any process that stops, prevents, or reduces the frequency, rate or extent of the directed movement of a solute from one side of a membrane to the other."" [GOC:mah]"	124	97	4	17376	0.0412371134020618	0.032258064516129	query_1	['GO:0034762', 'GO:0048523', 'GO:0051051', 'GO:0055085']	['PPIF', 'SUMO1', 'VDAC1', 'ISCU']
663	GO:BP	GO:0022411	cellular component disassembly	0.0267216874496837	True	"""A cellular process that results in the breakdown of a cellular component."" [GOC:isa_complete]"	476	97	8	17376	0.0824742268041237	0.0168067226890756	query_1	['GO:0016043']	['CDK5RAP3', 'DDRGK1', 'UFL1', 'PHB2', 'VDAC1', 'HDAC6', 'UBA5', 'UFM1']
664	GO:BP	GO:0031326	regulation of cellular biosynthetic process	0.0271771901238261	True	"""Any process that modulates the frequency, rate or extent of the chemical reactions and pathways resulting in the formation of substances, carried out by individual cells."" [GOC:mah]"	3716	97	32	17376	0.3298969072164948	0.0086114101184068	query_1	['GO:0009889', 'GO:0031323', 'GO:0044249']	['RBBP8', 'SNX6', 'UBE2I', 'PDK4', 'CDK5RAP3', 'ATF7IP', 'TP53BP1', 'ZNF45', 'ZNF350', 'XRCC6', 'PAXIP1', 'SETDB2', 'DDRGK1', 'UFL1', 'PHB2', 'BRCA2', 'SETDB1', 'SUMO1', 'PDK3', 'FLYWCH1', 'BLM', 'PIAS1', 'HDAC6', 'PDK1', 'CBX5', 'BRCA1', 'STAT5A', 'PDK2', 'MBD1', 'TRIM28', 'PHB1', 'STAT5B']
665	GO:BP	GO:0006303	double-strand break repair via nonhomologous end joining	0.0271771901238261	True	"""The repair of a double-strand break in DNA in which the two broken ends are rejoined with little or no sequence complementarity. Information at the DNA ends may be lost due to the modification of broken DNA ends. This term covers instances of separate pathways, called classical (or canonical) and alternative nonhomologous end joining (C-NHEJ and A-NHEJ). These in turn may further branch into sub-pathways, but evidence is still unclear."" [GOC:rph, PMID:10827453, PMID:24837021]"	63	97	3	17376	0.0309278350515463	0.0476190476190476	query_1	['GO:0006302']	['TP53BP1', 'XRCC6', 'MRE11']
666	GO:BP	GO:0051179	localization	0.0271771901238261	True	"""Any process in which a cell, a substance, or a cellular entity, such as a protein complex or organelle, is transported, tethered to or otherwise maintained in a specific location. In the case of substances, localization may also be achieved via selective degradation."" [GOC:ai, GOC:dos]"	4982	97	40	17376	0.4123711340206185	0.0080289040545965	query_1	['GO:0008150']	['PPIF', 'SNX6', 'UBE2I', 'SPG7', 'SNX1', 'MAIP1', 'CDK5RAP3', 'HSPA9', 'MCUB', 'UBAC2', 'DDRGK1', 'UFL1', 'PMPCA', 'PHB2', 'METTL21C', 'SDHD', 'BRCA2', 'MCU', 'SIL1', 'SUMO1', 'HSPD1', 'RPA1', 'VDAC1', 'AFG3L2', 'HDAC6', 'ISCU', 'FAF2', 'BRCA1', 'MICU1', 'STAT5A', 'SMDT1', 'TRIM28', 'BARD1', 'MICU2', 'MFN1', 'PMPCB', 'UBA5', 'GJA10', 'UFM1', 'STAT5B']
667	GO:BP	GO:1904950	negative regulation of establishment of protein localization	0.0272007025355193	True	"""Any process that stops, prevents or reduces the frequency, rate or extent of establishment of protein localization."" [GO_REF:0000058, GOC:TermGenie, PMID:22761445]"	125	97	4	17376	0.0412371134020618	0.032	query_1	['GO:0045184', 'GO:0070201', 'GO:1903828']	['UBAC2', 'SUMO1', 'BARD1', 'UFM1']
668	GO:BP	GO:0006811	monoatomic ion transport	0.0272839743808626	True	"""The directed movement of a monoatomic ion into, out of or within a cell, or between cells, by means of some agent such as a transporter or pore. Monatomic ions (also called simple ions) are ions consisting of exactly one atom."" [GOC:ai]"	1169	97	14	17376	0.1443298969072164	0.0119760479041916	query_1	['GO:0006810']	['PPIF', 'MAIP1', 'MCUB', 'PHB2', 'METTL21C', 'MCU', 'SUMO1', 'VDAC1', 'AFG3L2', 'ISCU', 'MICU1', 'SMDT1', 'MICU2', 'PMPCB']
669	GO:BP	GO:0036498	IRE1-mediated unfolded protein response	0.0273392162650811	True	"""The series of molecular signals mediated by the endoplasmic reticulum stress sensor IRE1 (Inositol-requiring transmembrane kinase/endonuclease). Begins with activation of IRE1 in response to endoplasmic reticulum (ER) stress, and ends with regulation of a downstream cellular process, e.g. transcription. One target of activated IRE1 is the transcription factor HAC1 in yeast, or XBP1 in mammals; IRE1 cleaves an intron of a mRNA coding for HAC1/XBP1 to generate an activated HAC1/XBP1 transcription factor, which controls the up regulation of UPR-related genes. At least in mammals, IRE1 can also signal through additional intracellular pathways including JNK and NF-kappaB."" [GOC:bf, GOC:PARL, PMID:22013210]"	20	97	2	17376	0.0206185567010309	0.1	query_1	['GO:0030968']	['DDRGK1', 'UFL1']
670	GO:BP	GO:0070192	chromosome organization involved in meiotic cell cycle	0.0273392162650811	True	"""A process of chromosome organization that is involved in a meiotic cell cycle."" [GOC:mah]"	64	97	3	17376	0.0309278350515463	0.046875	query_1	['GO:0051276', 'GO:1903046']	['RAD50', 'MRE11', 'RAD51']
671	GO:BP	GO:1905091	positive regulation of parkin-mediated stimulation of mitophagy in response to mitochondrial depolarization	0.0273392162650811	True	"""Any process that activates or increases the frequency, rate or extent of parkin-mediated mitophagy in response to mitochondrial depolarization."" [GO_REF:0000058, GOC:pad, GOC:PARL, GOC:TermGenie, PMID:26942284]"	1	97	1	17376	0.0103092783505154	1.0	query_1	['GO:0048584', 'GO:0061734', 'GO:1901526', 'GO:1905089']	['VDAC1']
672	GO:BP	GO:0070512	positive regulation of histone H4-K20 methylation	0.0273392162650811	True	"""Any process that activates or increases the frequency, rate or extent of the covalent addition of a methyl group to the lysine at position 20 of histone H4."" [GOC:mah]"	1	97	1	17376	0.0103092783505154	1.0	query_1	['GO:0031062']	['BRCA1']
673	GO:BP	GO:0070843	misfolded protein transport	0.0273392162650811	True	"""The directed movement of misfolded proteins in a cell, including the movement of proteins between specific compartments or structures within a cell."" [GOC:BHF, GOC:mah, PMID:14675537]"	1	97	1	17376	0.0103092783505154	1.0	query_1	['GO:0006886']	['HDAC6']
674	GO:BP	GO:0110099	negative regulation of calcium import into the mitochondrion	0.0273392162650811	True	"""Any process that stops, prevents or reduces the frequency, rate or extent of calcium ion import into the mitochondrion."" [GOC:sl, PMID:24085037]"	1	97	1	17376	0.0103092783505154	1.0	query_1	['GO:0036444', 'GO:0110097', 'GO:1903170']	['VDAC1']
675	GO:BP	GO:0097551	mitochondrial double-strand break repair	0.0273392162650811	True	"""The repair of double-strand breaks in mitochondrial DNA via homologous and nonhomologous mechanisms to reform a continuous DNA helix."" [GOC:di, PMID:22214610]"	1	97	1	17376	0.0103092783505154	1.0	query_1	['GO:0006302']	['MRE11']
676	GO:BP	GO:0070844	polyubiquitinated protein transport	0.0273392162650811	True	"""The directed movement of polyubiquitinated proteins in a cell, including the movement of proteins between specific compartments or structures within a cell."" [GOC:BHF, GOC:mah, PMID:14675537]"	1	97	1	17376	0.0103092783505154	1.0	query_1	['GO:0006886']	['HDAC6']
677	GO:BP	GO:0070845	polyubiquitinated misfolded protein transport	0.0273392162650811	True	"""The directed movement of misfolded polyubiquitinated proteins in a cell, including the movement of proteins between specific compartments or structures within a cell."" [GOC:BHF, GOC:mah, PMID:14675537]"	1	97	1	17376	0.0103092783505154	1.0	query_1	['GO:0070843', 'GO:0070844']	['HDAC6']
678	GO:BP	GO:0070846	Hsp90 deacetylation	0.0273392162650811	True	"""The modification of an Hsp90 protein by removal of acetyl groups."" [GOC:BHF, GOC:mah]"	1	97	1	17376	0.0103092783505154	1.0	query_1	['GO:0006476']	['HDAC6']
679	GO:BP	GO:0010849	regulation of proton-transporting ATPase activity, rotational mechanism	0.0273392162650811	True	"""Any process that modulates the rate of ATP hydrolysis by an ATPase. Enables the transfer of a solute or solutes from one side of a membrane to the other according to the reaction: ATP + H2O + H+(in) = ADP + phosphate + H+(out), by a rotational mechanism."" [GOC:dph, GOC:tb]"	1	97	1	17376	0.0103092783505154	1.0	query_1	['GO:0010155', 'GO:0032412', 'GO:0043462']	['PPIF']
680	GO:BP	GO:0070585	protein localization to mitochondrion	0.0273392162650811	True	"""A process in which a protein is transported to, or maintained in, a location within the mitochondrion."" [GOC:ecd]"	127	97	4	17376	0.0412371134020618	0.0314960629921259	query_1	['GO:0033365']	['MAIP1', 'PMPCA', 'HSPD1', 'PMPCB']
681	GO:BP	GO:1904631	response to glucoside	0.0273392162650811	True	"""Any process that results in a change in state or activity of a cell or an organism (in terms of movement, secretion, enzyme production, gene expression, etc.) as a result of a glucoside stimulus."" [GO_REF:0000071, GOC:TermGenie, PMID:16842873]"	1	97	1	17376	0.0103092783505154	1.0	query_1	['GO:1903416']	['RAD51']
682	GO:BP	GO:0097552	mitochondrial double-strand break repair via homologous recombination	0.0273392162650811	True	"""The repair of a double-strand break in mitochondrial DNA in which the broken DNA molecule is repaired using homologous sequences."" [GOC:di, PMID:22214610]"	1	97	1	17376	0.0103092783505154	1.0	query_1	['GO:0000725', 'GO:0097551']	['MRE11']
683	GO:BP	GO:0040014	regulation of multicellular organism growth	0.0273392162650811	True	"""Any process that modulates the frequency, rate or extent of growth of the body of an organism so that it reaches its usual body size."" [GOC:dph, GOC:ems, GOC:tb]"	64	97	3	17376	0.0309278350515463	0.046875	query_1	['GO:0035264', 'GO:0048638', 'GO:0051239']	['AFG3L2', 'STAT5A', 'STAT5B']
684	GO:BP	GO:0007127	meiosis I	0.0273392162650811	True	"""The first meiotic nuclear division in which homologous chromosomes are paired and segregated from each other, producing two haploid daughter nuclei."" [GOC:dph, GOC:jl, GOC:mtg_cell_cycle, PMID:9334324]"	126	97	4	17376	0.0412371134020618	0.0317460317460317	query_1	['GO:0061982', 'GO:0140013']	['RAD50', 'BRCA2', 'MRE11', 'RAD51']
685	GO:BP	GO:0043271	negative regulation of monoatomic ion transport	0.0273392162650811	True	"""Any process that stops, prevents, or reduces the frequency, rate or extent of the directed movement of charged atoms or small charged molecules into, out of or within a cell, or between cells, by means of some agent such as a transporter or pore."" [GOC:jl]"	127	97	4	17376	0.0412371134020618	0.0314960629921259	query_1	['GO:0006811', 'GO:0043269', 'GO:0051051']	['PPIF', 'SUMO1', 'VDAC1', 'ISCU']
686	GO:BP	GO:1901984	negative regulation of protein acetylation	0.0273392162650811	True	"""Any process that stops, prevents or reduces the frequency, rate or extent of protein acetylation."" [GOC:TermGenie, PMID:22117195]"	20	97	2	17376	0.0206185567010309	0.1	query_1	['GO:0006473', 'GO:0031400', 'GO:1901983']	['HDAC6', 'BRCA1']
687	GO:BP	GO:1904056	positive regulation of cholangiocyte proliferation	0.0273392162650811	True	"""Any process that activates or increases the frequency, rate or extent of cholangiocyte proliferation."" [GO_REF:0000058, GOC:TermGenie, PMID:24434010]"	1	97	1	17376	0.0103092783505154	1.0	query_1	['GO:0050679', 'GO:1904054', 'GO:1990705']	['HDAC6']
688	GO:BP	GO:0006593	ornithine catabolic process	0.0273392162650811	True	"""The chemical reactions and pathways resulting in the breakdown of ornithine, an amino acid only rarely found in proteins, but which is important in living organisms as an intermediate in the reactions of the urea cycle and in arginine biosynthesis."" [GOC:jl, ISBN:0192801023]"	1	97	1	17376	0.0103092783505154	1.0	query_1	['GO:0006591', 'GO:0009063', 'GO:1901606']	['OTC']
689	GO:BP	GO:1903182	regulation of SUMO transferase activity	0.0273392162650811	True	"""Any process that modulates the frequency, rate or extent of SUMO ligase activity."" [GO_REF:0000059, GOC:bf, GOC:PARL, GOC:TermGenie]"	1	97	1	17376	0.0103092783505154	1.0	query_1	['GO:0033233', 'GO:0051338']	['UBE2I']
690	GO:BP	GO:1903755	positive regulation of SUMO transferase activity	0.0273392162650811	True	"""Any process that activates or increases the frequency, rate or extent of SUMO transferase activity."" [GO_REF:0000059, GOC:PARL, GOC:rl, GOC:TermGenie, PMID:19955185]"	1	97	1	17376	0.0103092783505154	1.0	query_1	['GO:0051347', 'GO:1903182']	['UBE2I']
691	GO:BP	GO:1904439	negative regulation of iron ion import across plasma membrane	0.0273392162650811	True	"""Any process that stops, prevents or reduces the frequency, rate or extent of iron ions import across plasma membrane."" [GO_REF:0000058, GOC:BHF, GOC:kom, GOC:TermGenie, PMID:18353247]"	1	97	1	17376	0.0103092783505154	1.0	query_1	['GO:0034760', 'GO:0098711', 'GO:1904438']	['ISCU']
692	REAC	REAC:R-HSA-1839124	FGFR1 mutant receptor activation	0.0273993324799249	True	FGFR1 mutant receptor activation	25	97	2	17376	0.0206185567010309	0.08	query_1	['REAC:R-HSA-5655302']	['STAT5A', 'STAT5B']
693	REAC	REAC:R-HSA-8854691	Interleukin-20 family signaling	0.0273993324799249	True	Interleukin-20 family signaling	25	97	2	17376	0.0206185567010309	0.08	query_1	['REAC:R-HSA-449147']	['STAT5A', 'STAT5B']
694	REAC	REAC:R-HSA-9705462	Inactivation of CSF3 (G-CSF) signaling	0.0273993324799249	True	Inactivation of CSF3 (G-CSF) signaling	25	97	2	17376	0.0206185567010309	0.08	query_1	['REAC:R-HSA-9674555']	['STAT5A', 'STAT5B']
695	GO:BP	GO:0031401	positive regulation of protein modification process	0.0275645893096474	True	"""Any process that activates or increases the frequency, rate or extent of the covalent alteration of one or more amino acid residues within a protein."" [GOC:mah, GOC:tb]"	932	97	12	17376	0.1237113402061855	0.0128755364806866	query_1	['GO:0031399', 'GO:0036211', 'GO:0051247']	['CDK5RAP3', 'NBN', 'RAD50', 'XRCC6', 'PAXIP1', 'DDRGK1', 'PHB2', 'PIAS1', 'MRE11', 'HDAC6', 'BRCA1', 'PHB1']
696	GO:CC	GO:0017053	transcription repressor complex	0.0279356521388401	True	"""A protein complex that possesses activity that prevents or downregulates transcription."" [GOC:mah]"	77	97	3	17376	0.0309278350515463	0.0389610389610389	query_1	['GO:0005667']	['RBBP8', 'ZNF350', 'CBX5']
697	REAC	REAC:R-HSA-1221632	Meiotic synapsis	0.0281892450843466	True	Meiotic synapsis	76	97	3	17376	0.0309278350515463	0.0394736842105263	query_1	['REAC:R-HSA-1500620']	['UBE2I', 'H2AX', 'BRCA1']
698	GO:BP	GO:0045739	positive regulation of DNA repair	0.0287610955394816	True	"""Any process that activates or increases the frequency, rate or extent of DNA repair."" [GOC:go_curators]"	129	97	4	17376	0.0412371134020618	0.0310077519379844	query_1	['GO:0006281', 'GO:0006282', 'GO:0048584', 'GO:0051054']	['RBBP8', 'H2AX', 'BRCA1', 'TRIM28']
699	GO:BP	GO:1901700	response to oxygen-containing compound	0.028981809080973	True	"""Any process that results in a change in state or activity of a cell or an organism (in terms of movement, secretion, enzyme production, gene expression, etc.) as a result of an oxygen-containing compound stimulus."" [GOC:pr, GOC:TermGenie]"	1707	97	18	17376	0.1855670103092783	0.0105448154657293	query_1	['GO:0042221']	['PPIF', 'SNX6', 'PDK4', 'OTC', 'UFL1', 'PHB2', 'METTL21C', 'SETDB1', 'BCKDHB', 'PDK3', 'BLM', 'RAD51', 'HDAC6', 'GPD1', 'BRCA1', 'STAT5A', 'PDK2', 'STAT5B']
700	GO:BP	GO:0006305	DNA alkylation	0.028981809080973	True	"""The addition of alkyl groups to many positions on all four bases of DNA. Alkylating agents can also modify the bases of incoming nucleotides in the course of DNA synthesis."" [ISBN:0716735970]"	66	97	3	17376	0.0309278350515463	0.0454545454545454	query_1	['GO:0006304']	['ATF7IP', 'BRCA1', 'TRIM28']
701	GO:BP	GO:0006306	DNA methylation	0.028981809080973	True	"""The covalent transfer of a methyl group to either N-6 of adenine or C-5 or N-4 of cytosine."" [GOC:ems, ISBN:0198506732]"	66	97	3	17376	0.0309278350515463	0.0454545454545454	query_1	['GO:0006305', 'GO:0043414']	['ATF7IP', 'BRCA1', 'TRIM28']
702	REAC	REAC:R-HSA-186763	Downstream signal transduction	0.0290655292138072	True	Downstream signal transduction	26	97	2	17376	0.0206185567010309	0.0769230769230769	query_1	['REAC:R-HSA-186797']	['STAT5A', 'STAT5B']
703	GO:BP	GO:0098780	response to mitochondrial depolarisation	0.0291540591500726	True	"""Any process that results in a change in state or activity of a cell (in terms of movement, secretion, enzyme production, gene expression, etc.) in response to the depolarization of one or more mitochondria."" [GOC:dos]"	21	97	2	17376	0.0206185567010309	0.0952380952380952	query_1	['GO:0033554']	['VDAC1', 'HDAC6']
704	GO:BP	GO:0051571	positive regulation of histone H3-K4 methylation	0.0291540591500726	True	"""Any process that activates or increases the frequency, rate or extent of the covalent addition of a methyl group to the lysine at position 4 of histone H3."" [GOC:mah]"	21	97	2	17376	0.0206185567010309	0.0952380952380952	query_1	['GO:0031062', 'GO:0051568', 'GO:0051569']	['PAXIP1', 'BRCA1']
705	GO:BP	GO:0097193	intrinsic apoptotic signaling pathway	0.0293209882488756	True	"""The series of molecular signals in which an intracellular signal is conveyed to trigger the apoptotic death of a cell. The pathway starts with reception of an intracellular signal (e.g. DNA damage, endoplasmic reticulum stress, oxidative stress etc.), and ends when the execution phase of apoptosis is triggered. The intrinsic apoptotic signaling pathway is crucially regulated by permeabilization of the mitochondrial outer membrane (MOMP)."" [GOC:mtg_apoptosis, GOC:yaf, PMID:11919192, PMID:17340152, PMID:18852119]"	294	97	6	17376	0.0618556701030927	0.0204081632653061	query_1	['GO:0035556', 'GO:0097190']	['PPIF', 'NBN', 'BRCA2', 'PDK1', 'BRCA1', 'PDK2']
706	GO:BP	GO:0043604	amide biosynthetic process	0.0296439344735189	True	"""The chemical reactions and pathways resulting in the formation of an amide, any derivative of an oxoacid in which an acidic hydroxy group has been replaced by an amino or substituted amino group."" [GOC:curators]"	824	97	11	17376	0.1134020618556701	0.0133495145631067	query_1	['GO:0043603', 'GO:0044271']	['PDK4', 'OTC', 'DLAT', 'PDHA2', 'PDHX', 'PDHB', 'PDHA1', 'PDK3', 'PDK1', 'DLD', 'PDK2']
707	GO:BP	GO:0050821	protein stabilization	0.0297272973760138	True	"""Any process involved in maintaining the structure and integrity of a protein and preventing it from degradation or aggregation."" [GOC:ai]"	208	97	5	17376	0.0515463917525773	0.0240384615384615	query_1	['GO:0031647']	['ATF7IP', 'PHB2', 'SUMO1', 'HSPD1', 'PHB1']
708	REAC	REAC:R-HSA-9663891	Selective autophagy	0.0297452366453298	True	Selective autophagy	78	97	3	17376	0.0309278350515463	0.0384615384615384	query_1	['REAC:R-HSA-1632852']	['VDAC1', 'HDAC6', 'MFN1']
709	GO:BP	GO:0002702	positive regulation of production of molecular mediator of immune response	0.0298011399028127	True	"""Any process that activates or increases the frequency, rate, or extent of the production of molecular mediator of immune response."" [GOC:add]"	131	97	4	17376	0.0412371134020618	0.0305343511450381	query_1	['GO:0002440', 'GO:0002699', 'GO:0002700', 'GO:0010628']	['TP53BP1', 'PAXIP1', 'PHB2', 'PHB1']
710	REAC	REAC:R-HSA-9682385	FLT3 signaling in disease	0.0302349107584505	True	FLT3 signaling in disease	27	97	2	17376	0.0206185567010309	0.074074074074074	query_1	['REAC:R-HSA-5663202']	['STAT5A', 'STAT5B']
711	REAC	REAC:R-HSA-5205647	Mitophagy	0.0302349107584505	True	Mitophagy	27	97	2	17376	0.0206185567010309	0.074074074074074	query_1	['REAC:R-HSA-9663891']	['VDAC1', 'MFN1']
712	REAC	REAC:R-HSA-9683701	Translation of Structural Proteins	0.0302349107584505	True	Translation of Structural Proteins	27	97	2	17376	0.0206185567010309	0.074074074074074	query_1	['REAC:R-HSA-9678108']	['UBE2I', 'SUMO1']
713	GO:BP	GO:0061982	meiosis I cell cycle process	0.0305416475820858	True	"""A process that contributes to the first meiotic division. The first meiotic division is the reductive division resulting in the separation of homologous chromosome pairs."" [PMID:29385397]"	132	97	4	17376	0.0412371134020618	0.0303030303030303	query_1	['GO:1903046']	['RAD50', 'BRCA2', 'MRE11', 'RAD51']
714	GO:BP	GO:0016043	cellular component organization	0.0306221017918703	True	"""A process that results in the assembly, arrangement of constituent parts, or disassembly of a cellular component."" [GOC:ai, GOC:jl, GOC:mah]"	6030	97	46	17376	0.4742268041237113	0.0076285240464344	query_1	['GO:0071840']	['PPIF', 'UBE2I', 'SPG7', 'SNX1', 'LYRM4', 'MAIP1', 'CDK5RAP3', 'NBN', 'ATF7IP', 'HSPA9', 'TP53BP1', 'RAD50', 'XRCC6', 'SETDB2', 'H2AX', 'DDRGK1', 'UFL1', 'PMPCA', 'PHB2', 'BRCA2', 'MCU', 'SETDB1', 'CDNF', 'SUMO1', 'HSPD1', 'RPA1', 'BLM', 'MRE11', 'VDAC1', 'RAD51', 'AFG3L2', 'HDAC6', 'ISCU', 'FAF2', 'NFS1', 'CBX5', 'NDUFAB1', 'BRCA1', 'MICU1', 'TRIM28', 'MFN1', 'PMPCB', 'UBA5', 'GJA10', 'PHB1', 'UFM1']
715	GO:BP	GO:0045732	positive regulation of protein catabolic process	0.0306811852719777	True	"""Any process that activates or increases the frequency, rate or extent of the chemical reactions and pathways resulting in the breakdown of a protein by the destruction of the native, active configuration, with or without the hydrolysis of peptide bonds."" [GOC:go_curators]"	210	97	5	17376	0.0515463917525773	0.0238095238095238	query_1	['GO:0009896', 'GO:0030163', 'GO:0042176', 'GO:0051247']	['SNX1', 'DDRGK1', 'SUMO1', 'PIAS1', 'BARD1']
716	GO:BP	GO:0007004	telomere maintenance via telomerase	0.03085765267058	True	"""The maintenance of proper telomeric length by the addition of telomeric repeats by telomerase."" [GOC:elh]"	68	97	3	17376	0.0309278350515463	0.0441176470588235	query_1	['GO:0006278', 'GO:0010833']	['RAD50', 'RPA1', 'MRE11']
717	GO:BP	GO:2001141	regulation of RNA biosynthetic process	0.0312162349026979	True	"""Any process that modulates the frequency, rate or extent of RNA biosynthetic process."" [GOC:dph]"	3159	97	28	17376	0.2886597938144329	0.0088635644191199	query_1	['GO:0010556', 'GO:0031326', 'GO:0032774', 'GO:0051252']	['RBBP8', 'SNX6', 'UBE2I', 'CDK5RAP3', 'ATF7IP', 'TP53BP1', 'ZNF45', 'ZNF350', 'XRCC6', 'PAXIP1', 'SETDB2', 'DDRGK1', 'UFL1', 'PHB2', 'BRCA2', 'SETDB1', 'SUMO1', 'FLYWCH1', 'BLM', 'PIAS1', 'HDAC6', 'CBX5', 'BRCA1', 'STAT5A', 'MBD1', 'TRIM28', 'PHB1', 'STAT5B']
718	GO:BP	GO:0001832	blastocyst growth	0.0313169672386978	True	"""An increase in size of a blastocyst due to expansion of the blastocoelic cavity cell shape changes and cell proliferation."" [GOC:dph, ISBN:0124020607, ISBN:0198542771]"	22	97	2	17376	0.0206185567010309	0.0909090909090909	query_1	['GO:0001824', 'GO:0048589']	['NBN', 'BRCA2']
719	GO:BP	GO:0016571	histone methylation	0.0318013680335894	True	"""The modification of histones by addition of methyl groups."" [GOC:ai]"	134	97	4	17376	0.0412371134020618	0.0298507462686567	query_1	['GO:0006479', 'GO:0016570']	['PAXIP1', 'SETDB2', 'SETDB1', 'BRCA1']
720	GO:BP	GO:0006278	RNA-templated DNA biosynthetic process	0.031813231511918	True	"""A DNA biosynthetic process that uses RNA as a template for RNA-dependent DNA polymerases (e.g. reverse transcriptase) that synthesize the new strand."" [GOC:mah, ISBN:0198506732]"	69	97	3	17376	0.0309278350515463	0.0434782608695652	query_1	['GO:0071897']	['RAD50', 'RPA1', 'MRE11']
721	GO:BP	GO:0010569	regulation of double-strand break repair via homologous recombination	0.031813231511918	True	"""Any process that modulates the frequency, rate or extent of the error-free repair of a double-strand break in DNA in which the broken DNA molecule is repaired using homologous sequences."" [GOC:dph, GOC:jp, GOC:tb]"	69	97	3	17376	0.0309278350515463	0.0434782608695652	query_1	['GO:0000018', 'GO:0000724', 'GO:2000779']	['RBBP8', 'TP53BP1', 'RAD51']
722	GO:BP	GO:0002705	positive regulation of leukocyte mediated immunity	0.0323772178407697	True	"""Any process that activates or increases the frequency, rate, or extent of leukocyte mediated immunity."" [GOC:add]"	135	97	4	17376	0.0412371134020618	0.0296296296296296	query_1	['GO:0002443', 'GO:0002699', 'GO:0002703']	['TP53BP1', 'PAXIP1', 'HSPD1', 'STAT5B']
723	GO:BP	GO:0071456	cellular response to hypoxia	0.0323772178407697	True	"""Any process that results in a change in state or activity of a cell (in terms of movement, secretion, enzyme production, gene expression, etc.) as a result of a stimulus indicating lowered oxygen tension. Hypoxia, defined as a decline in O2 levels below normoxic levels of 20.8 - 20.95%, results in metabolic adaptation at both the cellular and organismal level."" [GOC:mah]"	135	97	4	17376	0.0412371134020618	0.0296296296296296	query_1	['GO:0001666', 'GO:0033554', 'GO:0036294']	['PHB2', 'SDHD', 'PDK3', 'PDK1']
724	GO:CC	GO:1990221	L-cysteine desulfurase complex	0.0326302815742036	True	"""A protein complex capable of cysteine desulfurase activity decomposing L-cysteine to L-alanine and sulfur. It belongs to a ubiquitous family of pyridoxal 5-phosphate (PLP)-dependent enzymes. In E. coli it consists of a SufS dimer."" [GOC:bhm, PMID:11827487]"	2	97	1	17376	0.0103092783505154	0.5	query_1	['GO:0005829', 'GO:1902494']	['LYRM4']
725	GO:CC	GO:0140494	migrasome	0.0326302815742036	True	"""A vesicular organelle that forms on retraction fibers behind migrating cells and mediates the release of cytoplasmic contents during cell migration."" [PMID:25342562, PMID:31371827]"	2	97	1	17376	0.0103092783505154	0.5	query_1	['GO:0043231']	['HSPD1']
726	GO:CC	GO:0005960	glycine cleavage complex	0.0326302815742036	True	"""A protein complex that catalyzes the reversible oxidation of glycine. In E. coli, it has four components: dihydrolipoamide dehydrogenase, glycine dehydrogenase (decarboxylating), lipoyl-GcvH-protein and aminomethyltransferase, also known as L, P, H, and T."" [GOC:mah, MetaCyc:GCVMULTI-CPLX]"	2	97	1	17376	0.0103092783505154	0.5	query_1	['GO:0005737', 'GO:1990204']	['GCSH']
727	GO:CC	GO:0000792	heterochromatin	0.0326302815742036	True	"""A compact and highly condensed form of chromatin that is refractory to transcription."" [PMID:32017156]"	82	97	3	17376	0.0309278350515463	0.0365853658536585	query_1	['GO:0000785']	['FLYWCH1', 'CBX5', 'TRIM28']
728	GO:BP	GO:0032206	positive regulation of telomere maintenance	0.032844765975183	True	"""Any process that activates or increases the frequency, rate or extent of a process that affects and monitors the activity of telomeric proteins and the length of telomeric DNA."" [GOC:mah]"	70	97	3	17376	0.0309278350515463	0.0428571428571428	query_1	['GO:0000723', 'GO:0032204', 'GO:0051054', 'GO:2001252']	['NBN', 'RAD50', 'MRE11']
729	GO:BP	GO:0045911	positive regulation of DNA recombination	0.032844765975183	True	"""Any process that activates or increases the frequency, rate or extent of DNA recombination."" [GOC:go_curators]"	70	97	3	17376	0.0309278350515463	0.0428571428571428	query_1	['GO:0000018', 'GO:0006310', 'GO:0051054']	['RBBP8', 'TP53BP1', 'PAXIP1']
730	GO:BP	GO:0030879	mammary gland development	0.0329508265754871	True	"""The process whose specific outcome is the progression of the mammary gland over time, from its formation to the mature structure. The mammary gland is a large compound sebaceous gland that in female mammals is modified to secrete milk. Its development starts with the formation of the mammary line and ends as the mature gland cycles between nursing and weaning stages."" [PMID:9576833]"	136	97	4	17376	0.0412371134020618	0.0294117647058823	query_1	['GO:0048732']	['PHB2', 'BRCA2', 'STAT5A', 'STAT5B']
731	GO:BP	GO:2000377	regulation of reactive oxygen species metabolic process	0.0329508265754871	True	"""Any process that modulates the frequency, rate or extent of reactive oxygen species metabolic process."" [GOC:mah]"	136	97	4	17376	0.0412371134020618	0.0294117647058823	query_1	['GO:0031323', 'GO:0072593']	['PDK3', 'VDAC1', 'HDAC6', 'BRCA1']
732	GO:BP	GO:0072593	reactive oxygen species metabolic process	0.0329508265754871	True	"""The chemical reactions and pathways involving a reactive oxygen species, any molecules or ions formed by the incomplete one-electron reduction of oxygen. They contribute to the microbicidal activity of phagocytes, regulation of signal transduction and gene expression, and the oxidative damage to biopolymers."" [GOC:mah]"	215	97	5	17376	0.0515463917525773	0.0232558139534883	query_1	['GO:0044237']	['PDK4', 'PDK3', 'VDAC1', 'HDAC6', 'BRCA1']
733	REAC	REAC:R-HSA-9763198	Impaired BRCA2 binding to SEM1 (DSS1)	0.0329529927831028	True	Impaired BRCA2 binding to SEM1 (DSS1)	2	97	1	17376	0.0103092783505154	0.5	query_1	['REAC:R-HSA-9701190']	['BRCA2']
734	REAC	REAC:R-HSA-6791465	Pentose phosphate pathway disease	0.0329529927831028	True	Pentose phosphate pathway disease	2	97	1	17376	0.0103092783505154	0.5	query_1	['REAC:R-HSA-5663084']	['TALDO1']
735	REAC	REAC:R-HSA-163754	Insulin effects increased synthesis of Xylulose-5-Phosphate	0.0329529927831028	True	Insulin effects increased synthesis of Xylulose-5-Phosphate	2	97	1	17376	0.0103092783505154	0.5	query_1	['REAC:R-HSA-163685']	['TALDO1']
736	REAC	REAC:R-HSA-9709275	Impaired BRCA2 translocation to the nucleus	0.0329529927831028	True	Impaired BRCA2 translocation to the nucleus	2	97	1	17376	0.0103092783505154	0.5	query_1	['REAC:R-HSA-9701190']	['BRCA2']
737	GO:BP	GO:0051171	regulation of nitrogen compound metabolic process	0.0336094662486337	True	"""Any process that modulates the frequency, rate or extent of the chemical reactions and pathways involving nitrogen or nitrogenous compounds."" [GOC:ai, GOC:tb]"	5234	97	41	17376	0.422680412371134	0.0078333970194879	query_1	['GO:0006807', 'GO:0019222']	['RBBP8', 'SNX6', 'UBE2I', 'PDK4', 'SNX1', 'CDK5RAP3', 'NBN', 'ATF7IP', 'TP53BP1', 'RAD50', 'ZNF45', 'ZNF350', 'XRCC6', 'PAXIP1', 'SETDB2', 'H2AX', 'DDRGK1', 'UFL1', 'PHB2', 'BRCA2', 'SETDB1', 'BCKDK', 'SUMO1', 'HSPD1', 'PDK3', 'FLYWCH1', 'BLM', 'PIAS1', 'MRE11', 'RAD51', 'HDAC6', 'PDK1', 'CBX5', 'BRCA1', 'STAT5A', 'PDK2', 'MBD1', 'TRIM28', 'BARD1', 'PHB1', 'STAT5B']
738	GO:BP	GO:1903322	positive regulation of protein modification by small protein conjugation or removal	0.0336094662486337	True	"""Any process that activates or increases the frequency, rate or extent of protein modification by small protein conjugation or removal."" [GO_REF:0000058, GOC:TermGenie, GOC:vw]"	137	97	4	17376	0.0412371134020618	0.0291970802919708	query_1	['GO:0031401', 'GO:0070647', 'GO:1903320']	['CDK5RAP3', 'PAXIP1', 'PIAS1', 'BRCA1']
739	GO:BP	GO:1900180	regulation of protein localization to nucleus	0.0344004333099106	True	"""Any process that modulates the frequency, rate or extent of protein localization to nucleus."" [GOC:TermGenie]"	138	97	4	17376	0.0412371134020618	0.0289855072463768	query_1	['GO:0032880', 'GO:0034504']	['CDK5RAP3', 'SUMO1', 'TRIM28', 'UFM1']
740	GO:BP	GO:0009893	positive regulation of metabolic process	0.0345610774320826	True	"""Any process that activates or increases the frequency, rate or extent of the chemical reactions and pathways within a cell or an organism."" [GOC:go_curators]"	3648	97	31	17376	0.3195876288659793	0.0084978070175438	query_1	['GO:0008152', 'GO:0019222', 'GO:0048518']	['RBBP8', 'SNX1', 'CDK5RAP3', 'NBN', 'ATF7IP', 'TP53BP1', 'RAD50', 'XRCC6', 'PAXIP1', 'H2AX', 'DDRGK1', 'UFL1', 'PHB2', 'BRCA2', 'SUMO1', 'HSPD1', 'BLM', 'PIAS1', 'MRE11', 'VDAC1', 'RAD51', 'HDAC6', 'ISCU', 'GPD1', 'BRCA1', 'STAT5A', 'TRIM28', 'BARD1', 'ABHD6', 'PHB1', 'STAT5B']
741	GO:BP	GO:0043603	amide metabolic process	0.0345610774320826	True	"""The chemical reactions and pathways involving an amide, any derivative of an oxoacid in which an acidic hydroxy group has been replaced by an amino or substituted amino group, as carried out by individual cells."" [GOC:curators]"	1091	97	13	17376	0.134020618556701	0.0119156736938588	query_1	['GO:0006807']	['PDK4', 'OTC', 'DLST', 'DLAT', 'PDHA2', 'PDHX', 'PDHB', 'PDHA1', 'PDK3', 'PDK1', 'DLD', 'PDK2', 'OGDH']
742	GO:BP	GO:0034504	protein localization to nucleus	0.0352856473789615	True	"""A process in which a protein transports or maintains the localization of another protein to the nucleus."" [GOC:ecd]"	309	97	6	17376	0.0618556701030927	0.0194174757281553	query_1	['GO:0033365']	['CDK5RAP3', 'PHB2', 'SUMO1', 'TRIM28', 'BARD1', 'UFM1']
743	GO:BP	GO:1901701	cellular response to oxygen-containing compound	0.0352856473789615	True	"""Any process that results in a change in state or activity of a cell (in terms of movement, secretion, enzyme production, gene expression, etc.) as a result of an oxygen-containing compound stimulus."" [GOC:pr, GOC:TermGenie]"	1221	97	14	17376	0.1443298969072164	0.0114660114660114	query_1	['GO:0070887', 'GO:1901700']	['PPIF', 'SNX6', 'PDK4', 'PHB2', 'METTL21C', 'PDK3', 'BLM', 'RAD51', 'HDAC6', 'GPD1', 'BRCA1', 'STAT5A', 'PDK2', 'STAT5B']
744	REAC	REAC:R-HSA-9674555	Signaling by CSF3 (G-CSF)	0.0355840999151423	True	Signaling by CSF3 (G-CSF)	30	97	2	17376	0.0206185567010309	0.0666666666666666	query_1	['REAC:R-HSA-1280215']	['STAT5A', 'STAT5B']
745	GO:BP	GO:0010155	regulation of proton transport	0.0357477467726913	True	"""Any process that modulates the frequency, rate or extent of proton transport into, out of or within a cell, or between cells, by means of some agent such as a transporter or pore."" [GOC:sm]"	24	97	2	17376	0.0206185567010309	0.0833333333333333	query_1	['GO:1902600', 'GO:1904062']	['PPIF', 'PHB2']
746	GO:BP	GO:0032434	regulation of proteasomal ubiquitin-dependent protein catabolic process	0.0357477467726913	True	"""Any process that modulates the frequency, rate or extent of the breakdown of a protein or peptide by hydrolysis of its peptide bonds, initiated by the covalent attachment of ubiquitin, and mediated by the proteasome."" [GOC:mah]"	140	97	4	17376	0.0412371134020618	0.0285714285714285	query_1	['GO:0043161', 'GO:0061136', 'GO:2000058']	['DDRGK1', 'UFL1', 'SUMO1', 'PIAS1']
747	GO:BP	GO:0009894	regulation of catabolic process	0.0357477467726913	True	"""Any process that modulates the frequency, rate, or extent of the chemical reactions and pathways resulting in the breakdown of substances."" [GOC:go_curators]"	973	97	12	17376	0.1237113402061855	0.0123329907502569	query_1	['GO:0009056', 'GO:0019222']	['SNX6', 'SNX1', 'CDK5RAP3', 'DDRGK1', 'UFL1', 'SUMO1', 'PIAS1', 'VDAC1', 'HDAC6', 'GPD1', 'BARD1', 'PHB1']
748	GO:BP	GO:0009896	positive regulation of catabolic process	0.0361079193654957	True	"""Any process that activates or increases the frequency, rate or extent of the chemical reactions and pathways resulting in the breakdown of substances."" [GOC:go_curators]"	513	97	8	17376	0.0824742268041237	0.0155945419103313	query_1	['GO:0009056', 'GO:0009893', 'GO:0009894']	['SNX1', 'DDRGK1', 'UFL1', 'SUMO1', 'PIAS1', 'VDAC1', 'GPD1', 'BARD1']
749	GO:BP	GO:0016064	immunoglobulin mediated immune response	0.0364188906140048	True	"""An immune response mediated by immunoglobulins, whether cell-bound or in solution."" [GO_REF:0000022, GOC:add, ISBN:0781735149]"	141	97	4	17376	0.0412371134020618	0.0283687943262411	query_1	['GO:0019724']	['NBN', 'TP53BP1', 'PAXIP1', 'HSPD1']
750	GO:BP	GO:0030968	endoplasmic reticulum unfolded protein response	0.0371113071469881	True	"""The series of molecular signals generated as a consequence of the presence of unfolded proteins in the endoplasmic reticulum (ER) or other ER-related stress; results in changes in the regulation of transcription and translation."" [GOC:mah, PMID:12042763]"	74	97	3	17376	0.0309278350515463	0.0405405405405405	query_1	['GO:0007165', 'GO:0034620', 'GO:0034976']	['CDK5RAP3', 'DDRGK1', 'UFL1']
751	REAC	REAC:R-HSA-3371556	Cellular response to heat stress	0.0371257933460325	True	Cellular response to heat stress	87	97	3	17376	0.0309278350515463	0.0344827586206896	query_1	['REAC:R-HSA-2262752']	['HSPA9', 'RPA1', 'HDAC6']
752	GO:BP	GO:0036294	cellular response to decreased oxygen levels	0.0371753298000919	True	"""Any process that results in a change in state or activity of a cell (in terms of movement, secretion, enzyme production, gene expression, etc.) as a result of a stimulus reflecting a decline in the level of oxygen."" [GOC:al]"	142	97	4	17376	0.0412371134020618	0.028169014084507	query_1	['GO:0036293', 'GO:0071453']	['PHB2', 'SDHD', 'PDK3', 'PDK1']
753	REAC	REAC:R-HSA-5655302	Signaling by FGFR1 in disease	0.0373042773368899	True	Signaling by FGFR1 in disease	31	97	2	17376	0.0206185567010309	0.064516129032258	query_1	['REAC:R-HSA-1226099']	['STAT5A', 'STAT5B']
754	GO:CC	GO:0005721	pericentric heterochromatin	0.0374617298084192	True	"""Heterochromatin that is located adjacent to the CENP-A rich centromere 'central core' and characterized by methylated H3 histone at lysine 9 (H3K9me2/H3K9me3)."" [PMID:12019236, PMID:20206496, PMID:21437270, PMID:22729156, PMID:9413993]"	31	97	2	17376	0.0206185567010309	0.064516129032258	query_1	['GO:0000775', 'GO:0000792']	['FLYWCH1', 'CBX5']
755	GO:BP	GO:0071417	cellular response to organonitrogen compound	0.037945311276812	True	"""Any process that results in a change in state or activity of a cell (in terms of movement, secretion, enzyme production, gene expression, etc.) as a result of an organonitrogen stimulus. An organonitrogen compound is formally a compound containing at least one carbon-nitrogen bond."" [GOC:mah]"	628	97	9	17376	0.0927835051546391	0.0143312101910828	query_1	['GO:0010243', 'GO:0071310', 'GO:0071495', 'GO:1901699']	['SNX6', 'PDK4', 'BLM', 'RAD51', 'GPD1', 'BRCA1', 'STAT5A', 'PDK2', 'STAT5B']
756	GO:BP	GO:0033233	regulation of protein sumoylation	0.0382122300590007	True	"""Any process that modulates the frequency, rate or extent of the addition of SUMO groups to a protein."" [GOC:mah]"	25	97	2	17376	0.0206185567010309	0.08	query_1	['GO:0016925', 'GO:1903320']	['UBE2I', 'PIAS1']
757	GO:BP	GO:0010822	positive regulation of mitochondrion organization	0.0382122300590007	True	"""Any process that increases the frequency, rate or extent of a process involved in the formation, arrangement of constituent parts, or disassembly of a mitochondrion."" [GOC:dph, GOC:tb]"	75	97	3	17376	0.0309278350515463	0.04	query_1	['GO:0007005', 'GO:0010638', 'GO:0010821']	['PPIF', 'MCU', 'VDAC1']
758	GO:BP	GO:0019724	B cell mediated immunity	0.0387139900283949	True	"""Any process involved with the carrying out of an immune response by a B cell, through, for instance, the production of antibodies or cytokines, or antigen presentation to T cells."" [GO_REF:0000022, GOC:add, ISBN:0781735149]"	144	97	4	17376	0.0412371134020618	0.0277777777777777	query_1	['GO:0002449', 'GO:0002460']	['NBN', 'TP53BP1', 'PAXIP1', 'HSPD1']
759	GO:BP	GO:0033157	regulation of intracellular protein transport	0.0389657371104266	True	"""Any process that modulates the frequency, rate or extent of the directed movement of proteins within cells."" [GOC:mah]"	226	97	5	17376	0.0515463917525773	0.0221238938053097	query_1	['GO:0006886', 'GO:0032386', 'GO:0051223']	['UBAC2', 'SUMO1', 'TRIM28', 'BARD1', 'UFM1']
760	GO:BP	GO:0046496	nicotinamide nucleotide metabolic process	0.0392528959234851	True	"""The chemical reactions and pathways involving nicotinamide nucleotides, any nucleotide that contains combined nicotinamide."" [ISBN:0198506732]"	76	97	3	17376	0.0309278350515463	0.0394736842105263	query_1	['GO:0019362']	['TALDO1', 'GPD1', 'OGDH']
761	GO:BP	GO:0019362	pyridine nucleotide metabolic process	0.0392528959234851	True	"""The chemical reactions and pathways involving a pyridine nucleotide, a nucleotide characterized by a pyridine derivative as a nitrogen base."" [GOC:jl]"	76	97	3	17376	0.0309278350515463	0.0394736842105263	query_1	['GO:0009117', 'GO:0072524']	['TALDO1', 'GPD1', 'OGDH']
762	GO:BP	GO:0030330	DNA damage response, signal transduction by p53 class mediator	0.0392528959234851	True	"""A cascade of processes induced by the cell cycle regulator phosphoprotein p53, or an equivalent protein, in response to the detection of DNA damage."" [GOC:go_curators]"	76	97	3	17376	0.0309278350515463	0.0394736842105263	query_1	['GO:0042770', 'GO:0072331']	['NBN', 'PAXIP1', 'BRCA2']
763	REAC	REAC:R-HSA-4085377	SUMOylation of SUMOylation proteins	0.0393381961150334	True	SUMOylation of SUMOylation proteins	32	97	2	17376	0.0206185567010309	0.0625	query_1	['REAC:R-HSA-3108232']	['UBE2I', 'SUMO1']
764	GO:BP	GO:0051716	cellular response to stimulus	0.0401483839183177	True	"""Any process that results in a change in state or activity of a cell (in terms of movement, secretion, enzyme production, gene expression, etc.) as a result of a stimulus. The process begins with detection of the stimulus by a cell and ends with a change in state or activity or the cell."" [GOC:bf, GOC:jl]"	6647	97	49	17376	0.5051546391752577	0.0073717466526252	query_1	['GO:0009987', 'GO:0050896']	['PPIF', 'RBBP8', 'SNX6', 'UBE2I', 'PDK4', 'CDK5RAP3', 'NBN', 'HSPA9', 'TP53BP1', 'RAD50', 'UBAC2', 'XRCC6', 'PAXIP1', 'H2AX', 'DDRGK1', 'UFL1', 'MDC1', 'PHB2', 'METTL21C', 'SDHD', 'BRCA2', 'MCU', 'CDNF', 'SUMO1', 'HSPD1', 'RPA1', 'PDK3', 'FLYWCH1', 'BLM', 'PIAS1', 'MRE11', 'VDAC1', 'RAD51', 'HDAC6', 'GPD1', 'PDK1', 'FAF2', 'CBX5', 'BRCA1', 'MICU1', 'STAT5A', 'PDK2', 'TRIM28', 'BARD1', 'ABHD6', 'UBA5', 'PHB1', 'UFM1', 'STAT5B']
765	GO:BP	GO:1904353	regulation of telomere capping	0.0401483839183177	True	"""Any process that modulates the frequency, rate or extent of telomere capping."" [GO_REF:0000058, GOC:BHF, GOC:BHF_telomere, GOC:nc, GOC:TermGenie, PMID:23959892]"	26	97	2	17376	0.0206185567010309	0.0769230769230769	query_1	['GO:0016233', 'GO:0032204']	['NBN', 'RAD50']
766	GO:BP	GO:0039529	RIG-I signaling pathway	0.0401483839183177	True	"""The series of molecular signals initiated by the binding ssRNA or dsRNA from another organism to the cytoplasmic pattern recognition receptor (PRR) RIG-1 (also known as DDX58). RIG-I detects RNA synthesized during viral replication or shed by non-viral pathogens, and triggers a signaling pathway to protect the host against infection, for example by inducing the expression of cytokines."" [GOC:bf, PMID:17328678, PMID:19620789, PMID:21435580, PMID:25579795]"	26	97	2	17376	0.0206185567010309	0.0769230769230769	query_1	['GO:0002753']	['PHB2', 'PHB1']
767	GO:BP	GO:0030163	protein catabolic process	0.0401483839183177	True	"""The chemical reactions and pathways resulting in the breakdown of a protein by the destruction of the native, active configuration, with or without the hydrolysis of peptide bonds."" [GOC:mah]"	992	97	12	17376	0.1237113402061855	0.0120967741935483	query_1	['GO:0009057', 'GO:0019538', 'GO:1901565']	['UBE2I', 'SNX1', 'CDK5RAP3', 'UBAC2', 'DDRGK1', 'UFL1', 'SUMO1', 'PIAS1', 'HDAC6', 'FAF2', 'BARD1', 'PHB1']
768	GO:BP	GO:0071378	cellular response to growth hormone stimulus	0.0401483839183177	True	"""Any process that results in a change in state or activity of a cell (in terms of movement, secretion, enzyme production, gene expression, etc.) as a result of a growth hormone stimulus. Growth hormone is a peptide hormone that binds to the growth hormone receptor and stimulates growth."" [GOC:mah]"	26	97	2	17376	0.0206185567010309	0.0769230769230769	query_1	['GO:0060416', 'GO:0071375']	['STAT5A', 'STAT5B']
769	GO:BP	GO:1904062	regulation of monoatomic cation transmembrane transport	0.0401483839183177	True	"""Any process that modulates the frequency, rate or extent of cation transmembrane transport."" [GO_REF:0000058, GOC:TermGenie, PMID:15304482]"	320	97	6	17376	0.0618556701030927	0.01875	query_1	['GO:0034765', 'GO:0098655']	['PPIF', 'PHB2', 'METTL21C', 'SUMO1', 'VDAC1', 'ISCU']
770	GO:BP	GO:0140374	antiviral innate immune response	0.0401483839183177	True	"""A defense response against viruses mediated through an innate immune response. An innate immune response is mediated by germline encoded components that directly recognize components of potential pathogens."" [PMID:31006531]"	26	97	2	17376	0.0206185567010309	0.0769230769230769	query_1	['GO:0045087', 'GO:0051607']	['PHB2', 'PHB1']
771	GO:BP	GO:0042981	regulation of apoptotic process	0.0401483839183177	True	"""Any process that modulates the occurrence or rate of cell death by apoptotic process."" [GOC:jl, GOC:mtg_apoptosis]"	1376	97	15	17376	0.1546391752577319	0.0109011627906976	query_1	['GO:0006915', 'GO:0043067']	['PPIF', 'SNX6', 'PDK4', 'HSPA9', 'DDRGK1', 'UFL1', 'PHB2', 'HSPD1', 'MRE11', 'VDAC1', 'BRCA1', 'BARD1', 'PHB1', 'UFM1', 'STAT5B']
772	GO:BP	GO:0060396	growth hormone receptor signaling pathway	0.0401483839183177	True	"""The series of molecular signals generated as a consequence of growth hormone receptor binding to its physiological ligand."" [GOC:BHF, GOC:dph, PMID:11445442]"	26	97	2	17376	0.0206185567010309	0.0769230769230769	query_1	['GO:0007169', 'GO:0071378']	['STAT5A', 'STAT5B']
773	GO:BP	GO:0051649	establishment of localization in cell	0.0420240124782123	True	"""Any process, occuring in a cell, that localizes a substance or cellular component. This may occur via movement, tethering or selective degradation."" [GOC:ai, GOC:dos, GOC:dph, GOC:tb]"	2070	97	20	17376	0.2061855670103092	0.0096618357487922	query_1	['GO:0051234', 'GO:0051641']	['PPIF', 'SNX6', 'UBE2I', 'SPG7', 'SNX1', 'MAIP1', 'HSPA9', 'UBAC2', 'PMPCA', 'PHB2', 'SIL1', 'SUMO1', 'HSPD1', 'HDAC6', 'ISCU', 'FAF2', 'TRIM28', 'BARD1', 'PMPCB', 'UFM1']
774	GO:BP	GO:0051051	negative regulation of transport	0.0422413186493357	True	"""Any process that stops, prevents, or reduces the frequency, rate or extent of the directed movement of substances (such as macromolecules, small molecules, ions) into, out of or within a cell, or between cells, by means of some agent such as a transporter or pore."" [GOC:ai]"	425	97	7	17376	0.0721649484536082	0.0164705882352941	query_1	['GO:0006810', 'GO:0048519', 'GO:0051049']	['PPIF', 'UBAC2', 'SUMO1', 'VDAC1', 'ISCU', 'BARD1', 'UFM1']
775	GO:BP	GO:0006633	fatty acid biosynthetic process	0.0422413186493357	True	"""The chemical reactions and pathways resulting in the formation of a fatty acid, any of the aliphatic monocarboxylic acids that can be liberated by hydrolysis from naturally occurring fats and oils. Fatty acids are predominantly straight-chain acids of 4 to 24 carbon atoms, which may be saturated or unsaturated; branched fatty acids and hydroxy fatty acids also occur, and very long chain acids of over 30 carbons are found in waxes."" [GOC:mah, ISBN:0198506732]"	149	97	4	17376	0.0412371134020618	0.0268456375838926	query_1	['GO:0006631', 'GO:0008610', 'GO:0072330']	['PDK4', 'MCAT', 'NDUFAB1', 'BRCA1']
776	GO:BP	GO:0045830	positive regulation of isotype switching	0.0427316110420054	True	"""Any process that activates or increases the frequency, rate or extent of isotype switching."" [GOC:go_curators]"	27	97	2	17376	0.0206185567010309	0.074074074074074	query_1	['GO:0002639', 'GO:0002891', 'GO:0045190', 'GO:0045191', 'GO:0045911', 'GO:0050871', 'GO:0051094']	['TP53BP1', 'PAXIP1']
777	GO:BP	GO:0060765	regulation of androgen receptor signaling pathway	0.0427316110420054	True	"""Any process that modulates the rate, frequency, or extent of the androgen receptor signaling pathway."" [GOC:dph]"	27	97	2	17376	0.0206185567010309	0.074074074074074	query_1	['GO:0030521', 'GO:0033143']	['HDAC6', 'PHB1']
778	GO:BP	GO:0042026	protein refolding	0.0427316110420054	True	"""The process carried out by a cell that restores the biological activity of an unfolded or misfolded protein, using helper proteins such as chaperones."" [GOC:mb]"	27	97	2	17376	0.0206185567010309	0.074074074074074	query_1	['GO:0006457']	['HSPA9', 'HSPD1']
779	GO:BP	GO:0010821	regulation of mitochondrion organization	0.0429023968475619	True	"""Any process that modulates the frequency, rate or extent of a process involved in the formation, arrangement of constituent parts, or disassembly of a mitochondrion."" [GOC:dph, GOC:tb]"	150	97	4	17376	0.0412371134020618	0.0266666666666666	query_1	['GO:0007005', 'GO:0033043']	['PPIF', 'MCU', 'VDAC1', 'HDAC6']
780	REAC	REAC:R-HSA-174417	Telomere C-strand (Lagging Strand) Synthesis	0.0434941598480632	True	Telomere C-strand (Lagging Strand) Synthesis	34	97	2	17376	0.0206185567010309	0.0588235294117647	query_1	['REAC:R-HSA-180786']	['RPA1', 'BLM']
781	REAC	REAC:R-HSA-1266695	Interleukin-7 signaling	0.0434941598480632	True	Interleukin-7 signaling	34	97	2	17376	0.0206185567010309	0.0588235294117647	query_1	['REAC:R-HSA-449147']	['STAT5A', 'STAT5B']
782	GO:BP	GO:0042325	regulation of phosphorylation	0.0437812994134318	True	"""Any process that modulates the frequency, rate or extent of addition of phosphate groups into a molecule."" [GOC:jl]"	1133	97	13	17376	0.134020618556701	0.0114739629302736	query_1	['GO:0016310', 'GO:0019220']	['SNX6', 'CDK5RAP3', 'NBN', 'RAD50', 'XRCC6', 'DDRGK1', 'PHB2', 'BLM', 'MRE11', 'RAD51', 'HDAC6', 'BARD1', 'PHB1']
783	GO:BP	GO:0051090	regulation of DNA-binding transcription factor activity	0.0438223176427927	True	"""Any process that modulates the frequency, rate or extent of the activity of a transcription factor, any factor involved in the initiation or regulation of transcription."" [GOC:ai]"	429	97	7	17376	0.0721649484536082	0.0163170163170163	query_1	['GO:0006355', 'GO:0065009']	['CDK5RAP3', 'TP53BP1', 'PAXIP1', 'DDRGK1', 'UFL1', 'PHB2', 'SUMO1']
784	GO:BP	GO:0030970	retrograde protein transport, ER to cytosol	0.0452753831860765	True	"""The directed movement of unfolded or misfolded proteins from the endoplasmic reticulum to the cytosol through the translocon."" [PMID:11994744]"	28	97	2	17376	0.0206185567010309	0.0714285714285714	query_1	['GO:0032527', 'GO:0036503', 'GO:1903513']	['UBAC2', 'FAF2']
785	GO:BP	GO:0006508	proteolysis	0.0452753831860765	True	"""The hydrolysis of proteins into smaller polypeptides and/or amino acids by cleavage of their peptide bonds."" [GOC:bf, GOC:mah]"	1670	97	17	17376	0.1752577319587628	0.0101796407185628	query_1	['GO:0019538']	['UBE2I', 'SPG7', 'UBAC2', 'DDRGK1', 'UFL1', 'PMPCA', 'SUMO1', 'HSPD1', 'PIAS1', 'AFG3L2', 'HDAC6', 'FAF2', 'BRCA1', 'DLD', 'BARD1', 'PEPD', 'PMPCB']
786	GO:BP	GO:1903513	endoplasmic reticulum to cytosol transport	0.0452753831860765	True	"""The directed movement of substances from endoplasmic reticulum to cytosol."" [GO_REF:0000076, GOC:BHF, GOC:mtg_cardiac_conduct_nov11, GOC:rl, GOC:TermGenie, PMID:16402920]"	28	97	2	17376	0.0206185567010309	0.0714285714285714	query_1	['GO:0046907']	['UBAC2', 'FAF2']
787	GO:BP	GO:0033598	mammary gland epithelial cell proliferation	0.0452753831860765	True	"""The multiplication or reproduction of mammary gland epithelial cells, resulting in the expansion of a cell population. Mammary gland epithelial cells make up the covering of surfaces of the mammary gland. The mammary gland is a large compound sebaceous gland that in female mammals is modified to secrete milk."" [GOC:dph, GOC:mah]"	28	97	2	17376	0.0206185567010309	0.0714285714285714	query_1	['GO:0050673', 'GO:0061180']	['PHB2', 'BRCA2']
788	REAC	REAC:R-HSA-597592	Post-translational protein modification	0.0457392281321986	True	Post-translational protein modification	1338	97	14	17376	0.1443298969072164	0.0104633781763826	query_1	['REAC:R-HSA-392499']	['UBE2I', 'TP53BP1', 'ZNF350', 'MDC1', 'SUMO1', 'RPA1', 'BLM', 'PIAS1', 'VDAC1', 'CBX5', 'BRCA1', 'MBD1', 'TRIM28', 'BARD1']
789	GO:BP	GO:0072524	pyridine-containing compound metabolic process	0.0459494563791663	True	"""The chemical reactions and pathways involving a pyridine-containing compound, i.e. any compound that contains pyridine or a formal derivative thereof."" [GOC:mah]"	82	97	3	17376	0.0309278350515463	0.0365853658536585	query_1	['GO:0034641', 'GO:0046483', 'GO:1901360', 'GO:1901564']	['TALDO1', 'GPD1', 'OGDH']
790	GO:BP	GO:0061034	olfactory bulb mitral cell layer development	0.0459494563791663	True	"""The progression of the olfactory bulb mitral cell layer over time from its initial formation until its mature state. The mitral cell layer is composed of pyramidal neurons whose cell bodies are located between the granule cell layer and the plexiform layer."" [GOC:dph]"	2	97	1	17376	0.0103092783505154	0.5	query_1	['GO:0021772', 'GO:0048856']	['OGDH']
791	GO:BP	GO:0018282	metal incorporation into metallo-sulfur cluster	0.0459494563791663	True	"""The formation of a cluster of several metal atoms, including iron, nickel, molybdenum, vanadium, or copper, with one or more bridging (mu-bond) sulfur atoms; amino acids residues in proteins that may ligate the metal sulfur cluster are cysteine, histidine, aspartate, glutamate, serine and cysteine persulfide."" [GOC:jsg]"	2	97	1	17376	0.0103092783505154	0.5	query_1	['GO:0031163', 'GO:0036211']	['NFS1']
792	GO:BP	GO:0046168	glycerol-3-phosphate catabolic process	0.0459494563791663	True	"""The chemical reactions and pathways resulting in the breakdown of glycerol-3-phosphate, a phosphoric monoester of glycerol."" [GOC:ai]"	2	97	1	17376	0.0103092783505154	0.5	query_1	['GO:0006072', 'GO:0046434', 'GO:1901136']	['GPD1']
793	GO:BP	GO:0018283	iron incorporation into metallo-sulfur cluster	0.0459494563791663	True	"""The incorporation of iron into a metallo-sulfur cluster."" [GOC:ai]"	2	97	1	17376	0.0103092783505154	0.5	query_1	['GO:0016226', 'GO:0018282']	['NFS1']
794	GO:BP	GO:0034514	mitochondrial unfolded protein response	0.0459494563791663	True	"""The series of molecular signals generated as a consequence of the presence of unfolded proteins in the mitochondrial matrix; results in transcriptional upregulation of nuclear genes encoding mitochondrial stress proteins."" [GOC:mah, PMID:17849004]"	2	97	1	17376	0.0103092783505154	0.5	query_1	['GO:0034620']	['HSPD1']
795	GO:BP	GO:1904438	regulation of iron ion import across plasma membrane	0.0459494563791663	True	"""Any process that modulates the frequency, rate or extent of iron ions import across plasma membrane."" [GO_REF:0000058, GOC:BHF, GOC:kom, GOC:TermGenie, PMID:18353247]"	2	97	1	17376	0.0103092783505154	0.5	query_1	['GO:0034759', 'GO:0060341', 'GO:0098711']	['ISCU']
796	GO:BP	GO:1905089	regulation of parkin-mediated stimulation of mitophagy in response to mitochondrial depolarization	0.0459494563791663	True	"""Any process that modulates the frequency, rate or extent of a parkin-mediated process that positively regulates mitophagy in response to mitochondrial depolarization."" [GO_REF:0000058, GOC:pad, GOC:PARL, GOC:TermGenie, PMID:26942284]"	2	97	1	17376	0.0103092783505154	0.5	query_1	['GO:0061734', 'GO:0080135', 'GO:1901524']	['VDAC1']
797	GO:BP	GO:1905552	positive regulation of protein localization to endoplasmic reticulum	0.0459494563791663	True	"""Any process that activates or increases the frequency, rate or extent of protein localization to endoplasmic reticulum."" [GO_REF:0000058, GOC:TermGenie, PMID:22768340]"	2	97	1	17376	0.0103092783505154	0.5	query_1	['GO:0070972', 'GO:1903829', 'GO:1905550']	['DDRGK1']
798	GO:BP	GO:2000276	negative regulation of oxidative phosphorylation uncoupler activity	0.0459494563791663	True	"""Any process that stops, prevents or reduces the frequency, rate or extent of oxidative phosphorylation uncoupler activity."" [GOC:mah]"	2	97	1	17376	0.0103092783505154	0.5	query_1	['GO:0032410', 'GO:1904063', 'GO:2000275']	['PPIF']
799	GO:BP	GO:2000620	positive regulation of histone H4-K16 acetylation	0.0459494563791663	True	"""Any process that activates or increases the frequency, rate or extent of histone H4-K16 acetylation."" [GOC:BHF]"	2	97	1	17376	0.0103092783505154	0.5	query_1	['GO:0043984', 'GO:0090240']	['BRCA1']
800	GO:BP	GO:0006127	glycerophosphate shuttle	0.0459494563791663	True	"""The process of transferring reducing equivalents from the cytosol into the mitochondria; NADH is used to synthesise glycerol 3-phosphate in the cytosol; this compound is then transported into the mitochondria where it is converted to dihydroxyacetone phosphate (DHAP) using FAD; DHAP then returns to the cytosol to complete the cycle."" [GOC:jl, GOC:mtg_electron_transport, ISBN:0716720094, PMID:16368075]"	2	97	1	17376	0.0103092783505154	0.5	query_1	['GO:0006116', 'GO:0006796', 'GO:0019637', 'GO:0022904', 'GO:0034308', 'GO:0042180', 'GO:1901135']	['GPD1']
801	GO:BP	GO:2001311	lysobisphosphatidic acid metabolic process	0.0459494563791663	True	"""The chemical reactions and pathways involving a lysobisphosphatidic acid. A lysobisphosphatidic acid is a lysophosphatidic acid having the unusual property of a phosphodiester moiety linked to positions sn-1 and sn1' of glycerol; and two additional fatty acids esterified to the glycerol head group."" [GOC:mw]"	2	97	1	17376	0.0103092783505154	0.5	query_1	['GO:0006650', 'GO:0052646']	['ABHD6']
802	GO:BP	GO:0090044	positive regulation of tubulin deacetylation	0.0459494563791663	True	"""Any process that increases the frequency, rate or extent of tubulin deacetylation. Tubulin deacetylation is the removal of an acetyl group from a protein amino acid."" [GOC:BHF, GOC:dph, GOC:tb]"	2	97	1	17376	0.0103092783505154	0.5	query_1	['GO:0090042', 'GO:0090043', 'GO:0090312']	['HDAC6']
803	GO:BP	GO:0046544	development of secondary male sexual characteristics	0.0459494563791663	True	"""The process whose specific outcome is the progression of the secondary male sexual characteristics over time, from their formation to the mature structures. In male humans, these include growth of axillary, chest, and pubic hair, voice changes, and testicular/penile enlargement. Development occurs in response to sex hormone secretion."" [GOC:ai]"	2	97	1	17376	0.0103092783505154	0.5	query_1	['GO:0045136', 'GO:0046661']	['STAT5B']
804	GO:BP	GO:0070781	response to biotin	0.0459494563791663	True	"""Any process that results in a change in state or activity of a cell or an organism (in terms of movement, secretion, enzyme production, gene expression, etc.) as a result of a biotin stimulus."" [GOC:sl]"	2	97	1	17376	0.0103092783505154	0.5	query_1	['GO:0010243', 'GO:0014070', 'GO:0033273', 'GO:1901700']	['OTC']
805	GO:BP	GO:0031441	negative regulation of mRNA 3'-end processing	0.0459494563791663	True	"""Any process that stops, prevents, or reduces the frequency, rate or extent of mRNA 3'-end processing."" [GOC:mah]"	2	97	1	17376	0.0103092783505154	0.5	query_1	['GO:0031124', 'GO:0031440', 'GO:0050686']	['BARD1']
806	GO:BP	GO:0110097	regulation of calcium import into the mitochondrion	0.0459494563791663	True	"""Any process that modulates the frequency, rate or extent of calcium import into the mitochondrion."" [GOC:sl, PMID:24085037]"	2	97	1	17376	0.0103092783505154	0.5	query_1	['GO:0036444', 'GO:1903169']	['VDAC1']
807	GO:BP	GO:0042450	arginine biosynthetic process via ornithine	0.0459494563791663	True	"""The chemical reactions and pathways resulting in the formation of arginine (2-amino-5-guanidinopentanoic acid) via the intermediate compound ornithine."" [GOC:jl]"	2	97	1	17376	0.0103092783505154	0.5	query_1	['GO:0006526', 'GO:0006591']	['OTC']
808	REAC	REAC:R-HSA-947581	Molybdenum cofactor biosynthesis	0.0463055986579105	True	Molybdenum cofactor biosynthesis	3	97	1	17376	0.0103092783505154	0.3333333333333333	query_1	['REAC:R-HSA-196849']	['MOCS3']
809	GO:BP	GO:0045935	positive regulation of nucleobase-containing compound metabolic process	0.0463591218921919	True	"""Any cellular process that activates or increases the frequency, rate or extent of the chemical reactions and pathways involving nucleobases, nucleosides, nucleotides and nucleic acids."" [GOC:go_curators]"	1959	97	19	17376	0.1958762886597938	0.0096988259315977	query_1	['GO:0006139', 'GO:0019219', 'GO:0031325', 'GO:0051173']	['RBBP8', 'CDK5RAP3', 'NBN', 'ATF7IP', 'TP53BP1', 'RAD50', 'XRCC6', 'PAXIP1', 'H2AX', 'DDRGK1', 'BRCA2', 'BLM', 'MRE11', 'RAD51', 'BRCA1', 'STAT5A', 'TRIM28', 'PHB1', 'STAT5B']
810	GO:BP	GO:0008053	mitochondrial fusion	0.046448797267518	True	"""Merging of two or more mitochondria within a cell to form a single compartment."" [PMID:11038192, PMID:12052774]"	29	97	2	17376	0.0206185567010309	0.0689655172413793	query_1	['GO:0007005', 'GO:0048284']	['AFG3L2', 'MFN1']
811	GO:BP	GO:0051252	regulation of RNA metabolic process	0.046448797267518	True	"""Any process that modulates the frequency, rate or extent of the chemical reactions and pathways involving RNA."" [GOC:ai]"	3441	97	29	17376	0.2989690721649484	0.008427782621331	query_1	['GO:0016070', 'GO:0019219', 'GO:0060255']	['RBBP8', 'SNX6', 'UBE2I', 'CDK5RAP3', 'ATF7IP', 'TP53BP1', 'ZNF45', 'ZNF350', 'XRCC6', 'PAXIP1', 'SETDB2', 'DDRGK1', 'UFL1', 'PHB2', 'BRCA2', 'SETDB1', 'SUMO1', 'FLYWCH1', 'BLM', 'PIAS1', 'HDAC6', 'CBX5', 'BRCA1', 'STAT5A', 'MBD1', 'TRIM28', 'BARD1', 'PHB1', 'STAT5B']
812	GO:BP	GO:0007202	activation of phospholipase C activity	0.046448797267518	True	"""The initiation of the activity of the inactive enzyme phospolipase C as the result of The series of molecular signals generated as a consequence of a G protein-coupled receptor binding to its physiological ligand."" [GOC:dph, GOC:mah, GOC:tb, PMID:8280098]"	29	97	2	17376	0.0206185567010309	0.0689655172413793	query_1	['GO:0010863']	['PHB2', 'PHB1']
813	GO:BP	GO:0051569	regulation of histone H3-K4 methylation	0.046448797267518	True	"""Any process that modulates the frequency, rate or extent of the covalent addition of a methyl group to the lysine at position 4 of histone H3."" [GOC:ai]"	29	97	2	17376	0.0206185567010309	0.0689655172413793	query_1	['GO:0031060', 'GO:0051568']	['PAXIP1', 'BRCA1']
814	GO:BP	GO:0006355	regulation of DNA-templated transcription	0.0464700759550987	True	"""Any process that modulates the frequency, rate or extent of cellular DNA-templated transcription."" [GOC:go_curators, GOC:txnOH]"	3136	97	27	17376	0.2783505154639175	0.008609693877551	query_1	['GO:0006351', 'GO:0010468', 'GO:1903506']	['RBBP8', 'SNX6', 'UBE2I', 'CDK5RAP3', 'ATF7IP', 'TP53BP1', 'ZNF45', 'ZNF350', 'XRCC6', 'PAXIP1', 'SETDB2', 'DDRGK1', 'UFL1', 'PHB2', 'BRCA2', 'SUMO1', 'FLYWCH1', 'BLM', 'PIAS1', 'HDAC6', 'CBX5', 'BRCA1', 'STAT5A', 'MBD1', 'TRIM28', 'PHB1', 'STAT5B']
815	GO:BP	GO:0032774	RNA biosynthetic process	0.0466561229468336	True	"""The chemical reactions and pathways resulting in the formation of RNA, ribonucleic acid, one of the two main type of nucleic acid, consisting of a long, unbranched macromolecule formed from ribonucleotides joined in 3',5'-phosphodiester linkage. Includes polymerization of ribonucleotide monomers. Refers not only to transcription but also to e.g. viral RNA replication."" [GOC:mah, GOC:txnOH]"	3290	97	28	17376	0.2886597938144329	0.0085106382978723	query_1	['GO:0009059', 'GO:0016070', 'GO:0034654']	['RBBP8', 'SNX6', 'UBE2I', 'CDK5RAP3', 'ATF7IP', 'TP53BP1', 'ZNF45', 'ZNF350', 'XRCC6', 'PAXIP1', 'SETDB2', 'DDRGK1', 'UFL1', 'PHB2', 'BRCA2', 'SETDB1', 'SUMO1', 'FLYWCH1', 'BLM', 'PIAS1', 'HDAC6', 'CBX5', 'BRCA1', 'STAT5A', 'MBD1', 'TRIM28', 'PHB1', 'STAT5B']
816	GO:BP	GO:1903506	regulation of nucleic acid-templated transcription	0.0466929587645041	True	"""Any process that modulates the frequency, rate or extent of nucleic acid-templated transcription."" [GO_REF:0000058, GOC:pr, GOC:TermGenie, GOC:txnOH, GOC:vw]"	3138	97	27	17376	0.2783505154639175	0.008604206500956	query_1	['GO:0097659', 'GO:2001141']	['RBBP8', 'SNX6', 'UBE2I', 'CDK5RAP3', 'ATF7IP', 'TP53BP1', 'ZNF45', 'ZNF350', 'XRCC6', 'PAXIP1', 'SETDB2', 'DDRGK1', 'UFL1', 'PHB2', 'BRCA2', 'SUMO1', 'FLYWCH1', 'BLM', 'PIAS1', 'HDAC6', 'CBX5', 'BRCA1', 'STAT5A', 'MBD1', 'TRIM28', 'PHB1', 'STAT5B']
817	REAC	REAC:R-HSA-9607240	FLT3 Signaling	0.0470455560982428	True	FLT3 Signaling	36	97	2	17376	0.0206185567010309	0.0555555555555555	query_1	['REAC:R-HSA-1280215']	['STAT5A', 'STAT5B']
818	REAC	REAC:R-HSA-5689901	Metalloprotease DUBs	0.0470455560982428	True	Metalloprotease DUBs	36	97	2	17376	0.0206185567010309	0.0555555555555555	query_1	['REAC:R-HSA-5688426']	['BRCA1', 'BARD1']
819	GO:BP	GO:0031325	positive regulation of cellular metabolic process	0.0471653734312216	True	"""Any process that activates or increases the frequency, rate or extent of the chemical reactions and pathways by which individual cells transform chemical substances."" [GOC:mah]"	2839	97	25	17376	0.2577319587628865	0.0088059175766114	query_1	['GO:0009893', 'GO:0031323', 'GO:0044237', 'GO:0048522']	['RBBP8', 'CDK5RAP3', 'NBN', 'ATF7IP', 'TP53BP1', 'RAD50', 'XRCC6', 'PAXIP1', 'H2AX', 'DDRGK1', 'UFL1', 'PHB2', 'BRCA2', 'BLM', 'MRE11', 'VDAC1', 'RAD51', 'HDAC6', 'ISCU', 'GPD1', 'BRCA1', 'STAT5A', 'TRIM28', 'PHB1', 'STAT5B']
820	GO:CC	GO:0043564	Ku70:Ku80 complex	0.047402335746224	True	"""Heterodimeric protein complex composed of a 70 kDa and a 80 kDa subunit, binds DNA through a channel formed by the heterodimer. Functions in DNA double stranded break repair, chromosome maintenance, transcription regulation, V(D)J recombination, and activation of DNA-PK."" [PMID:12518983]"	3	97	1	17376	0.0103092783505154	0.3333333333333333	query_1	['GO:0140513']	['XRCC6']
821	GO:CC	GO:0009331	glycerol-3-phosphate dehydrogenase complex	0.047402335746224	True	"""An enzyme complex that catalyzes the dehydrogenation of sn-glycerol 3-phosphate to form glycerone phosphate."" [PMID:7576488]"	3	97	1	17376	0.0103092783505154	0.3333333333333333	query_1	['GO:0005737', 'GO:1990204']	['GPD1']
822	GO:BP	GO:0071453	cellular response to oxygen levels	0.0478674406613139	True	"""Any process that results in a change in state or activity of a cell (in terms of movement, secretion, enzyme production, gene expression, etc.) as a result of a stimulus reflecting the presence, absence, or concentration of oxygen."" [GOC:mah]"	158	97	4	17376	0.0412371134020618	0.0253164556962025	query_1	['GO:0070482', 'GO:0070887']	['PHB2', 'SDHD', 'PDK3', 'PDK1']
823	GO:BP	GO:0051173	positive regulation of nitrogen compound metabolic process	0.0478674406613139	True	"""Any process that activates or increases the frequency, rate or extent of the chemical reactions and pathways involving nitrogen or nitrogenous compounds."" [GOC:ai, GOC:tb]"	2994	97	26	17376	0.268041237113402	0.0086840347361389	query_1	['GO:0006807', 'GO:0009893', 'GO:0051171']	['RBBP8', 'SNX1', 'CDK5RAP3', 'NBN', 'ATF7IP', 'TP53BP1', 'RAD50', 'XRCC6', 'PAXIP1', 'H2AX', 'DDRGK1', 'PHB2', 'BRCA2', 'SUMO1', 'HSPD1', 'BLM', 'PIAS1', 'MRE11', 'RAD51', 'HDAC6', 'BRCA1', 'STAT5A', 'TRIM28', 'BARD1', 'PHB1', 'STAT5B']
824	GO:BP	GO:0008104	protein localization	0.0478674406613139	True	"""Any process in which a protein is transported to, or maintained in, a specific location."" [GOC:ai]"	2400	97	22	17376	0.2268041237113402	0.0091666666666666	query_1	['GO:0070727']	['SNX6', 'SNX1', 'MAIP1', 'CDK5RAP3', 'HSPA9', 'UBAC2', 'DDRGK1', 'UFL1', 'PMPCA', 'PHB2', 'BRCA2', 'MCU', 'SIL1', 'SUMO1', 'HSPD1', 'RPA1', 'HDAC6', 'FAF2', 'TRIM28', 'BARD1', 'PMPCB', 'UFM1']
825	GO:BP	GO:0035556	intracellular signal transduction	0.0478674406613139	True	"""The process in which a signal is passed on to downstream components within the cell, which become activated themselves to further propagate the signal and finally trigger a change in the function or state of the cell."" [GOC:bf, GOC:jl, GOC:signaling, ISBN:3527303782]"	2546	97	23	17376	0.2371134020618556	0.0090337784760408	query_1	['GO:0007165']	['PPIF', 'RBBP8', 'UBE2I', 'CDK5RAP3', 'NBN', 'TP53BP1', 'RAD50', 'PAXIP1', 'H2AX', 'DDRGK1', 'UFL1', 'MDC1', 'PHB2', 'BRCA2', 'MCU', 'BLM', 'MRE11', 'RAD51', 'PDK1', 'BRCA1', 'PDK2', 'BARD1', 'PHB1']
826	GO:BP	GO:0010941	regulation of cell death	0.0479940999493147	True	"""Any process that modulates the rate or frequency of cell death. Cell death is the specific activation or halting of processes within a cell so that its vital functions markedly cease, rather than simply deteriorating gradually over time, which culminates in cell death."" [GOC:dph, GOC:tb]"	1554	97	16	17376	0.1649484536082474	0.0102960102960102	query_1	['GO:0008219', 'GO:0050794']	['PPIF', 'SNX6', 'PDK4', 'HSPA9', 'DDRGK1', 'UFL1', 'PHB2', 'HSPD1', 'MRE11', 'VDAC1', 'HDAC6', 'BRCA1', 'BARD1', 'PHB1', 'UFM1', 'STAT5B']
827	GO:BP	GO:0001932	regulation of protein phosphorylation	0.0480496942138789	True	"""Any process that modulates the frequency, rate or extent of addition of phosphate groups into an amino acid in a protein."" [GOC:hjd]"	1029	97	12	17376	0.1237113402061855	0.0116618075801749	query_1	['GO:0006468', 'GO:0031399', 'GO:0042325']	['SNX6', 'CDK5RAP3', 'NBN', 'RAD50', 'XRCC6', 'DDRGK1', 'PHB2', 'BLM', 'MRE11', 'RAD51', 'HDAC6', 'PHB1']
828	GO:BP	GO:0006338	chromatin remodeling	0.0482151614907172	True	"""A dynamic process of chromatin reorganization resulting in changes to chromatin structure. These changes allow DNA metabolic processes such as transcriptional regulation, DNA recombination, DNA repair, and DNA replication."" [GOC:jid, GOC:vw, PMID:12042764, PMID:12697820]"	443	97	7	17376	0.0721649484536082	0.0158013544018058	query_1	['GO:0006325']	['ATF7IP', 'SETDB2', 'H2AX', 'SETDB1', 'HDAC6', 'BRCA1', 'TRIM28']
829	GO:BP	GO:1903715	regulation of aerobic respiration	0.0483435359729258	True	"""Any process that modulates the frequency, rate or extent of aerobic respiration."" [GO_REF:0000058, GOC:TermGenie, PMID:19266076]"	30	97	2	17376	0.0206185567010309	0.0666666666666666	query_1	['GO:0009060', 'GO:0043457']	['PPIF', 'ISCU']
830	GO:BP	GO:0061919	process utilizing autophagic mechanism	0.0483435359729258	True	"""A cellular process involving delivery of a portion of the cytoplasm to lysosomes or to the plant or fungal vacuole that does not involve direct transport through the endocytic or vacuolar protein sorting (Vps) pathways. This process typically leads to degradation of the cargo; however, it can also be used to deliver resident proteins, such as in the cytoplasm-to-vacuole targeting (Cvt) pathway."" [PMID:21997368, PMID:22966490, PMID:28596378]"	553	97	8	17376	0.0824742268041237	0.0144665461121157	query_1	['GO:0009987']	['SNX6', 'DDRGK1', 'UFL1', 'PHB2', 'VDAC1', 'HDAC6', 'UBA5', 'UFM1']
831	GO:BP	GO:0006914	autophagy	0.0483435359729258	True	"""The cellular catabolic process in which cells digest parts of their own cytoplasm; allows for both recycling of macromolecular constituents under conditions of cellular stress and remodeling the intracellular structure for cell differentiation."" [GOC:autophagy, ISBN:0198547684, PMID:11099404, PMID:9412464]"	553	97	8	17376	0.0824742268041237	0.0144665461121157	query_1	['GO:0044248', 'GO:0061919']	['SNX6', 'DDRGK1', 'UFL1', 'PHB2', 'VDAC1', 'HDAC6', 'UBA5', 'UFM1']
832	GO:BP	GO:0071840	cellular component organization or biogenesis	0.0483435359729258	True	"""A process that results in the biosynthesis of constituent macromolecules, assembly, arrangement of constituent parts, or disassembly of a cellular component."" [GOC:mah]"	6223	97	46	17376	0.4742268041237113	0.0073919331512132	query_1	['GO:0009987']	['PPIF', 'UBE2I', 'SPG7', 'SNX1', 'LYRM4', 'MAIP1', 'CDK5RAP3', 'NBN', 'ATF7IP', 'HSPA9', 'TP53BP1', 'RAD50', 'XRCC6', 'SETDB2', 'H2AX', 'DDRGK1', 'UFL1', 'PMPCA', 'PHB2', 'BRCA2', 'MCU', 'SETDB1', 'CDNF', 'SUMO1', 'HSPD1', 'RPA1', 'BLM', 'MRE11', 'VDAC1', 'RAD51', 'AFG3L2', 'HDAC6', 'ISCU', 'FAF2', 'NFS1', 'CBX5', 'NDUFAB1', 'BRCA1', 'MICU1', 'TRIM28', 'MFN1', 'PMPCB', 'UBA5', 'GJA10', 'PHB1', 'UFM1']
833	GO:BP	GO:1900101	regulation of endoplasmic reticulum unfolded protein response	0.0483435359729258	True	"""Any process that modulates the frequency, rate or extent of endoplasmic reticulum unfolded protein response."" [GOC:TermGenie]"	30	97	2	17376	0.0206185567010309	0.0666666666666666	query_1	['GO:0009966', 'GO:0030968', 'GO:1905897']	['DDRGK1', 'UFL1']
834	GO:BP	GO:1901699	cellular response to nitrogen compound	0.0483435359729258	True	"""Any process that results in a change in state or activity of a cell (in terms of movement, secretion, enzyme production, gene expression, etc.) as a result of a nitrogen compound stimulus."" [GOC:pr, GOC:TermGenie]"	666	97	9	17376	0.0927835051546391	0.0135135135135135	query_1	['GO:0070887', 'GO:1901698']	['SNX6', 'PDK4', 'BLM', 'RAD51', 'GPD1', 'BRCA1', 'STAT5A', 'PDK2', 'STAT5B']
835	REAC	REAC:R-HSA-77289	Mitochondrial Fatty Acid Beta-Oxidation	0.0491880997214486	True	Mitochondrial Fatty Acid Beta-Oxidation	37	97	2	17376	0.0206185567010309	0.054054054054054	query_1	['REAC:R-HSA-8978868']	['MCAT', 'NDUFAB1']
836	GO:BP	GO:0070727	cellular macromolecule localization	0.0492203116363627	True	"""Any process in which a macromolecule is transported to, and/or maintained in, a specific location at the level of a cell. Localization at the cellular level encompasses movement within the cell, from within the cell to the cell surface, or from one location to another at the surface of a cell."" [GOC:mah]"	2410	97	22	17376	0.2268041237113402	0.0091286307053941	query_1	['GO:0033036', 'GO:0051641']	['SNX6', 'SNX1', 'MAIP1', 'CDK5RAP3', 'HSPA9', 'UBAC2', 'DDRGK1', 'UFL1', 'PMPCA', 'PHB2', 'BRCA2', 'MCU', 'SIL1', 'SUMO1', 'HSPD1', 'RPA1', 'HDAC6', 'FAF2', 'TRIM28', 'BARD1', 'PMPCB', 'UFM1']
837	GO:BP	GO:0019222	regulation of metabolic process	0.0494286888057096	True	"""Any process that modulates the frequency, rate or extent of the chemical reactions and pathways within a cell or an organism."" [GOC:go_curators]"	6232	97	46	17376	0.4742268041237113	0.0073812580231065	query_1	['GO:0008152', 'GO:0050789']	['PPIF', 'RBBP8', 'SNX6', 'UBE2I', 'PDK4', 'SNX1', 'CDK5RAP3', 'NBN', 'ATF7IP', 'TP53BP1', 'RAD50', 'ZNF45', 'ZNF350', 'XRCC6', 'PAXIP1', 'SETDB2', 'H2AX', 'DDRGK1', 'UFL1', 'PHB2', 'BRCA2', 'SETDB1', 'BCKDK', 'SUMO1', 'HSPD1', 'PDK3', 'FLYWCH1', 'BLM', 'PIAS1', 'MRE11', 'VDAC1', 'RAD51', 'HDAC6', 'ISCU', 'GPD1', 'PDK1', 'CBX5', 'BRCA1', 'STAT5A', 'PDK2', 'MBD1', 'TRIM28', 'BARD1', 'ABHD6', 'PHB1', 'STAT5B']
