Transaldolase deficiency	source	native	name	p_value	significant	description	term_size	query_size	intersection_size	effective_domain_size	precision	recall	query	parents	intersections
0	GO:CC	GO:0098798	mitochondrial protein-containing complex	1.4302877153062108e-39	True	"""A protein complex that is part of a mitochondrion."" [GOC:dos]"	309	97	36	22122	0.3711340206185567	0.116504854368932	query_1	['GO:0005739', 'GO:0032991']	['PPIF', 'SPG7', 'LYRM4', 'HSPA9', 'MCUB', 'DLAT', 'PDHA2', 'PDHX', 'PDHB', 'PMPCA', 'PHB2', 'SDHD', 'DBT', 'MCU', 'BCKDK', 'BCKDHB', 'PDHA1', 'VDAC1', 'AFG3L2', 'ISCU', 'PDK1', 'SDHB', 'NFS1', 'NDUFAB1', 'SDHA', 'MICU1', 'SMDT1', 'SDHC', 'DLD', 'PDK2', 'NDUFV3', 'MICU2', 'MFN1', 'PMPCB', 'PHB1', 'BCKDHA']
1	GO:CC	GO:0005759	mitochondrial matrix	6.1396996390077275e-28	True	"""The gel-like material, with considerable fine structure, that lies in the matrix space, or lumen, of a mitochondrion. It contains the enzymes of the tricarboxylic acid cycle and, in some organisms, the enzymes concerned with fatty acid oxidation."" [GOC:as, ISBN:0198506732]"	491	97	33	22122	0.3402061855670103	0.0672097759674134	query_1	['GO:0005739', 'GO:0070013']	['PPIF', 'PDK4', 'GCSH', 'PPM1K', 'LYRM4', 'MAIP1', 'OTC', 'DLST', 'HSPA9', 'DLAT', 'PDHA2', 'PDHX', 'PDHB', 'PMPCA', 'MCAT', 'DBT', 'BCKDK', 'BCKDHB', 'PDHA1', 'HSPD1', 'PDK3', 'VDAC1', 'RAD51', 'ISCU', 'PDK1', 'NFS1', 'NDUFAB1', 'SMDT1', 'DLD', 'PDK2', 'PMPCB', 'OGDH', 'BCKDHA']
2	GO:CC	GO:1990204	oxidoreductase complex	1.263570776608658e-26	True	"""Any protein complex that possesses oxidoreductase activity."" [GOC:bhm, PMID:18982432]"	132	97	22	22122	0.2268041237113402	0.1666666666666666	query_1	['GO:1902494']	['GCSH', 'DLST', 'DLAT', 'PDHA2', 'PDHX', 'PDHB', 'SDHD', 'DBT', 'BCKDK', 'BCKDHB', 'PDHA1', 'GPD1', 'PDK1', 'SDHB', 'NDUFAB1', 'SDHA', 'SDHC', 'DLD', 'PDK2', 'NDUFV3', 'OGDH', 'BCKDHA']
3	GO:CC	GO:0005739	mitochondrion	1.9633117265713976e-25	True	"""A semiautonomous, self replicating organelle that occurs in varying numbers, shapes, and sizes in the cytoplasm of virtually all eukaryotic cells. It is notably the site of tissue respiration."" [GOC:giardia, ISBN:0198506732]"	1710	97	48	22122	0.4948453608247423	0.0280701754385964	query_1	['GO:0005737', 'GO:0043231']	['PPIF', 'PDK4', 'GCSH', 'SPG7', 'PPM1K', 'LYRM4', 'MAIP1', 'OTC', 'DLST', 'HSPA9', 'MCUB', 'DLAT', 'PDHA2', 'PDHX', 'PDHB', 'PMPCA', 'PHB2', 'MCAT', 'SDHD', 'DBT', 'MCU', 'BCKDK', 'BCKDHB', 'PDHA1', 'HSPD1', 'PDK3', 'VDAC1', 'RAD51', 'AFG3L2', 'ISCU', 'PDK1', 'SDHB', 'NFS1', 'NDUFAB1', 'SDHA', 'MICU1', 'SMDT1', 'SDHC', 'DLD', 'PDK2', 'NDUFV3', 'MICU2', 'MFN1', 'ABHD6', 'PMPCB', 'OGDH', 'PHB1', 'BCKDHA']
4	REAC	REAC:R-HSA-71406	Pyruvate metabolism and Citric Acid (TCA) cycle	3.862126149399586e-21	True	Pyruvate metabolism and Citric Acid (TCA) cycle	54	84	17	10790	0.2023809523809523	0.3148148148148148	query_1	['REAC:R-HSA-1428517']	['PDK4', 'DLST', 'DLAT', 'PDHA2', 'PDHX', 'PDHB', 'SDHD', 'PDHA1', 'PDK3', 'VDAC1', 'PDK1', 'SDHB', 'SDHA', 'SDHC', 'DLD', 'PDK2', 'OGDH']
5	REAC	REAC:R-HSA-8949664	Processing of SMDT1	1.565531398701047e-20	True	Processing of SMDT1	16	84	12	10790	0.1428571428571428	0.75	query_1	['REAC:R-HSA-8949215']	['SPG7', 'MAIP1', 'MCUB', 'PMPCA', 'PHB2', 'MCU', 'AFG3L2', 'MICU1', 'SMDT1', 'MICU2', 'PMPCB', 'PHB1']
6	GO:BP	GO:0006086	acetyl-CoA biosynthetic process from pyruvate	6.090375974047532e-20	True	"""The chemical reactions and pathways resulting in the formation of acetyl-CoA from pyruvate."" [GOC:dph, GOC:go_curators, GOC:tb]"	11	96	10	21110	0.1041666666666666	0.9090909090909092	query_1	['GO:0006085', 'GO:0006090']	['PDK4', 'DLAT', 'PDHA2', 'PDHX', 'PDHB', 'PDHA1', 'PDK3', 'PDK1', 'DLD', 'PDK2']
7	REAC	REAC:R-HSA-8949215	Mitochondrial calcium ion transport	6.337611502764733e-20	True	Mitochondrial calcium ion transport	23	84	13	10790	0.1547619047619047	0.5652173913043478	query_1	['REAC:R-HSA-382551']	['SPG7', 'MAIP1', 'MCUB', 'PMPCA', 'PHB2', 'MCU', 'VDAC1', 'AFG3L2', 'MICU1', 'SMDT1', 'MICU2', 'PMPCB', 'PHB1']
8	GO:CC	GO:0031974	membrane-enclosed lumen	1.61827955374175e-18	True	"""The enclosed volume within a sealed membrane or between two sealed membranes. Encompasses the volume enclosed by the membranes of a particular organelle, e.g. endoplasmic reticulum lumen, or the space between the two lipid bilayers of a double membrane surrounding an organelle, e.g. nuclear envelope lumen."" [GOC:add, GOC:mah]"	6635	97	74	22122	0.7628865979381443	0.0111529766390354	query_1	['GO:0110165']	['PPIF', 'RBBP8', 'UBE2I', 'PDK4', 'GCSH', 'PPM1K', 'LYRM4', 'MAIP1', 'CDK5RAP3', 'NBN', 'OTC', 'ATF7IP', 'DLST', 'HSPA9', 'MCUB', 'TP53BP1', 'RAD50', 'ZNF45', 'ZNF350', 'XRCC6', 'PAXIP1', 'DLAT', 'PDHA2', 'PDHX', 'SETDB2', 'PDHB', 'H2AX', 'DDRGK1', 'MDC1', 'PMPCA', 'PHB2', 'MCAT', 'DBT', 'BRCA2', 'SIL1', 'SETDB1', 'BCKDK', 'BCKDHB', 'PDHA1', 'SUMO1', 'HSPD1', 'RPA1', 'PDK3', 'ARL14EP', 'FLYWCH1', 'BLM', 'PIAS1', 'MRE11', 'VDAC1', 'RAD51', 'HDAC6', 'ISCU', 'PDK1', 'SDHB', 'FAF2', 'NFS1', 'CBX5', 'NDUFAB1', 'BRCA1', 'SDHA', 'MICU1', 'STAT5A', 'SMDT1', 'DLD', 'PDK2', 'MBD1', 'TRIM28', 'BARD1', 'MICU2', 'PMPCB', 'OGDH', 'PHB1', 'STAT5B', 'BCKDHA']
9	GO:CC	GO:0070013	intracellular organelle lumen	1.61827955374175e-18	True	"""An organelle lumen that is part of an intracellular organelle."" [GOC:mah]"	6635	97	74	22122	0.7628865979381443	0.0111529766390354	query_1	['GO:0043229', 'GO:0043233']	['PPIF', 'RBBP8', 'UBE2I', 'PDK4', 'GCSH', 'PPM1K', 'LYRM4', 'MAIP1', 'CDK5RAP3', 'NBN', 'OTC', 'ATF7IP', 'DLST', 'HSPA9', 'MCUB', 'TP53BP1', 'RAD50', 'ZNF45', 'ZNF350', 'XRCC6', 'PAXIP1', 'DLAT', 'PDHA2', 'PDHX', 'SETDB2', 'PDHB', 'H2AX', 'DDRGK1', 'MDC1', 'PMPCA', 'PHB2', 'MCAT', 'DBT', 'BRCA2', 'SIL1', 'SETDB1', 'BCKDK', 'BCKDHB', 'PDHA1', 'SUMO1', 'HSPD1', 'RPA1', 'PDK3', 'ARL14EP', 'FLYWCH1', 'BLM', 'PIAS1', 'MRE11', 'VDAC1', 'RAD51', 'HDAC6', 'ISCU', 'PDK1', 'SDHB', 'FAF2', 'NFS1', 'CBX5', 'NDUFAB1', 'BRCA1', 'SDHA', 'MICU1', 'STAT5A', 'SMDT1', 'DLD', 'PDK2', 'MBD1', 'TRIM28', 'BARD1', 'MICU2', 'PMPCB', 'OGDH', 'PHB1', 'STAT5B', 'BCKDHA']
10	GO:CC	GO:0043233	organelle lumen	1.61827955374175e-18	True	"""The internal volume enclosed by the membranes of a particular organelle; includes the volume enclosed by a single organelle membrane, e.g. endoplasmic reticulum lumen, or the volume enclosed by the innermost of the two lipid bilayers of an organelle envelope, e.g. nuclear lumen."" [GOC:jl, GOC:mah]"	6635	97	74	22122	0.7628865979381443	0.0111529766390354	query_1	['GO:0031974', 'GO:0043226']	['PPIF', 'RBBP8', 'UBE2I', 'PDK4', 'GCSH', 'PPM1K', 'LYRM4', 'MAIP1', 'CDK5RAP3', 'NBN', 'OTC', 'ATF7IP', 'DLST', 'HSPA9', 'MCUB', 'TP53BP1', 'RAD50', 'ZNF45', 'ZNF350', 'XRCC6', 'PAXIP1', 'DLAT', 'PDHA2', 'PDHX', 'SETDB2', 'PDHB', 'H2AX', 'DDRGK1', 'MDC1', 'PMPCA', 'PHB2', 'MCAT', 'DBT', 'BRCA2', 'SIL1', 'SETDB1', 'BCKDK', 'BCKDHB', 'PDHA1', 'SUMO1', 'HSPD1', 'RPA1', 'PDK3', 'ARL14EP', 'FLYWCH1', 'BLM', 'PIAS1', 'MRE11', 'VDAC1', 'RAD51', 'HDAC6', 'ISCU', 'PDK1', 'SDHB', 'FAF2', 'NFS1', 'CBX5', 'NDUFAB1', 'BRCA1', 'SDHA', 'MICU1', 'STAT5A', 'SMDT1', 'DLD', 'PDK2', 'MBD1', 'TRIM28', 'BARD1', 'MICU2', 'PMPCB', 'OGDH', 'PHB1', 'STAT5B', 'BCKDHA']
11	REAC	REAC:R-HSA-389661	Glyoxylate metabolism and glycine degradation	1.0877757921655333e-17	True	Glyoxylate metabolism and glycine degradation	31	84	13	10790	0.1547619047619047	0.4193548387096774	query_1	['REAC:R-HSA-71291']	['GCSH', 'DLST', 'DLAT', 'PDHA2', 'PDHX', 'PDHB', 'DBT', 'BCKDHB', 'PDHA1', 'NDUFAB1', 'DLD', 'OGDH', 'BCKDHA']
12	GO:CC	GO:0005967	mitochondrial pyruvate dehydrogenase complex	2.8897554318054986e-17	True	"""Complex that carries out the oxidative decarboxylation of pyruvate to form acetyl-CoA in eukaryotes; includes subunits possessing three catalytic activities: pyruvate dehydrogenase (E1), dihydrolipoamide S-acetyltransferase (E2), and dihydrolipoamide dehydrogenase (E3). The This Eukaryotic form usually contains more subunits than its bacterial counterpart; for example, one known complex contains 30 E1 dimers, 60 E2 monomers, and 6 E3 dimers as well as a few copies of pyruvate dehydrogenase kinase and pyruvate dehydrogenase phosphatase."" [GOC:mtg_sensu, ISBN:0471331309, ISBN:0716720094]"	8	97	8	22122	0.0824742268041237	1.0	query_1	['GO:0005759', 'GO:0045254', 'GO:0098798']	['DLAT', 'PDHA2', 'PDHX', 'PDHB', 'PDHA1', 'PDK1', 'DLD', 'PDK2']
13	GO:CC	GO:0045254	pyruvate dehydrogenase complex	2.8897554318054986e-17	True	"""Complex that carries out the oxidative decarboxylation of pyruvate to form acetyl-CoA; comprises subunits possessing three catalytic activities: pyruvate dehydrogenase (E1), dihydrolipoamide S-acetyltransferase (E2), and dihydrolipoamide dehydrogenase (E3)."" [ISBN:0716720094]"	8	97	8	22122	0.0824742268041237	1.0	query_1	['GO:0005737', 'GO:1990204']	['DLAT', 'PDHA2', 'PDHX', 'PDHB', 'PDHA1', 'PDK1', 'DLD', 'PDK2']
14	GO:CC	GO:0098800	inner mitochondrial membrane protein complex	1.533920280864104e-16	True	"""Any protein complex that is part of the inner mitochondrial membrane."" [GOC:dos]"	163	97	17	22122	0.1752577319587628	0.1042944785276073	query_1	['GO:0005743', 'GO:0098796', 'GO:0098798']	['PPIF', 'SPG7', 'HSPA9', 'MCUB', 'PHB2', 'SDHD', 'MCU', 'AFG3L2', 'SDHB', 'NDUFAB1', 'SDHA', 'MICU1', 'SMDT1', 'SDHC', 'NDUFV3', 'MICU2', 'PHB1']
15	GO:BP	GO:0006085	acetyl-CoA biosynthetic process	2.3606035904746783e-16	True	"""The chemical reactions and pathways resulting in the formation of acetyl-CoA, a derivative of coenzyme A in which the sulfhydryl group is acetylated."" [GOC:go_curators]"	18	96	10	21110	0.1041666666666666	0.5555555555555556	query_1	['GO:0006084', 'GO:0071616']	['PDK4', 'DLAT', 'PDHA2', 'PDHX', 'PDHB', 'PDHA1', 'PDK3', 'PDK1', 'DLD', 'PDK2']
16	GO:CC	GO:1902494	catalytic complex	9.84360022306661e-16	True	"""A protein complex which is capable of catalytic activity."" [GOC:bhm, GOC:TermGenie, PMID:8077207]"	1792	97	39	22122	0.4020618556701031	0.0217633928571428	query_1	['GO:0032991']	['PPIF', 'UBE2I', 'GCSH', 'SPG7', 'LYRM4', 'DLST', 'TP53BP1', 'XRCC6', 'PAXIP1', 'DLAT', 'PDHA2', 'PDHX', 'PDHB', 'PMPCA', 'SDHD', 'DBT', 'BRCA2', 'BCKDK', 'BCKDHB', 'PDHA1', 'BLM', 'RAD51', 'AFG3L2', 'HDAC6', 'GPD1', 'PDK1', 'SDHB', 'CBX5', 'NDUFAB1', 'BRCA1', 'SDHA', 'SDHC', 'DLD', 'PDK2', 'NDUFV3', 'BARD1', 'PMPCB', 'OGDH', 'BCKDHA']
17	REAC	REAC:R-HSA-204174	Regulation of pyruvate dehydrogenase (PDH) complex	1.462815695640896e-15	True	Regulation of pyruvate dehydrogenase (PDH) complex	16	84	10	10790	0.119047619047619	0.625	query_1	['REAC:R-HSA-70268']	['PDK4', 'DLAT', 'PDHA2', 'PDHX', 'PDHB', 'PDHA1', 'PDK3', 'PDK1', 'DLD', 'PDK2']
18	GO:BP	GO:0006084	acetyl-CoA metabolic process	4.040985210294569e-15	True	"""The chemical reactions and pathways involving acetyl-CoA, a derivative of coenzyme A in which the sulfhydryl group is acetylated; it is a metabolite derived from several pathways (e.g. glycolysis, fatty acid oxidation, amino-acid catabolism) and is further metabolized by the tricarboxylic acid cycle. It is a key intermediate in lipid and terpenoid biosynthesis."" [ISBN:0198547684]"	33	96	11	21110	0.1145833333333333	0.3333333333333333	query_1	['GO:0006637']	['PDK4', 'DLST', 'DLAT', 'PDHA2', 'PDHX', 'PDHB', 'PDHA1', 'PDK3', 'PDK1', 'DLD', 'PDK2']
19	KEGG	KEGG:00020	Citrate cycle (TCA cycle)	9.282564857374952e-15	True	Citrate cycle (TCA cycle)	30	63	11	8161	0.1746031746031746	0.3666666666666666	query_1	['KEGG:00000']	['DLST', 'DLAT', 'PDHA2', 'PDHB', 'SDHD', 'PDHA1', 'SDHB', 'SDHA', 'SDHC', 'DLD', 'OGDH']
20	REAC	REAC:R-HSA-1428517	The citric acid (TCA) cycle and respiratory electron transport	2.41910249641518e-14	True	The citric acid (TCA) cycle and respiratory electron transport	177	84	19	10790	0.2261904761904762	0.1073446327683615	query_1	['REAC:R-HSA-1430728']	['PDK4', 'DLST', 'DLAT', 'PDHA2', 'PDHX', 'PDHB', 'SDHD', 'PDHA1', 'PDK3', 'VDAC1', 'PDK1', 'SDHB', 'NDUFAB1', 'SDHA', 'SDHC', 'DLD', 'PDK2', 'NDUFV3', 'OGDH']
21	GO:CC	GO:0031966	mitochondrial membrane	5.6082530921108953e-14	True	"""Either of the lipid bilayers that surround the mitochondrion and form the mitochondrial envelope."" [GOC:mah, NIF_Subcellular:sao1045389829]"	767	97	26	22122	0.268041237113402	0.0338983050847457	query_1	['GO:0005740', 'GO:0031090']	['PPIF', 'SPG7', 'MAIP1', 'OTC', 'HSPA9', 'MCUB', 'PMPCA', 'PHB2', 'SDHD', 'MCU', 'HSPD1', 'VDAC1', 'AFG3L2', 'SDHB', 'NDUFAB1', 'SDHA', 'MICU1', 'SMDT1', 'SDHC', 'NDUFV3', 'MICU2', 'MFN1', 'ABHD6', 'PMPCB', 'OGDH', 'PHB1']
22	REAC	REAC:R-HSA-70268	Pyruvate metabolism	6.318244910597398e-14	True	Pyruvate metabolism	30	84	11	10790	0.1309523809523809	0.3666666666666666	query_1	['REAC:R-HSA-71406']	['PDK4', 'DLAT', 'PDHA2', 'PDHX', 'PDHB', 'PDHA1', 'PDK3', 'VDAC1', 'PDK1', 'DLD', 'PDK2']
23	GO:BP	GO:0006851	mitochondrial calcium ion transmembrane transport	6.337691893293834e-14	True	"""The process in which a calcium ion (Ca2+) is transported across a mitochondrial membrane, into or out of the mitochondrion."" [GOC:ai]"	18	96	9	21110	0.09375	0.5	query_1	['GO:0070588']	['MAIP1', 'MCUB', 'MCU', 'VDAC1', 'AFG3L2', 'MICU1', 'SMDT1', 'MICU2', 'PMPCB']
24	GO:CC	GO:0005743	mitochondrial inner membrane	1.3620330127991405e-13	True	"""The inner, i.e. lumen-facing, lipid bilayer of the mitochondrial envelope. It is highly folded to form cristae."" [GOC:ai]"	513	97	22	22122	0.2268041237113402	0.0428849902534113	query_1	['GO:0019866', 'GO:0031966']	['PPIF', 'SPG7', 'MAIP1', 'OTC', 'HSPA9', 'MCUB', 'PMPCA', 'PHB2', 'SDHD', 'MCU', 'HSPD1', 'AFG3L2', 'SDHB', 'NDUFAB1', 'SDHA', 'MICU1', 'SMDT1', 'SDHC', 'NDUFV3', 'MICU2', 'PMPCB', 'PHB1']
25	GO:BP	GO:0036444	calcium import into the mitochondrion	1.576311779802387e-13	True	"""A process in which a calcium ion (Ca2+) is transported from the cytosol into the mitochondrial matrix."" [GOC:vw]"	12	96	8	21110	0.0833333333333333	0.6666666666666666	query_1	['GO:0006851']	['MAIP1', 'MCUB', 'MCU', 'VDAC1', 'AFG3L2', 'MICU1', 'SMDT1', 'MICU2']
26	GO:CC	GO:0032991	protein-containing complex	1.7243540725031329e-13	True	"""A stable assembly of two or more macromolecules, i.e. proteins, nucleic acids, carbohydrates or lipids, in which at least one component is a protein and the constituent parts function together."" [GOC:dos, GOC:mah]"	7966	97	74	22122	0.7628865979381443	0.0092894802912377	query_1	['GO:0005575']	['PPIF', 'RBBP8', 'SNX6', 'UBE2I', 'GCSH', 'SPG7', 'SNX1', 'LYRM4', 'ADSL', 'CDK5RAP3', 'NBN', 'ATF7IP', 'DLST', 'HSPA9', 'MCUB', 'TP53BP1', 'RAD50', 'ZNF350', 'XRCC6', 'PAXIP1', 'DLAT', 'PDHA2', 'PDHX', 'PDHB', 'H2AX', 'UFL1', 'PMPCA', 'PHB2', 'METTL21C', 'SDHD', 'DBT', 'BRCA2', 'MCU', 'BCKDK', 'BCKDHB', 'PDHA1', 'SUMO1', 'HSPD1', 'RPA1', 'FLYWCH1', 'BLM', 'MRE11', 'VDAC1', 'RAD51', 'AFG3L2', 'HDAC6', 'ISCU', 'GPD1', 'PDK1', 'SDHB', 'FAF2', 'NFS1', 'CBX5', 'NDUFAB1', 'BRCA1', 'SDHA', 'MICU1', 'STAT5A', 'SMDT1', 'SDHC', 'DLD', 'PDK2', 'NDUFV3', 'TRIM28', 'BARD1', 'MICU2', 'MFN1', 'ABHD6', 'PMPCB', 'OGDH', 'GJA10', 'PHB1', 'STAT5B', 'BCKDHA']
27	GO:BP	GO:1901564	organonitrogen compound metabolic process	1.8462367149356472e-13	True	"""The chemical reactions and pathways involving organonitrogen compound."" [GOC:pr, GOC:TermGenie]"	6441	96	69	21110	0.71875	0.0107126222636236	query_1	['GO:0006807', 'GO:0071704']	['PPIF', 'SNX6', 'UBE2I', 'PDK4', 'GCSH', 'SPG7', 'PPM1K', 'SNX1', 'ADSL', 'CDK5RAP3', 'NBN', 'OTC', 'DLST', 'RAD50', 'UBAC2', 'XRCC6', 'TALDO1', 'PAXIP1', 'DLAT', 'PDHA2', 'PDHX', 'SETDB2', 'PDHB', 'DDRGK1', 'UFL1', 'PMPCA', 'PHB2', 'METTL21C', 'SDHD', 'DBT', 'BRCA2', 'SETDB1', 'BCKDK', 'BCKDHB', 'PDHA1', 'SUMO1', 'HSPD1', 'PDK3', 'BLM', 'PIAS1', 'MRE11', 'RAD51', 'AFG3L2', 'HDAC6', 'MOCS3', 'GPD1', 'PDK1', 'SDHB', 'FAF2', 'NFS1', 'NDUFAB1', 'BRCA1', 'SDHA', 'STAT5A', 'SDHC', 'DLD', 'PDK2', 'NDUFV3', 'TRIM28', 'BARD1', 'MFN1', 'PEPD', 'PMPCB', 'UBA5', 'OGDH', 'PHB1', 'UFM1', 'STAT5B', 'BCKDHA']
28	GO:CC	GO:0005740	mitochondrial envelope	2.766545101029246e-13	True	"""The double lipid bilayer enclosing the mitochondrion and separating its contents from the cell cytoplasm; includes the intermembrane space."" [GOC:ai, GOC:pz]"	820	97	26	22122	0.268041237113402	0.0317073170731707	query_1	['GO:0005739', 'GO:0031967']	['PPIF', 'SPG7', 'MAIP1', 'OTC', 'HSPA9', 'MCUB', 'PMPCA', 'PHB2', 'SDHD', 'MCU', 'HSPD1', 'VDAC1', 'AFG3L2', 'SDHB', 'NDUFAB1', 'SDHA', 'MICU1', 'SMDT1', 'SDHC', 'NDUFV3', 'MICU2', 'MFN1', 'ABHD6', 'PMPCB', 'OGDH', 'PHB1']
29	GO:BP	GO:0009152	purine ribonucleotide biosynthetic process	3.5958770245826897e-13	True	"""The chemical reactions and pathways resulting in the formation of a purine ribonucleotide, a compound consisting of ribonucleoside (a purine base linked to a ribose sugar) esterified with a phosphate group at either the 3' or 5'-hydroxyl group of the sugar."" [GOC:go_curators, ISBN:0198506732]"	219	96	17	21110	0.1770833333333333	0.0776255707762557	query_1	['GO:0006164', 'GO:0009150', 'GO:0009260']	['PDK4', 'ADSL', 'DLAT', 'PDHA2', 'PDHX', 'PDHB', 'SDHD', 'PDHA1', 'PDK3', 'PDK1', 'SDHB', 'NDUFAB1', 'SDHA', 'SDHC', 'DLD', 'PDK2', 'NDUFV3']
30	GO:BP	GO:0006163	purine nucleotide metabolic process	3.622090351033444e-13	True	"""The chemical reactions and pathways involving a purine nucleotide, a compound consisting of nucleoside (a purine base linked to a deoxyribose or ribose sugar) esterified with a phosphate group at either the 3' or 5'-hydroxyl group of the sugar."" [GOC:go_curators, ISBN:0198506732]"	469	96	22	21110	0.2291666666666666	0.0469083155650319	query_1	['GO:0009117', 'GO:0072521']	['PDK4', 'ADSL', 'DLST', 'TALDO1', 'DLAT', 'PDHA2', 'PDHX', 'PDHB', 'SDHD', 'PDHA1', 'PDK3', 'GPD1', 'PDK1', 'SDHB', 'NDUFAB1', 'SDHA', 'SDHC', 'DLD', 'PDK2', 'NDUFV3', 'MFN1', 'OGDH']
31	GO:BP	GO:0006082	organic acid metabolic process	5.224140048691693e-13	True	"""The chemical reactions and pathways involving organic acids, any acidic compound containing carbon in covalent linkage."" [ISBN:0198506732]"	979	96	29	21110	0.3020833333333333	0.0296220633299285	query_1	['GO:0044237', 'GO:0044281', 'GO:0071704']	['PDK4', 'GCSH', 'OTC', 'DLST', 'DLAT', 'PDHA2', 'PDHX', 'PDHB', 'MCAT', 'DBT', 'BCKDK', 'BCKDHB', 'PDHA1', 'PDK3', 'VDAC1', 'GPD1', 'PDK1', 'SDHB', 'NDUFAB1', 'BRCA1', 'SDHA', 'STAT5A', 'DLD', 'PDK2', 'ABHD6', 'PEPD', 'OGDH', 'STAT5B', 'BCKDHA']
32	GO:BP	GO:0009150	purine ribonucleotide metabolic process	6.517815068696178e-13	True	"""The chemical reactions and pathways involving a purine ribonucleotide, a compound consisting of ribonucleoside (a purine base linked to a ribose sugar) esterified with a phosphate group at either the 3' or 5'-hydroxyl group of the sugar."" [GOC:go_curators, ISBN:0198506732]"	369	96	20	21110	0.2083333333333333	0.05420054200542	query_1	['GO:0006163', 'GO:0009259']	['PDK4', 'ADSL', 'DLST', 'DLAT', 'PDHA2', 'PDHX', 'PDHB', 'SDHD', 'PDHA1', 'PDK3', 'PDK1', 'SDHB', 'NDUFAB1', 'SDHA', 'SDHC', 'DLD', 'PDK2', 'NDUFV3', 'MFN1', 'OGDH']
33	GO:BP	GO:0006099	tricarboxylic acid cycle	6.665944677654962e-13	True	"""A nearly universal metabolic pathway in which the acetyl group of acetyl coenzyme A is effectively oxidized to two CO2 and four pairs of electrons are transferred to coenzymes. The acetyl group combines with oxaloacetate to form citrate, which undergoes successive transformations to isocitrate, 2-oxoglutarate, succinyl-CoA, succinate, fumarate, malate, and oxaloacetate again, thus completing the cycle. In eukaryotes the tricarboxylic acid is confined to the mitochondria. See also glyoxylate cycle."" [ISBN:0198506732]"	34	96	10	21110	0.1041666666666666	0.2941176470588235	query_1	['GO:0009060', 'GO:0044238']	['DLST', 'DLAT', 'PDHA2', 'PDHB', 'SDHD', 'PDHA1', 'SDHB', 'SDHA', 'SDHC', 'OGDH']
34	GO:BP	GO:0006790	sulfur compound metabolic process	8.293309113199964e-13	True	"""The chemical reactions and pathways involving the nonmetallic element sulfur or compounds that contain sulfur, such as the amino acids methionine and cysteine or the tripeptide glutathione."" [GOC:ai]"	322	96	19	21110	0.1979166666666666	0.0590062111801242	query_1	['GO:0044237']	['PDK4', 'LYRM4', 'DLST', 'HSPA9', 'DLAT', 'PDHA2', 'PDHX', 'PDHB', 'PDHA1', 'PDK3', 'ISCU', 'PDK1', 'NFS1', 'NDUFAB1', 'STAT5A', 'DLD', 'PDK2', 'OGDH', 'STAT5B']
35	GO:CC	GO:0045240	dihydrolipoyl dehydrogenase complex	8.43022347476298e-13	True	"""A protein complex that possesses alpha-ketoglutarate dehydrogenase activity."" [GOC:mah]"	10	97	7	22122	0.0721649484536082	0.7	query_1	['GO:0045239', 'GO:1990204']	['DLST', 'DBT', 'BCKDK', 'BCKDHB', 'DLD', 'OGDH', 'BCKDHA']
36	GO:BP	GO:0009260	ribonucleotide biosynthetic process	1.0201162758933768e-12	True	"""The chemical reactions and pathways resulting in the formation of a ribonucleotide, a compound consisting of ribonucleoside (a base linked to a ribose sugar) esterified with a phosphate group at either the 3' or 5'-hydroxyl group of the sugar."" [GOC:go_curators, ISBN:0198506732]"	233	96	17	21110	0.1770833333333333	0.0729613733905579	query_1	['GO:0009165', 'GO:0009259', 'GO:0046390']	['PDK4', 'ADSL', 'DLAT', 'PDHA2', 'PDHX', 'PDHB', 'SDHD', 'PDHA1', 'PDK3', 'PDK1', 'SDHB', 'NDUFAB1', 'SDHA', 'SDHC', 'DLD', 'PDK2', 'NDUFV3']
37	GO:BP	GO:0072521	purine-containing compound metabolic process	1.318329835406226e-12	True	"""The chemical reactions and pathways involving a purine-containing compound, i.e. any compound that contains purine or a formal derivative thereof."" [GOC:mah]"	499	96	22	21110	0.2291666666666666	0.0440881763527054	query_1	['GO:0006725', 'GO:0034641', 'GO:0046483', 'GO:1901360', 'GO:1901564']	['PDK4', 'ADSL', 'DLST', 'TALDO1', 'DLAT', 'PDHA2', 'PDHX', 'PDHB', 'SDHD', 'PDHA1', 'PDK3', 'GPD1', 'PDK1', 'SDHB', 'NDUFAB1', 'SDHA', 'SDHC', 'DLD', 'PDK2', 'NDUFV3', 'MFN1', 'OGDH']
38	GO:BP	GO:0009060	aerobic respiration	1.3520582697834705e-12	True	"""The enzymatic release of energy from inorganic and organic compounds (especially carbohydrates and fats) which requires oxygen as the terminal electron acceptor."" [GOC:das, GOC:jl, ISBN:0140513590]"	196	96	16	21110	0.1666666666666666	0.0816326530612244	query_1	['GO:0045333']	['PPIF', 'ADSL', 'DLST', 'DLAT', 'PDHA2', 'PDHB', 'SDHD', 'PDHA1', 'ISCU', 'SDHB', 'NDUFAB1', 'SDHA', 'SDHC', 'DLD', 'NDUFV3', 'OGDH']
39	GO:CC	GO:0019866	organelle inner membrane	1.5403445178757273e-12	True	"""The inner, i.e. lumen-facing, lipid bilayer of an organelle envelope; usually highly selective to most ions and metabolites."" [GOC:mah]"	577	97	22	22122	0.2268041237113402	0.0381282495667244	query_1	['GO:0031090', 'GO:0031967']	['PPIF', 'SPG7', 'MAIP1', 'OTC', 'HSPA9', 'MCUB', 'PMPCA', 'PHB2', 'SDHD', 'MCU', 'HSPD1', 'AFG3L2', 'SDHB', 'NDUFAB1', 'SDHA', 'MICU1', 'SMDT1', 'SDHC', 'NDUFV3', 'MICU2', 'PMPCB', 'PHB1']
40	GO:BP	GO:0046390	ribose phosphate biosynthetic process	1.6753083277136125e-12	True	"""The chemical reactions and pathways resulting in the formation of ribose phosphate, any phosphorylated ribose sugar."" [GOC:ai]"	240	96	17	21110	0.1770833333333333	0.0708333333333333	query_1	['GO:0019693', 'GO:0090407', 'GO:1901137']	['PDK4', 'ADSL', 'DLAT', 'PDHA2', 'PDHX', 'PDHB', 'SDHD', 'PDHA1', 'PDK3', 'PDK1', 'SDHB', 'NDUFAB1', 'SDHA', 'SDHC', 'DLD', 'PDK2', 'NDUFV3']
41	GO:CC	GO:0070533	BRCA1-C complex	1.7257215084685765e-12	True	"""A protein complex that contains the BRCA1-BARD1 heterodimer, CtIP and Mre11/Rad50/NBS1 (M/R/N) complex, and binds to DNA at DNA damage sites. BRCA1-C binding ta damaged DNA is required for DNA damage-induced Chk1 phosphorylation and the G2/M transition checkpoint."" [GOC:mah, PMID:15485915, PMID:16391231]"	6	97	6	22122	0.0618556701030927	1.0	query_1	['GO:0140513']	['RBBP8', 'NBN', 'RAD50', 'MRE11', 'BRCA1', 'BARD1']
42	GO:BP	GO:0009259	ribonucleotide metabolic process	1.7956123808383397e-12	True	"""The chemical reactions and pathways involving a ribonucleotide, a compound consisting of ribonucleoside (a base linked to a ribose sugar) esterified with a phosphate group at either the 3' or 5'-hydroxyl group of the sugar."" [GOC:go_curators, ISBN:0198506732]"	389	96	20	21110	0.2083333333333333	0.0514138817480719	query_1	['GO:0009117', 'GO:0019693']	['PDK4', 'ADSL', 'DLST', 'DLAT', 'PDHA2', 'PDHX', 'PDHB', 'SDHD', 'PDHA1', 'PDK3', 'PDK1', 'SDHB', 'NDUFAB1', 'SDHA', 'SDHC', 'DLD', 'PDK2', 'NDUFV3', 'MFN1', 'OGDH']
43	WP	WP:WP4016	DNA IR-damage and cellular response via ATR	1.8175428789448932e-12	True	DNA IR-damage and cellular response via ATR	81	60	13	8133	0.2166666666666666	0.1604938271604938	query_1	['WP:000000']	['RBBP8', 'NBN', 'TP53BP1', 'RAD50', 'H2AX', 'MDC1', 'BRCA2', 'RPA1', 'MRE11', 'RAD51', 'BRCA1', 'TRIM28', 'BARD1']
44	GO:BP	GO:0045333	cellular respiration	2.2087988735002555e-12	True	"""The enzymatic release of energy from inorganic and organic compounds (especially carbohydrates and fats) which either requires oxygen (aerobic respiration) or does not (anaerobic respiration)."" [GOC:das, ISBN:0140513590, ISBN:0198506732]"	244	96	17	21110	0.1770833333333333	0.0696721311475409	query_1	['GO:0015980']	['PPIF', 'ADSL', 'DLST', 'DLAT', 'PDHA2', 'PDHB', 'SDHD', 'PDHA1', 'ISCU', 'GPD1', 'SDHB', 'NDUFAB1', 'SDHA', 'SDHC', 'DLD', 'NDUFV3', 'OGDH']
45	GO:BP	GO:0019693	ribose phosphate metabolic process	2.7811107131858386e-12	True	"""The chemical reactions and pathways involving ribose phosphate, any phosphorylated ribose sugar."" [GOC:ai]"	398	96	20	21110	0.2083333333333333	0.050251256281407	query_1	['GO:0006796', 'GO:0019637', 'GO:1901135']	['PDK4', 'ADSL', 'DLST', 'DLAT', 'PDHA2', 'PDHX', 'PDHB', 'SDHD', 'PDHA1', 'PDK3', 'PDK1', 'SDHB', 'NDUFAB1', 'SDHA', 'SDHC', 'DLD', 'PDK2', 'NDUFV3', 'MFN1', 'OGDH']
46	GO:BP	GO:0033554	cellular response to stress	3.1178298044938507e-12	True	"""Any process that results in a change in state or activity of a cell (in terms of movement, secretion, enzyme production, gene expression, etc.) as a result of a stimulus indicating the organism is under stress. The stress is usually, but not necessarily, exogenous (e.g. temperature, humidity, ionizing radiation)."" [GOC:mah]"	1949	96	38	21110	0.3958333333333333	0.0194971780400205	query_1	['GO:0006950', 'GO:0051716']	['PPIF', 'RBBP8', 'PDK4', 'CDK5RAP3', 'NBN', 'HSPA9', 'TP53BP1', 'RAD50', 'UBAC2', 'XRCC6', 'PAXIP1', 'H2AX', 'DDRGK1', 'UFL1', 'MDC1', 'PHB2', 'SDHD', 'BRCA2', 'SUMO1', 'HSPD1', 'RPA1', 'PDK3', 'FLYWCH1', 'BLM', 'MRE11', 'VDAC1', 'RAD51', 'HDAC6', 'PDK1', 'FAF2', 'CBX5', 'BRCA1', 'MICU1', 'PDK2', 'TRIM28', 'BARD1', 'UBA5', 'UFM1']
47	REAC	REAC:R-HSA-5693532	DNA Double-Strand Break Repair	3.4297291494800848e-12	True	DNA Double-Strand Break Repair	168	84	17	10790	0.2023809523809523	0.1011904761904761	query_1	['REAC:R-HSA-73894']	['RBBP8', 'UBE2I', 'NBN', 'TP53BP1', 'RAD50', 'XRCC6', 'PAXIP1', 'H2AX', 'MDC1', 'BRCA2', 'SUMO1', 'RPA1', 'BLM', 'MRE11', 'RAD51', 'BRCA1', 'BARD1']
48	GO:BP	GO:0009117	nucleotide metabolic process	4.245780212068433e-12	True	"""The chemical reactions and pathways involving a nucleotide, a nucleoside that is esterified with (ortho)phosphate or an oligophosphate at any hydroxyl group on the glycose moiety; may be mono-, di- or triphosphate; this definition includes cyclic nucleotides (nucleoside cyclic phosphates)."" [GOC:ma]"	528	96	22	21110	0.2291666666666666	0.0416666666666666	query_1	['GO:0006753']	['PDK4', 'ADSL', 'DLST', 'TALDO1', 'DLAT', 'PDHA2', 'PDHX', 'PDHB', 'SDHD', 'PDHA1', 'PDK3', 'GPD1', 'PDK1', 'SDHB', 'NDUFAB1', 'SDHA', 'SDHC', 'DLD', 'PDK2', 'NDUFV3', 'MFN1', 'OGDH']
49	GO:BP	GO:0006753	nucleoside phosphate metabolic process	6.494785435394217e-12	True	"""The chemical reactions and pathways involving any phosphorylated nucleoside."" [GOC:mah]"	539	96	22	21110	0.2291666666666666	0.0408163265306122	query_1	['GO:0006796', 'GO:0019637', 'GO:0055086']	['PDK4', 'ADSL', 'DLST', 'TALDO1', 'DLAT', 'PDHA2', 'PDHX', 'PDHB', 'SDHD', 'PDHA1', 'PDK3', 'GPD1', 'PDK1', 'SDHB', 'NDUFAB1', 'SDHA', 'SDHC', 'DLD', 'PDK2', 'NDUFV3', 'MFN1', 'OGDH']
50	GO:MF	GO:0034603	pyruvate dehydrogenase [NAD(P)+] activity	7.497157358986878e-12	True	"""Catalysis of the reaction: pyruvate + CoA + NAD(P)+ = acetyl-CoA + CO2 + NAD(P)H."" [GOC:mah]"	6	97	6	20195	0.0618556701030927	1.0	query_1	['GO:0004738', 'GO:0016620']	['DLAT', 'PDHA2', 'PDHX', 'PDHB', 'PDHA1', 'DLD']
51	GO:MF	GO:0034604	pyruvate dehydrogenase (NAD+) activity	7.497157358986878e-12	True	"""Catalysis of the reaction: pyruvate + CoA + NAD+ = acetyl-CoA + CO2 + NADH."" [GOC:mah, ISBN:0201090910]"	6	97	6	20195	0.0618556701030927	1.0	query_1	['GO:0034603']	['DLAT', 'PDHA2', 'PDHX', 'PDHB', 'PDHA1', 'DLD']
52	GO:MF	GO:0004738	pyruvate dehydrogenase activity	7.497157358986878e-12	True	"""Catalysis of the oxidative decarboxylation of pyruvate."" [ISBN:0716720094]"	6	97	6	20195	0.0618556701030927	1.0	query_1	['GO:0016903']	['DLAT', 'PDHA2', 'PDHX', 'PDHB', 'PDHA1', 'DLD']
53	GO:BP	GO:0006164	purine nucleotide biosynthetic process	9.893259946302557e-12	True	"""The chemical reactions and pathways resulting in the formation of a purine nucleotide, a compound consisting of nucleoside (a purine base linked to a deoxyribose or ribose sugar) esterified with a phosphate group at either the 3' or 5'-hydroxyl group of the sugar."" [GOC:go_curators, ISBN:0198506732]"	267	96	17	21110	0.1770833333333333	0.0636704119850187	query_1	['GO:0006163', 'GO:0009165', 'GO:0072522']	['PDK4', 'ADSL', 'DLAT', 'PDHA2', 'PDHX', 'PDHB', 'SDHD', 'PDHA1', 'PDK3', 'PDK1', 'SDHB', 'NDUFAB1', 'SDHA', 'SDHC', 'DLD', 'PDK2', 'NDUFV3']
54	GO:BP	GO:0006090	pyruvate metabolic process	1.0873590598651368e-11	True	"""The chemical reactions and pathways involving pyruvate, 2-oxopropanoate."" [GOC:go_curators]"	114	96	13	21110	0.1354166666666666	0.1140350877192982	query_1	['GO:0032787']	['PDK4', 'DLAT', 'PDHA2', 'PDHX', 'PDHB', 'PDHA1', 'PDK3', 'VDAC1', 'GPD1', 'PDK1', 'DLD', 'PDK2', 'OGDH']
55	GO:BP	GO:0072522	purine-containing compound biosynthetic process	1.7125905241253163e-11	True	"""The chemical reactions and pathways resulting in the formation of a purine-containing compound, i.e. any compound that contains purine or a formal derivative thereof."" [GOC:mah]"	276	96	17	21110	0.1770833333333333	0.0615942028985507	query_1	['GO:0018130', 'GO:0019438', 'GO:0044271', 'GO:0072521', 'GO:1901362', 'GO:1901566']	['PDK4', 'ADSL', 'DLAT', 'PDHA2', 'PDHX', 'PDHB', 'SDHD', 'PDHA1', 'PDK3', 'PDK1', 'SDHB', 'NDUFAB1', 'SDHA', 'SDHC', 'DLD', 'PDK2', 'NDUFV3']
56	WP	WP:WP3959	DNA IR-double strand breaks and cellular response via ATM	1.8375983364648763e-11	True	DNA IR-double strand breaks and cellular response via ATM	55	60	11	8133	0.1833333333333333	0.2	query_1	['WP:000000']	['NBN', 'TP53BP1', 'RAD50', 'H2AX', 'MDC1', 'BRCA2', 'BLM', 'MRE11', 'RAD51', 'BRCA1', 'TRIM28']
57	GO:BP	GO:0019752	carboxylic acid metabolic process	2.0167206861291188e-11	True	"""The chemical reactions and pathways involving carboxylic acids, any organic acid containing one or more carboxyl (COOH) groups or anions (COO-)."" [ISBN:0198506732]"	951	96	27	21110	0.28125	0.028391167192429	query_1	['GO:0043436']	['PDK4', 'GCSH', 'OTC', 'DLST', 'DLAT', 'PDHA2', 'PDHX', 'PDHB', 'MCAT', 'DBT', 'BCKDK', 'BCKDHB', 'PDHA1', 'PDK3', 'VDAC1', 'GPD1', 'PDK1', 'SDHB', 'NDUFAB1', 'BRCA1', 'SDHA', 'DLD', 'PDK2', 'ABHD6', 'PEPD', 'OGDH', 'BCKDHA']
58	GO:BP	GO:0071616	acyl-CoA biosynthetic process	2.5082305959396213e-11	True	"""The chemical reactions and pathways resulting in the formation of acyl-CoA, any derivative of coenzyme A in which the sulfhydryl group is in thiolester linkage with an acyl group."" [GOC:cjk]"	47	96	10	21110	0.1041666666666666	0.2127659574468085	query_1	['GO:0006637', 'GO:0009152', 'GO:0034030', 'GO:0034033', 'GO:0035384', 'GO:0043604']	['PDK4', 'DLAT', 'PDHA2', 'PDHX', 'PDHB', 'PDHA1', 'PDK3', 'PDK1', 'DLD', 'PDK2']
59	GO:BP	GO:0035384	thioester biosynthetic process	2.5082305959396213e-11	True	"""The chemical reactions and pathways resulting in the formation of a thioester, a compound of general formula RC(=O)SR' in which the linking oxygen in an ester is replaced by a sulfur atom. They are the product of esterification between a carboxylic acid and a thiol."" [GOC:bf, http://encyclopedia.thefreedictionary.com/Thioester]"	47	96	10	21110	0.1041666666666666	0.2127659574468085	query_1	['GO:0035383', 'GO:0044272', 'GO:1901576']	['PDK4', 'DLAT', 'PDHA2', 'PDHX', 'PDHB', 'PDHA1', 'PDK3', 'PDK1', 'DLD', 'PDK2']
60	KEGG	KEGG:03440	Homologous recombination	2.7250699328317597e-11	True	Homologous recombination	41	63	10	8161	0.1587301587301587	0.2439024390243902	query_1	['KEGG:00000']	['RBBP8', 'NBN', 'RAD50', 'BRCA2', 'RPA1', 'BLM', 'MRE11', 'RAD51', 'BRCA1', 'BARD1']
61	GO:CC	GO:0031967	organelle envelope	2.856974463690456e-11	True	"""A double membrane structure enclosing an organelle, including two lipid bilayers and the region between them. In some cases, an organelle envelope may have more than two membranes."" [GOC:mah, GOC:pz]"	1285	97	29	22122	0.2989690721649484	0.022568093385214	query_1	['GO:0031975', 'GO:0043227', 'GO:0043229']	['PPIF', 'UBE2I', 'SPG7', 'MAIP1', 'OTC', 'HSPA9', 'MCUB', 'PMPCA', 'PHB2', 'SDHD', 'MCU', 'SUMO1', 'HSPD1', 'VDAC1', 'AFG3L2', 'SDHB', 'CBX5', 'NDUFAB1', 'SDHA', 'MICU1', 'SMDT1', 'SDHC', 'NDUFV3', 'MICU2', 'MFN1', 'ABHD6', 'PMPCB', 'OGDH', 'PHB1']
62	GO:CC	GO:0031975	envelope	2.856974463690456e-11	True	"""A multilayered structure surrounding all or part of a cell; encompasses one or more lipid bilayers, and may include a cell wall layer; also includes the space between layers."" [GOC:mah, GOC:pz]"	1285	97	29	22122	0.2989690721649484	0.022568093385214	query_1	['GO:0110165']	['PPIF', 'UBE2I', 'SPG7', 'MAIP1', 'OTC', 'HSPA9', 'MCUB', 'PMPCA', 'PHB2', 'SDHD', 'MCU', 'SUMO1', 'HSPD1', 'VDAC1', 'AFG3L2', 'SDHB', 'CBX5', 'NDUFAB1', 'SDHA', 'MICU1', 'SMDT1', 'SDHC', 'NDUFV3', 'MICU2', 'MFN1', 'ABHD6', 'PMPCB', 'OGDH', 'PHB1']
63	REAC	REAC:R-HSA-9709570	Impaired BRCA2 binding to RAD51	2.977206224145019e-11	True	Impaired BRCA2 binding to RAD51	35	84	10	10790	0.119047619047619	0.2857142857142857	query_1	['REAC:R-HSA-9701190']	['RBBP8', 'NBN', 'RAD50', 'BRCA2', 'RPA1', 'BLM', 'MRE11', 'RAD51', 'BRCA1', 'BARD1']
64	REAC	REAC:R-HSA-9709603	Impaired BRCA2 binding to PALB2	3.2441359561321296e-11	True	Impaired BRCA2 binding to PALB2	24	84	9	10790	0.1071428571428571	0.375	query_1	['REAC:R-HSA-9701190']	['RBBP8', 'NBN', 'RAD50', 'BRCA2', 'BLM', 'MRE11', 'RAD51', 'BRCA1', 'BARD1']
65	GO:BP	GO:0043436	oxoacid metabolic process	3.5083388060663094e-11	True	"""The chemical reactions and pathways involving any oxoacid; an oxoacid is a compound which contains oxygen, at least one other element, and at least one hydrogen bound to oxygen, and which produces a conjugate base by loss of positive hydrogen ion(s) (hydrons)."" [Wikipedia:Oxyacid]"	973	96	27	21110	0.28125	0.0277492291880781	query_1	['GO:0006082']	['PDK4', 'GCSH', 'OTC', 'DLST', 'DLAT', 'PDHA2', 'PDHX', 'PDHB', 'MCAT', 'DBT', 'BCKDK', 'BCKDHB', 'PDHA1', 'PDK3', 'VDAC1', 'GPD1', 'PDK1', 'SDHB', 'NDUFAB1', 'BRCA1', 'SDHA', 'DLD', 'PDK2', 'ABHD6', 'PEPD', 'OGDH', 'BCKDHA']
66	GO:BP	GO:0006637	acyl-CoA metabolic process	3.673293141135213e-11	True	"""The chemical reactions and pathways involving acyl-CoA, any derivative of coenzyme A in which the sulfhydryl group is in thiolester linkage with an acyl group."" [ISBN:0198506732]"	95	96	12	21110	0.125	0.1263157894736842	query_1	['GO:0009150', 'GO:0033875', 'GO:0034032', 'GO:0035383', 'GO:0043603']	['PDK4', 'DLST', 'DLAT', 'PDHA2', 'PDHX', 'PDHB', 'PDHA1', 'PDK3', 'PDK1', 'DLD', 'PDK2', 'OGDH']
67	GO:BP	GO:0035383	thioester metabolic process	3.673293141135213e-11	True	"""The chemical reactions and pathways involving a thioester, a compound of general formula RC(=O)SR' in which the linking oxygen in an ester is replaced by a sulfur atom. They are the product of esterification between a carboxylic acid and a thiol."" [GOC:bf, Wikipedia:Thioester]"	95	96	12	21110	0.125	0.1263157894736842	query_1	['GO:0006790', 'GO:0071704']	['PDK4', 'DLST', 'DLAT', 'PDHA2', 'PDHX', 'PDHB', 'PDHA1', 'PDK3', 'PDK1', 'DLD', 'PDK2', 'OGDH']
68	REAC	REAC:R-HSA-9701193	Defective homologous recombination repair (HRR) due to PALB2 loss of function	5.0372160120371177e-11	True	Defective homologous recombination repair (HRR) due to PALB2 loss of function	25	84	9	10790	0.1071428571428571	0.36	query_1	['REAC:R-HSA-9675136']	['RBBP8', 'NBN', 'RAD50', 'BRCA2', 'BLM', 'MRE11', 'RAD51', 'BRCA1', 'BARD1']
69	REAC	REAC:R-HSA-9701192	Defective homologous recombination repair (HRR) due to BRCA1 loss of function	5.0372160120371177e-11	True	Defective homologous recombination repair (HRR) due to BRCA1 loss of function	25	84	9	10790	0.1071428571428571	0.36	query_1	['REAC:R-HSA-9675136']	['RBBP8', 'NBN', 'RAD50', 'BRCA2', 'BLM', 'MRE11', 'RAD51', 'BRCA1', 'BARD1']
70	REAC	REAC:R-HSA-9704646	Defective HDR through Homologous Recombination Repair (HRR) due to PALB2 loss of BRCA2/RAD51/RAD51C binding function	5.0372160120371177e-11	True	Defective HDR through Homologous Recombination Repair (HRR) due to PALB2 loss of BRCA2/RAD51/RAD51C binding function	25	84	9	10790	0.1071428571428571	0.36	query_1	['REAC:R-HSA-9701193']	['RBBP8', 'NBN', 'RAD50', 'BRCA2', 'BLM', 'MRE11', 'RAD51', 'BRCA1', 'BARD1']
71	REAC	REAC:R-HSA-9704331	Defective HDR through Homologous Recombination Repair (HRR) due to PALB2 loss of BRCA1 binding function	5.0372160120371177e-11	True	Defective HDR through Homologous Recombination Repair (HRR) due to PALB2 loss of BRCA1 binding function	25	84	9	10790	0.1071428571428571	0.36	query_1	['REAC:R-HSA-9701193']	['RBBP8', 'NBN', 'RAD50', 'BRCA2', 'BLM', 'MRE11', 'RAD51', 'BRCA1', 'BARD1']
72	GO:BP	GO:0055086	nucleobase-containing small molecule metabolic process	7.131396042138815e-11	True	"""The cellular chemical reactions and pathways involving a nucleobase-containing small molecule: a nucleobase, a nucleoside, or a nucleotide."" [GOC:vw]"	606	96	22	21110	0.2291666666666666	0.0363036303630363	query_1	['GO:0006139', 'GO:0044281']	['PDK4', 'ADSL', 'DLST', 'TALDO1', 'DLAT', 'PDHA2', 'PDHX', 'PDHB', 'SDHD', 'PDHA1', 'PDK3', 'GPD1', 'PDK1', 'SDHB', 'NDUFAB1', 'SDHA', 'SDHC', 'DLD', 'PDK2', 'NDUFV3', 'MFN1', 'OGDH']
73	GO:BP	GO:0009165	nucleotide biosynthetic process	7.136572083566337e-11	True	"""The chemical reactions and pathways resulting in the formation of nucleotides, any nucleoside that is esterified with (ortho)phosphate or an oligophosphate at any hydroxyl group on the glycose moiety; may be mono-, di- or triphosphate; this definition includes cyclic-nucleotides (nucleoside cyclic phosphates)."" [GOC:go_curators]"	301	96	17	21110	0.1770833333333333	0.0564784053156146	query_1	['GO:0009117', 'GO:1901293']	['PDK4', 'ADSL', 'DLAT', 'PDHA2', 'PDHX', 'PDHB', 'SDHD', 'PDHA1', 'PDK3', 'PDK1', 'SDHB', 'NDUFAB1', 'SDHA', 'SDHC', 'DLD', 'PDK2', 'NDUFV3']
74	GO:BP	GO:1901293	nucleoside phosphate biosynthetic process	8.395741381891686e-11	True	"""The chemical reactions and pathways resulting in the formation of a nucleoside phosphate."" [GOC:TermGenie]"	304	96	17	21110	0.1770833333333333	0.0559210526315789	query_1	['GO:0006753', 'GO:0034654', 'GO:0090407']	['PDK4', 'ADSL', 'DLAT', 'PDHA2', 'PDHX', 'PDHB', 'SDHD', 'PDHA1', 'PDK3', 'PDK1', 'SDHB', 'NDUFAB1', 'SDHA', 'SDHC', 'DLD', 'PDK2', 'NDUFV3']
75	REAC	REAC:R-HSA-5693554	Resolution of D-loop Structures through Synthesis-Dependent Strand Annealing (SDSA)	1.1411667428466729e-10	True	Resolution of D-loop Structures through Synthesis-Dependent Strand Annealing (SDSA)	27	84	9	10790	0.1071428571428571	0.3333333333333333	query_1	['REAC:R-HSA-5693537']	['RBBP8', 'NBN', 'RAD50', 'BRCA2', 'BLM', 'MRE11', 'RAD51', 'BRCA1', 'BARD1']
76	REAC	REAC:R-HSA-5693616	Presynaptic phase of homologous DNA pairing and strand exchange	1.3322987743133378e-10	True	Presynaptic phase of homologous DNA pairing and strand exchange	40	84	10	10790	0.119047619047619	0.25	query_1	['REAC:R-HSA-5693579']	['RBBP8', 'NBN', 'RAD50', 'BRCA2', 'RPA1', 'BLM', 'MRE11', 'RAD51', 'BRCA1', 'BARD1']
77	GO:CC	GO:0045239	tricarboxylic acid cycle enzyme complex	1.3325671517066208e-10	True	"""Any of the heteromeric enzymes that act in the TCA cycle."" [GOC:mah]"	17	97	7	22122	0.0721649484536082	0.4117647058823529	query_1	['GO:0005737', 'GO:1902494']	['DLST', 'DBT', 'BCKDK', 'BCKDHB', 'DLD', 'OGDH', 'BCKDHA']
78	HPA	HPA:0600432	tonsil; germinal center cells[≥Medium]	1.5425462595763626e-10	True	tonsil; germinal center cells[≥Medium]	4094	83	63	11006	0.7590361445783133	0.0153883732291157	query_1	['HPA:0600431']	['RBBP8', 'PDK4', 'GCSH', 'PPM1K', 'LYRM4', 'ADSL', 'NBN', 'ATF7IP', 'DLST', 'HSPA9', 'MCUB', 'TP53BP1', 'RAD50', 'XRCC6', 'PAXIP1', 'DLAT', 'PDHX', 'SETDB2', 'PDHB', 'H2AX', 'DDRGK1', 'PMPCA', 'PHB2', 'SDHD', 'MCU', 'SIL1', 'BCKDK', 'SUMO1', 'HSPD1', 'RPA1', 'ARL14EP', 'FLYWCH1', 'BLM', 'PIAS1', 'MRE11', 'VDAC1', 'RAD51', 'AFG3L2', 'HDAC6', 'ISCU', 'GPD1', 'NSUN6', 'SDHB', 'NFS1', 'CBX5', 'NDUFAB1', 'BRCA1', 'SDHA', 'MICU1', 'STAT5A', 'DLD', 'PDK2', 'NDUFV3', 'TRIM28', 'BARD1', 'PEPD', 'PMPCB', 'UBA5', 'OGDH', 'PHB1', 'UFM1', 'STAT5B', 'BCKDHA']
79	REAC	REAC:R-HSA-9675136	Diseases of DNA Double-Strand Break Repair	1.7510658334110698e-10	True	Diseases of DNA Double-Strand Break Repair	41	84	10	10790	0.119047619047619	0.2439024390243902	query_1	['REAC:R-HSA-9675135']	['RBBP8', 'NBN', 'RAD50', 'BRCA2', 'RPA1', 'BLM', 'MRE11', 'RAD51', 'BRCA1', 'BARD1']
80	REAC	REAC:R-HSA-9701190	Defective homologous recombination repair (HRR) due to BRCA2 loss of function	1.7510658334110698e-10	True	Defective homologous recombination repair (HRR) due to BRCA2 loss of function	41	84	10	10790	0.119047619047619	0.2439024390243902	query_1	['REAC:R-HSA-9675136']	['RBBP8', 'NBN', 'RAD50', 'BRCA2', 'RPA1', 'BLM', 'MRE11', 'RAD51', 'BRCA1', 'BARD1']
81	HPA	HPA:0540052	stomach 1; glandular cells[≥Medium]	1.805902653249837e-10	True	stomach 1; glandular cells[≥Medium]	6342	83	77	11006	0.927710843373494	0.0121412803532008	query_1	['HPA:0540051']	['RBBP8', 'SNX6', 'UBE2I', 'PDK4', 'GCSH', 'PPM1K', 'SNX1', 'LYRM4', 'ADSL', 'MAIP1', 'CDK5RAP3', 'NBN', 'ATF7IP', 'DLST', 'HSPA9', 'MCUB', 'TP53BP1', 'RAD50', 'UBAC2', 'XRCC6', 'PAXIP1', 'PDHX', 'SETDB2', 'PDHB', 'H2AX', 'DDRGK1', 'UFL1', 'MDC1', 'PMPCA', 'PHB2', 'MCAT', 'SDHD', 'DBT', 'MCU', 'SIL1', 'BCKDK', 'BCKDHB', 'PDHA1', 'SUMO1', 'HSPD1', 'RPA1', 'ARL14EP', 'FLYWCH1', 'BLM', 'PIAS1', 'MRE11', 'VDAC1', 'AFG3L2', 'HDAC6', 'ISCU', 'GPD1', 'PDK1', 'NSUN6', 'SDHB', 'FAF2', 'NFS1', 'CBX5', 'NDUFAB1', 'BRCA1', 'SDHA', 'MICU1', 'DLD', 'PDK2', 'MBD1', 'NDUFV3', 'TRIM28', 'BARD1', 'MICU2', 'MFN1', 'PEPD', 'PMPCB', 'UBA5', 'OGDH', 'PHB1', 'UFM1', 'STAT5B', 'BCKDHA']
82	GO:BP	GO:0044281	small molecule metabolic process	2.0358373949638457e-10	True	"""The chemical reactions and pathways involving small molecules, any low molecular weight, monomeric, non-encoded molecule."" [GOC:curators, GOC:pde, GOC:vw]"	1865	96	35	21110	0.3645833333333333	0.0187667560321715	query_1	['GO:0008152']	['PDK4', 'GCSH', 'ADSL', 'OTC', 'DLST', 'TALDO1', 'DLAT', 'PDHA2', 'PDHX', 'PDHB', 'MCAT', 'SDHD', 'DBT', 'BCKDK', 'BCKDHB', 'PDHA1', 'PDK3', 'VDAC1', 'GPD1', 'PDK1', 'SDHB', 'NDUFAB1', 'BRCA1', 'SDHA', 'STAT5A', 'SDHC', 'DLD', 'PDK2', 'NDUFV3', 'MFN1', 'ABHD6', 'PEPD', 'OGDH', 'STAT5B', 'BCKDHA']
83	KEGG	KEGG:01200	Carbon metabolism	2.0640176738497562e-10	True	Carbon metabolism	115	63	13	8161	0.2063492063492063	0.1130434782608695	query_1	['KEGG:00000']	['GCSH', 'DLST', 'TALDO1', 'DLAT', 'PDHA2', 'PDHB', 'SDHD', 'PDHA1', 'SDHB', 'SDHA', 'SDHC', 'DLD', 'OGDH']
84	GO:BP	GO:0033866	nucleoside bisphosphate biosynthetic process	2.4263677808331285e-10	True	"""The chemical reactions and pathways resulting in the formation of a nucleoside bisphosphate, a compound consisting of a nucleobase linked to a deoxyribose or ribose sugar esterified with one phosphate group attached to each of two different hydroxyl groups on the sugar."" [GOC:mah, GOC:pde]"	58	96	10	21110	0.1041666666666666	0.1724137931034483	query_1	['GO:0033865', 'GO:1901293']	['PDK4', 'DLAT', 'PDHA2', 'PDHX', 'PDHB', 'PDHA1', 'PDK3', 'PDK1', 'DLD', 'PDK2']
85	GO:BP	GO:0034030	ribonucleoside bisphosphate biosynthetic process	2.4263677808331285e-10	True	"""The chemical reactions and pathways resulting in the formation of a ribonucleoside bisphosphate, a compound consisting of a nucleobase linked to a ribose sugar esterified with one phosphate group attached to each of two different hydroxyl groups on the sugar."" [GOC:mah, GOC:pde]"	58	96	10	21110	0.1041666666666666	0.1724137931034483	query_1	['GO:0033866', 'GO:0033875']	['PDK4', 'DLAT', 'PDHA2', 'PDHX', 'PDHB', 'PDHA1', 'PDK3', 'PDK1', 'DLD', 'PDK2']
86	GO:BP	GO:0034033	purine nucleoside bisphosphate biosynthetic process	2.4263677808331285e-10	True	"""The chemical reactions and pathways resulting in the formation of a purine nucleoside bisphosphate, a compound consisting of a purine base linked to a deoxyribose or ribose sugar esterified with one phosphate group attached to each of two different hydroxyl groups on the sugar."" [GOC:mah, GOC:pde]"	58	96	10	21110	0.1041666666666666	0.1724137931034483	query_1	['GO:0033866', 'GO:0034032', 'GO:0072522']	['PDK4', 'DLAT', 'PDHA2', 'PDHX', 'PDHB', 'PDHA1', 'PDK3', 'PDK1', 'DLD', 'PDK2']
87	HPA	HPA:0360052	parathyroid gland; glandular cells[≥Medium]	2.6910022800752965e-10	True	parathyroid gland; glandular cells[≥Medium]	4410	83	65	11006	0.7831325301204819	0.0147392290249433	query_1	['HPA:0360051']	['PDK4', 'GCSH', 'PPM1K', 'SNX1', 'LYRM4', 'ADSL', 'MAIP1', 'CDK5RAP3', 'ATF7IP', 'DLST', 'HSPA9', 'TP53BP1', 'RAD50', 'XRCC6', 'PAXIP1', 'DLAT', 'PDHX', 'SETDB2', 'PDHB', 'H2AX', 'DDRGK1', 'UFL1', 'MDC1', 'PMPCA', 'PHB2', 'MCAT', 'DBT', 'MCU', 'SIL1', 'PDHA1', 'SUMO1', 'HSPD1', 'RPA1', 'ARL14EP', 'FLYWCH1', 'BLM', 'PIAS1', 'MRE11', 'VDAC1', 'AFG3L2', 'HDAC6', 'ISCU', 'GPD1', 'PDK1', 'NSUN6', 'SDHB', 'FAF2', 'NFS1', 'CBX5', 'NDUFAB1', 'SDHA', 'MICU1', 'DLD', 'PDK2', 'MBD1', 'NDUFV3', 'TRIM28', 'MICU2', 'MFN1', 'PMPCB', 'UBA5', 'OGDH', 'PHB1', 'UFM1', 'BCKDHA']
88	REAC	REAC:R-HSA-5693579	Homologous DNA Pairing and Strand Exchange	2.9574227877343216e-10	True	Homologous DNA Pairing and Strand Exchange	43	84	10	10790	0.119047619047619	0.2325581395348837	query_1	['REAC:R-HSA-5685942']	['RBBP8', 'NBN', 'RAD50', 'BRCA2', 'RPA1', 'BLM', 'MRE11', 'RAD51', 'BRCA1', 'BARD1']
89	REAC	REAC:R-HSA-5362517	Signaling by Retinoic Acid	2.9574227877343216e-10	True	Signaling by Retinoic Acid	43	84	10	10790	0.119047619047619	0.2325581395348837	query_1	['REAC:R-HSA-9006931']	['PDK4', 'DLAT', 'PDHA2', 'PDHX', 'PDHB', 'PDHA1', 'PDK3', 'PDK1', 'DLD', 'PDK2']
90	GO:BP	GO:0006091	generation of precursor metabolites and energy	3.431132053590673e-10	True	"""The chemical reactions and pathways resulting in the formation of precursor metabolites, substances from which energy is derived, and any process involved in the liberation of energy from these substances."" [GOC:jl]"	449	96	19	21110	0.1979166666666666	0.042316258351893	query_1	['GO:0044237']	['PPIF', 'ADSL', 'DLST', 'TALDO1', 'DLAT', 'PDHA2', 'PDHB', 'PHB2', 'SDHD', 'PDHA1', 'ISCU', 'GPD1', 'SDHB', 'NDUFAB1', 'SDHA', 'SDHC', 'DLD', 'NDUFV3', 'OGDH']
91	GO:BP	GO:0019637	organophosphate metabolic process	4.2065498201336076e-10	True	"""The chemical reactions and pathways involving organophosphates, any phosphate-containing organic compound."" [ISBN:0198506732]"	989	96	26	21110	0.2708333333333333	0.0262891809908999	query_1	['GO:0006793', 'GO:0071704']	['PDK4', 'ADSL', 'DLST', 'TALDO1', 'DLAT', 'PDHA2', 'PDHX', 'PDHB', 'PHB2', 'SDHD', 'PDHA1', 'PDK3', 'MOCS3', 'GPD1', 'PDK1', 'SDHB', 'NFS1', 'NDUFAB1', 'SDHA', 'SDHC', 'DLD', 'PDK2', 'NDUFV3', 'MFN1', 'ABHD6', 'OGDH']
92	GO:BP	GO:0015980	energy derivation by oxidation of organic compounds	4.289409910259815e-10	True	"""The chemical reactions and pathways by which a cell derives energy from organic compounds; results in the oxidation of the compounds from which energy is released."" [GOC:mah]"	336	96	17	21110	0.1770833333333333	0.050595238095238	query_1	['GO:0006091']	['PPIF', 'ADSL', 'DLST', 'DLAT', 'PDHA2', 'PDHB', 'SDHD', 'PDHA1', 'ISCU', 'GPD1', 'SDHB', 'NDUFAB1', 'SDHA', 'SDHC', 'DLD', 'NDUFV3', 'OGDH']
93	GO:BP	GO:0110025	DNA strand resection involved in replication fork processing	4.995075414731743e-10	True	"""The 5' to 3' exonucleolytic resection of DNA at the site of a stalled replication fork that contributes to replication fork processing."" [GOC:mah, PMID:28475874]"	8	96	6	21110	0.0625	0.75	query_1	['GO:0006259', 'GO:0031297']	['RBBP8', 'NBN', 'RAD50', 'MRE11', 'BRCA1', 'BARD1']
94	REAC	REAC:R-HSA-5693567	HDR through Homologous Recombination (HRR) or Single Strand Annealing (SSA)	5.171639327753066e-10	True	HDR through Homologous Recombination (HRR) or Single Strand Annealing (SSA)	132	84	14	10790	0.1666666666666666	0.106060606060606	query_1	['REAC:R-HSA-5693538']	['RBBP8', 'UBE2I', 'NBN', 'TP53BP1', 'RAD50', 'H2AX', 'MDC1', 'BRCA2', 'RPA1', 'BLM', 'MRE11', 'RAD51', 'BRCA1', 'BARD1']
95	GO:MF	GO:0016624	oxidoreductase activity, acting on the aldehyde or oxo group of donors, disulfide as acceptor	6.224904254832847e-10	True	"""Catalysis of an oxidation-reduction (redox) reaction in which an aldehyde or ketone (oxo) group acts as a hydrogen or electron donor and reduces a disulfide."" [GOC:jl]"	9	97	6	20195	0.0618556701030927	0.6666666666666666	query_1	['GO:0016903']	['PDHA2', 'PDHB', 'BCKDHB', 'PDHA1', 'OGDH', 'BCKDHA']
96	HPA	HPA:0360000	parathyroid gland	6.337687813970405e-10	True	parathyroid gland	5891	83	74	11006	0.891566265060241	0.0125615345442199	query_1	['HPA:0000000']	['RBBP8', 'PDK4', 'GCSH', 'PPM1K', 'SNX1', 'LYRM4', 'ADSL', 'MAIP1', 'CDK5RAP3', 'NBN', 'ATF7IP', 'DLST', 'HSPA9', 'MCUB', 'TP53BP1', 'RAD50', 'UBAC2', 'XRCC6', 'PAXIP1', 'DLAT', 'PDHX', 'SETDB2', 'PDHB', 'H2AX', 'DDRGK1', 'UFL1', 'MDC1', 'PMPCA', 'PHB2', 'MCAT', 'SDHD', 'DBT', 'MCU', 'SIL1', 'BCKDHB', 'PDHA1', 'SUMO1', 'HSPD1', 'RPA1', 'ARL14EP', 'FLYWCH1', 'BLM', 'PIAS1', 'MRE11', 'VDAC1', 'RAD51', 'AFG3L2', 'HDAC6', 'ISCU', 'GPD1', 'PDK1', 'NSUN6', 'SDHB', 'FAF2', 'NFS1', 'CBX5', 'NDUFAB1', 'SDHA', 'MICU1', 'DLD', 'PDK2', 'MBD1', 'NDUFV3', 'TRIM28', 'BARD1', 'MICU2', 'MFN1', 'PEPD', 'PMPCB', 'UBA5', 'OGDH', 'PHB1', 'UFM1', 'BCKDHA']
97	HPA	HPA:0360051	parathyroid gland; glandular cells[≥Low]	6.337687813970405e-10	True	parathyroid gland; glandular cells[≥Low]	5891	83	74	11006	0.891566265060241	0.0125615345442199	query_1	['HPA:0360000']	['RBBP8', 'PDK4', 'GCSH', 'PPM1K', 'SNX1', 'LYRM4', 'ADSL', 'MAIP1', 'CDK5RAP3', 'NBN', 'ATF7IP', 'DLST', 'HSPA9', 'MCUB', 'TP53BP1', 'RAD50', 'UBAC2', 'XRCC6', 'PAXIP1', 'DLAT', 'PDHX', 'SETDB2', 'PDHB', 'H2AX', 'DDRGK1', 'UFL1', 'MDC1', 'PMPCA', 'PHB2', 'MCAT', 'SDHD', 'DBT', 'MCU', 'SIL1', 'BCKDHB', 'PDHA1', 'SUMO1', 'HSPD1', 'RPA1', 'ARL14EP', 'FLYWCH1', 'BLM', 'PIAS1', 'MRE11', 'VDAC1', 'RAD51', 'AFG3L2', 'HDAC6', 'ISCU', 'GPD1', 'PDK1', 'NSUN6', 'SDHB', 'FAF2', 'NFS1', 'CBX5', 'NDUFAB1', 'SDHA', 'MICU1', 'DLD', 'PDK2', 'MBD1', 'NDUFV3', 'TRIM28', 'BARD1', 'MICU2', 'MFN1', 'PEPD', 'PMPCB', 'UBA5', 'OGDH', 'PHB1', 'UFM1', 'BCKDHA']
98	HPA	HPA:0390000	prostate	6.799880934003807e-10	True	prostate	6671	83	78	11006	0.9397590361445785	0.0116923999400389	query_1	['HPA:0000000']	['RBBP8', 'SNX6', 'UBE2I', 'PDK4', 'GCSH', 'PPM1K', 'SNX1', 'LYRM4', 'ADSL', 'MAIP1', 'CDK5RAP3', 'NBN', 'ATF7IP', 'DLST', 'HSPA9', 'MCUB', 'TP53BP1', 'RAD50', 'XRCC6', 'PAXIP1', 'DLAT', 'PDHX', 'SETDB2', 'PDHB', 'H2AX', 'DDRGK1', 'UFL1', 'MDC1', 'PMPCA', 'PHB2', 'MCAT', 'SDHD', 'DBT', 'MCU', 'SIL1', 'BCKDK', 'BCKDHB', 'PDHA1', 'SUMO1', 'HSPD1', 'RPA1', 'PDK3', 'ARL14EP', 'FLYWCH1', 'BLM', 'PIAS1', 'MRE11', 'VDAC1', 'AFG3L2', 'HDAC6', 'ISCU', 'GPD1', 'PDK1', 'NSUN6', 'SDHB', 'FAF2', 'NFS1', 'CBX5', 'NDUFAB1', 'BRCA1', 'SDHA', 'MICU1', 'DLD', 'PDK2', 'MBD1', 'NDUFV3', 'TRIM28', 'BARD1', 'MICU2', 'MFN1', 'PEPD', 'PMPCB', 'UBA5', 'OGDH', 'PHB1', 'UFM1', 'STAT5B', 'BCKDHA']
99	HPA	HPA:0390051	prostate; glandular cells[≥Low]	6.799880934003807e-10	True	prostate; glandular cells[≥Low]	6671	83	78	11006	0.9397590361445785	0.0116923999400389	query_1	['HPA:0390000']	['RBBP8', 'SNX6', 'UBE2I', 'PDK4', 'GCSH', 'PPM1K', 'SNX1', 'LYRM4', 'ADSL', 'MAIP1', 'CDK5RAP3', 'NBN', 'ATF7IP', 'DLST', 'HSPA9', 'MCUB', 'TP53BP1', 'RAD50', 'XRCC6', 'PAXIP1', 'DLAT', 'PDHX', 'SETDB2', 'PDHB', 'H2AX', 'DDRGK1', 'UFL1', 'MDC1', 'PMPCA', 'PHB2', 'MCAT', 'SDHD', 'DBT', 'MCU', 'SIL1', 'BCKDK', 'BCKDHB', 'PDHA1', 'SUMO1', 'HSPD1', 'RPA1', 'PDK3', 'ARL14EP', 'FLYWCH1', 'BLM', 'PIAS1', 'MRE11', 'VDAC1', 'AFG3L2', 'HDAC6', 'ISCU', 'GPD1', 'PDK1', 'NSUN6', 'SDHB', 'FAF2', 'NFS1', 'CBX5', 'NDUFAB1', 'BRCA1', 'SDHA', 'MICU1', 'DLD', 'PDK2', 'MBD1', 'NDUFV3', 'TRIM28', 'BARD1', 'MICU2', 'MFN1', 'PEPD', 'PMPCB', 'UBA5', 'OGDH', 'PHB1', 'UFM1', 'STAT5B', 'BCKDHA']
100	HPA	HPA:0190000	esophagus	6.872648018497934e-10	True	esophagus	6672	83	78	11006	0.9397590361445785	0.0116906474820143	query_1	['HPA:0000000']	['RBBP8', 'SNX6', 'UBE2I', 'PDK4', 'GCSH', 'PPM1K', 'SNX1', 'LYRM4', 'ADSL', 'CDK5RAP3', 'NBN', 'ATF7IP', 'DLST', 'HSPA9', 'MCUB', 'TP53BP1', 'RAD50', 'UBAC2', 'XRCC6', 'PAXIP1', 'DLAT', 'PDHX', 'SETDB2', 'PDHB', 'H2AX', 'DDRGK1', 'UFL1', 'MDC1', 'PMPCA', 'PHB2', 'MCAT', 'SDHD', 'DBT', 'MCU', 'SIL1', 'BCKDK', 'BCKDHB', 'PDHA1', 'SUMO1', 'HSPD1', 'RPA1', 'PDK3', 'ARL14EP', 'FLYWCH1', 'BLM', 'PIAS1', 'MRE11', 'VDAC1', 'RAD51', 'AFG3L2', 'HDAC6', 'ISCU', 'GPD1', 'PDK1', 'NSUN6', 'SDHB', 'FAF2', 'NFS1', 'CBX5', 'NDUFAB1', 'BRCA1', 'SDHA', 'MICU1', 'DLD', 'PDK2', 'MBD1', 'NDUFV3', 'TRIM28', 'MICU2', 'MFN1', 'PEPD', 'PMPCB', 'UBA5', 'OGDH', 'PHB1', 'UFM1', 'STAT5B', 'BCKDHA']
101	HPA	HPA:0190221	esophagus; squamous epithelial cells[≥Low]	6.872648018497934e-10	True	esophagus; squamous epithelial cells[≥Low]	6672	83	78	11006	0.9397590361445785	0.0116906474820143	query_1	['HPA:0190000']	['RBBP8', 'SNX6', 'UBE2I', 'PDK4', 'GCSH', 'PPM1K', 'SNX1', 'LYRM4', 'ADSL', 'CDK5RAP3', 'NBN', 'ATF7IP', 'DLST', 'HSPA9', 'MCUB', 'TP53BP1', 'RAD50', 'UBAC2', 'XRCC6', 'PAXIP1', 'DLAT', 'PDHX', 'SETDB2', 'PDHB', 'H2AX', 'DDRGK1', 'UFL1', 'MDC1', 'PMPCA', 'PHB2', 'MCAT', 'SDHD', 'DBT', 'MCU', 'SIL1', 'BCKDK', 'BCKDHB', 'PDHA1', 'SUMO1', 'HSPD1', 'RPA1', 'PDK3', 'ARL14EP', 'FLYWCH1', 'BLM', 'PIAS1', 'MRE11', 'VDAC1', 'RAD51', 'AFG3L2', 'HDAC6', 'ISCU', 'GPD1', 'PDK1', 'NSUN6', 'SDHB', 'FAF2', 'NFS1', 'CBX5', 'NDUFAB1', 'BRCA1', 'SDHA', 'MICU1', 'DLD', 'PDK2', 'MBD1', 'NDUFV3', 'TRIM28', 'MICU2', 'MFN1', 'PEPD', 'PMPCB', 'UBA5', 'OGDH', 'PHB1', 'UFM1', 'STAT5B', 'BCKDHA']
102	GO:BP	GO:0034032	purine nucleoside bisphosphate metabolic process	7.896215083215266e-10	True	"""The chemical reactions and pathways involving a purine nucleoside bisphosphate, a compound consisting of a purine base linked to a deoxyribose or ribose sugar esterified with one phosphate group attached to each of two different hydroxyl groups on the sugar."" [GOC:mah, GOC:pde]"	122	96	12	21110	0.125	0.0983606557377049	query_1	['GO:0033865', 'GO:0072521']	['PDK4', 'DLST', 'DLAT', 'PDHA2', 'PDHX', 'PDHB', 'PDHA1', 'PDK3', 'PDK1', 'DLD', 'PDK2', 'OGDH']
103	GO:BP	GO:0033875	ribonucleoside bisphosphate metabolic process	7.896215083215266e-10	True	"""The chemical reactions and pathways involving a ribonucleoside bisphosphate, a compound consisting of a nucleobase linked to a ribose sugar esterified with one phosphate group attached to each of two different hydroxyl groups on the sugar."" [GOC:mah, GOC:pde]"	122	96	12	21110	0.125	0.0983606557377049	query_1	['GO:0033865']	['PDK4', 'DLST', 'DLAT', 'PDHA2', 'PDHX', 'PDHB', 'PDHA1', 'PDK3', 'PDK1', 'DLD', 'PDK2', 'OGDH']
104	GO:BP	GO:0033865	nucleoside bisphosphate metabolic process	7.896215083215266e-10	True	"""The chemical reactions and pathways involving a nucleoside bisphosphate, a compound consisting of a nucleobase linked to a deoxyribose or ribose sugar esterified with one phosphate group attached to each of two different hydroxyl groups on the sugar."" [GOC:mah, GOC:pde]"	122	96	12	21110	0.125	0.0983606557377049	query_1	['GO:0006753']	['PDK4', 'DLST', 'DLAT', 'PDHA2', 'PDHX', 'PDHB', 'PDHA1', 'PDK3', 'PDK1', 'DLD', 'PDK2', 'OGDH']
105	REAC	REAC:R-HSA-5693538	Homology Directed Repair	9.591752016117096e-10	True	Homology Directed Repair	138	84	14	10790	0.1666666666666666	0.1014492753623188	query_1	['REAC:R-HSA-5693532']	['RBBP8', 'UBE2I', 'NBN', 'TP53BP1', 'RAD50', 'H2AX', 'MDC1', 'BRCA2', 'RPA1', 'BLM', 'MRE11', 'RAD51', 'BRCA1', 'BARD1']
106	GO:MF	GO:0016903	oxidoreductase activity, acting on the aldehyde or oxo group of donors	1.165973006150435e-09	True	"""Catalysis of an oxidation-reduction (redox) reaction in which an aldehyde or ketone (oxo) group acts as a hydrogen or electron donor and reduces a hydrogen or electron acceptor."" [GOC:ai]"	49	97	9	20195	0.0927835051546391	0.1836734693877551	query_1	['GO:0016491']	['DLAT', 'PDHA2', 'PDHX', 'PDHB', 'BCKDHB', 'PDHA1', 'DLD', 'OGDH', 'BCKDHA']
107	REAC	REAC:R-HSA-5693568	Resolution of D-loop Structures through Holliday Junction Intermediates	1.2221501469792483e-09	True	Resolution of D-loop Structures through Holliday Junction Intermediates	34	84	9	10790	0.1071428571428571	0.2647058823529412	query_1	['REAC:R-HSA-5693537']	['RBBP8', 'NBN', 'RAD50', 'BRCA2', 'BLM', 'MRE11', 'RAD51', 'BRCA1', 'BARD1']
108	CORUM	CORUM:5197	PTIP-DNA damage response complex	1.3704447040373647e-09	True	PTIP-DNA damage response complex	6	47	6	3383	0.1276595744680851	1.0	query_1	['CORUM:0000000']	['NBN', 'TP53BP1', 'RAD50', 'PAXIP1', 'BLM', 'MRE11']
109	REAC	REAC:R-HSA-9675135	Diseases of DNA repair	1.516454871463406e-09	True	Diseases of DNA repair	50	84	10	10790	0.119047619047619	0.2	query_1	['REAC:R-HSA-1643685']	['RBBP8', 'NBN', 'RAD50', 'BRCA2', 'RPA1', 'BLM', 'MRE11', 'RAD51', 'BRCA1', 'BARD1']
110	GO:BP	GO:0031297	replication fork processing	1.5946776203200416e-09	True	"""The process in which a DNA replication fork that has stalled is restored to a functional state and replication is restarted. The stalling may be due to DNA damage, DNA secondary structure, bound proteins, dNTP shortage, or other causes."" [GOC:vw, PMID:11459955, PMID:15367656, PMID:17660542]"	47	96	9	21110	0.09375	0.1914893617021276	query_1	['GO:0045005']	['RBBP8', 'NBN', 'RAD50', 'BRCA2', 'BLM', 'MRE11', 'RAD51', 'BRCA1', 'BARD1']
111	GO:BP	GO:0006796	phosphate-containing compound metabolic process	1.6187874345249243e-09	True	"""The chemical reactions and pathways involving the phosphate group, the anion or salt of any phosphoric acid."" [GOC:ai]"	2763	96	41	21110	0.4270833333333333	0.0148389431777053	query_1	['GO:0006793']	['SNX6', 'PDK4', 'PPM1K', 'ADSL', 'CDK5RAP3', 'NBN', 'DLST', 'RAD50', 'XRCC6', 'TALDO1', 'DLAT', 'PDHA2', 'PDHX', 'PDHB', 'DDRGK1', 'PHB2', 'SDHD', 'BCKDK', 'PDHA1', 'PDK3', 'BLM', 'MRE11', 'RAD51', 'HDAC6', 'MOCS3', 'GPD1', 'PDK1', 'SDHB', 'NFS1', 'NDUFAB1', 'SDHA', 'SDHC', 'DLD', 'PDK2', 'NDUFV3', 'TRIM28', 'BARD1', 'MFN1', 'ABHD6', 'OGDH', 'PHB1']
112	REAC	REAC:R-HSA-5693537	Resolution of D-Loop Structures	1.6348964070807931e-09	True	Resolution of D-Loop Structures	35	84	9	10790	0.1071428571428571	0.2571428571428571	query_1	['REAC:R-HSA-5685942']	['RBBP8', 'NBN', 'RAD50', 'BRCA2', 'BLM', 'MRE11', 'RAD51', 'BRCA1', 'BARD1']
113	GO:MF	GO:0004740	pyruvate dehydrogenase (acetyl-transferring) kinase activity	1.645300076934187e-09	True	"""Catalysis of the reaction: ATP + pyruvate dehydrogenase (acetyl-transferring) = ADP + pyruvate dehydrogenase (acetyl-transferring) phosphate."" [EC:2.7.11.2]"	5	97	5	20195	0.0515463917525773	1.0	query_1	['GO:0004672']	['PDK4', 'BCKDK', 'PDK3', 'PDK1', 'PDK2']
114	HP	HP:0010892	Abnormal circulating branched chain amino acid concentration	2.1825842927207277e-09	True	Any deviation from the normal concentration of a branched chain family amino acid in the blood circulation.	10	54	7	4851	0.1296296296296296	0.7	query_1	['HP:0033107']	['PPM1K', 'DBT', 'BCKDK', 'BCKDHB', 'MICU1', 'DLD', 'BCKDHA']
115	GO:BP	GO:0006793	phosphorus metabolic process	2.18379428777938e-09	True	"""The chemical reactions and pathways involving the nonmetallic element phosphorus or compounds that contain phosphorus, usually in the form of a phosphate group (PO4)."" [GOC:ai]"	2788	96	41	21110	0.4270833333333333	0.0147058823529411	query_1	['GO:0044237']	['SNX6', 'PDK4', 'PPM1K', 'ADSL', 'CDK5RAP3', 'NBN', 'DLST', 'RAD50', 'XRCC6', 'TALDO1', 'DLAT', 'PDHA2', 'PDHX', 'PDHB', 'DDRGK1', 'PHB2', 'SDHD', 'BCKDK', 'PDHA1', 'PDK3', 'BLM', 'MRE11', 'RAD51', 'HDAC6', 'MOCS3', 'GPD1', 'PDK1', 'SDHB', 'NFS1', 'NDUFAB1', 'SDHA', 'SDHC', 'DLD', 'PDK2', 'NDUFV3', 'TRIM28', 'BARD1', 'MFN1', 'ABHD6', 'OGDH', 'PHB1']
116	HPA	HPA:0020052	adrenal gland; glandular cells[≥Medium]	2.2640339252309667e-09	True	adrenal gland; glandular cells[≥Medium]	6009	83	74	11006	0.891566265060241	0.0123148610417706	query_1	['HPA:0020051']	['PDK4', 'GCSH', 'PPM1K', 'SNX1', 'LYRM4', 'ADSL', 'MAIP1', 'CDK5RAP3', 'NBN', 'ATF7IP', 'DLST', 'HSPA9', 'TP53BP1', 'RAD50', 'UBAC2', 'XRCC6', 'PAXIP1', 'DLAT', 'PDHX', 'SETDB2', 'PDHB', 'H2AX', 'DDRGK1', 'UFL1', 'MDC1', 'PMPCA', 'PHB2', 'MCAT', 'SDHD', 'DBT', 'MCU', 'SIL1', 'BCKDK', 'BCKDHB', 'PDHA1', 'SUMO1', 'HSPD1', 'RPA1', 'ARL14EP', 'FLYWCH1', 'BLM', 'PIAS1', 'MRE11', 'VDAC1', 'AFG3L2', 'HDAC6', 'ISCU', 'GPD1', 'PDK1', 'NSUN6', 'SDHB', 'FAF2', 'NFS1', 'CBX5', 'NDUFAB1', 'BRCA1', 'SDHA', 'MICU1', 'STAT5A', 'DLD', 'PDK2', 'MBD1', 'NDUFV3', 'TRIM28', 'MICU2', 'MFN1', 'PEPD', 'PMPCB', 'UBA5', 'OGDH', 'PHB1', 'UFM1', 'STAT5B', 'BCKDHA']
117	GO:CC	GO:0005947	mitochondrial alpha-ketoglutarate dehydrogenase complex	2.4805746056837127e-09	True	"""Mitochondrial complex that possesses alpha-ketoglutarate dehydrogenase activity."" [GOC:mah, GOC:mtg_sensu]"	6	97	5	22122	0.0515463917525773	0.8333333333333334	query_1	['GO:0030062', 'GO:0045240']	['DBT', 'BCKDK', 'BCKDHB', 'DLD', 'BCKDHA']
118	GO:CC	GO:1990246	uniplex complex	2.4805746056837127e-09	True	"""A calcium channel complex in the mitochondrial inner membrane capable of highly-selective calcium channel activity. Its components include the EF-hand-containing proteins mitochondrial calcium uptake 1 (MICU1) and MICU2, the pore-forming subunit mitochondrial calcium uniporter (MCU) and its paralog MCUb, and the MCU regulator EMRE."" [PMID:24231807]"	6	97	5	22122	0.0515463917525773	0.8333333333333334	query_1	['GO:0034704', 'GO:0098800']	['MCUB', 'MCU', 'MICU1', 'SMDT1', 'MICU2']
119	GO:BP	GO:0018130	heterocycle biosynthetic process	2.584103575435014e-09	True	"""The chemical reactions and pathways resulting in the formation of heterocyclic compounds, those with a cyclic molecular structure and at least two different atoms in the ring (or rings)."" [ISBN:0198547684]"	4129	96	50	21110	0.5208333333333334	0.0121094696052312	query_1	['GO:0044249', 'GO:0046483']	['RBBP8', 'SNX6', 'UBE2I', 'PDK4', 'ADSL', 'CDK5RAP3', 'ATF7IP', 'TP53BP1', 'RAD50', 'ZNF45', 'ZNF350', 'XRCC6', 'PAXIP1', 'DLAT', 'PDHA2', 'PDHX', 'SETDB2', 'PDHB', 'DDRGK1', 'UFL1', 'PHB2', 'SDHD', 'BRCA2', 'SETDB1', 'PDHA1', 'SUMO1', 'RPA1', 'PDK3', 'FLYWCH1', 'BLM', 'PIAS1', 'MRE11', 'HDAC6', 'MOCS3', 'PDK1', 'SDHB', 'NFS1', 'CBX5', 'NDUFAB1', 'BRCA1', 'SDHA', 'STAT5A', 'SDHC', 'DLD', 'PDK2', 'MBD1', 'NDUFV3', 'TRIM28', 'PHB1', 'STAT5B']
120	REAC	REAC:R-HSA-5685938	HDR through Single Strand Annealing (SSA)	2.8445558990919942e-09	True	HDR through Single Strand Annealing (SSA)	37	84	9	10790	0.1071428571428571	0.2432432432432432	query_1	['REAC:R-HSA-5693567']	['RBBP8', 'NBN', 'RAD50', 'RPA1', 'BLM', 'MRE11', 'RAD51', 'BRCA1', 'BARD1']
121	HPA	HPA:0310441	lymph node; non-germinal center cells[≥Low]	3.6084144061801283e-09	True	lymph node; non-germinal center cells[≥Low]	6053	83	74	11006	0.891566265060241	0.0122253428052205	query_1	['HPA:0310000']	['RBBP8', 'SNX6', 'UBE2I', 'PDK4', 'GCSH', 'PPM1K', 'LYRM4', 'ADSL', 'MAIP1', 'CDK5RAP3', 'NBN', 'ATF7IP', 'DLST', 'HSPA9', 'MCUB', 'TP53BP1', 'RAD50', 'XRCC6', 'PAXIP1', 'DLAT', 'PDHX', 'SETDB2', 'PDHB', 'H2AX', 'DDRGK1', 'UFL1', 'MDC1', 'PMPCA', 'PHB2', 'DBT', 'MCU', 'SIL1', 'BCKDK', 'BCKDHB', 'PDHA1', 'SUMO1', 'HSPD1', 'RPA1', 'ARL14EP', 'FLYWCH1', 'BLM', 'PIAS1', 'MRE11', 'VDAC1', 'RAD51', 'AFG3L2', 'HDAC6', 'ISCU', 'GPD1', 'PDK1', 'NSUN6', 'SDHB', 'FAF2', 'NFS1', 'CBX5', 'BRCA1', 'SDHA', 'MICU1', 'STAT5A', 'DLD', 'PDK2', 'MBD1', 'NDUFV3', 'TRIM28', 'BARD1', 'MFN1', 'PEPD', 'PMPCB', 'UBA5', 'OGDH', 'PHB1', 'UFM1', 'STAT5B', 'BCKDHA']
122	WP	WP:WP78	TCA cycle (aka Krebs or citric acid cycle)	3.6328130956867115e-09	True	TCA cycle (aka Krebs or citric acid cycle)	18	60	7	8133	0.1166666666666666	0.3888888888888889	query_1	['WP:000000']	['DLST', 'SDHD', 'SDHB', 'SDHA', 'SDHC', 'DLD', 'OGDH']
123	REAC	REAC:R-HSA-5693607	Processing of DNA double-strand break ends	3.711389778125543e-09	True	Processing of DNA double-strand break ends	97	84	12	10790	0.1428571428571428	0.1237113402061855	query_1	['REAC:R-HSA-5693567']	['RBBP8', 'UBE2I', 'NBN', 'TP53BP1', 'RAD50', 'H2AX', 'MDC1', 'RPA1', 'BLM', 'MRE11', 'BRCA1', 'BARD1']
124	HPA	HPA:0600221	tonsil; squamous epithelial cells[≥Low]	4.542622146112909e-09	True	tonsil; squamous epithelial cells[≥Low]	6645	83	77	11006	0.927710843373494	0.0115876598946576	query_1	['HPA:0600000']	['RBBP8', 'UBE2I', 'PDK4', 'GCSH', 'PPM1K', 'SNX1', 'LYRM4', 'ADSL', 'MAIP1', 'CDK5RAP3', 'NBN', 'ATF7IP', 'DLST', 'HSPA9', 'TP53BP1', 'RAD50', 'UBAC2', 'XRCC6', 'PAXIP1', 'DLAT', 'PDHX', 'SETDB2', 'PDHB', 'H2AX', 'DDRGK1', 'UFL1', 'MDC1', 'PMPCA', 'PHB2', 'MCAT', 'SDHD', 'DBT', 'MCU', 'SIL1', 'BCKDK', 'BCKDHB', 'PDHA1', 'SUMO1', 'HSPD1', 'RPA1', 'PDK3', 'ARL14EP', 'FLYWCH1', 'BLM', 'PIAS1', 'MRE11', 'VDAC1', 'RAD51', 'AFG3L2', 'HDAC6', 'ISCU', 'GPD1', 'PDK1', 'NSUN6', 'SDHB', 'FAF2', 'NFS1', 'CBX5', 'NDUFAB1', 'BRCA1', 'SDHA', 'MICU1', 'DLD', 'PDK2', 'MBD1', 'NDUFV3', 'TRIM28', 'BARD1', 'MICU2', 'MFN1', 'PEPD', 'PMPCB', 'OGDH', 'PHB1', 'UFM1', 'STAT5B', 'BCKDHA']
125	HPA	HPA:0050052	breast; glandular cells[≥Medium]	5.140185638507116e-09	True	breast; glandular cells[≥Medium]	5101	83	68	11006	0.8192771084337349	0.0133307194667712	query_1	['HPA:0050051']	['RBBP8', 'SNX6', 'PDK4', 'GCSH', 'PPM1K', 'SNX1', 'LYRM4', 'ADSL', 'CDK5RAP3', 'NBN', 'ATF7IP', 'HSPA9', 'MCUB', 'TP53BP1', 'RAD50', 'XRCC6', 'PAXIP1', 'DLAT', 'PDHX', 'SETDB2', 'PDHB', 'H2AX', 'DDRGK1', 'MDC1', 'PMPCA', 'PHB2', 'MCAT', 'DBT', 'MCU', 'SIL1', 'BCKDK', 'BCKDHB', 'PDHA1', 'SUMO1', 'RPA1', 'ARL14EP', 'FLYWCH1', 'BLM', 'PIAS1', 'MRE11', 'VDAC1', 'HDAC6', 'ISCU', 'GPD1', 'PDK1', 'NSUN6', 'SDHB', 'FAF2', 'NFS1', 'CBX5', 'NDUFAB1', 'BRCA1', 'SDHA', 'MICU1', 'STAT5A', 'DLD', 'PDK2', 'NDUFV3', 'TRIM28', 'BARD1', 'MICU2', 'MFN1', 'PMPCB', 'UBA5', 'OGDH', 'PHB1', 'UFM1', 'BCKDHA']
126	GO:MF	GO:0003824	catalytic activity	5.624351778327197e-09	True	"""Catalysis of a biochemical reaction at physiological temperatures. In biologically catalyzed reactions, the reactants are known as substrates, and the catalysts are naturally occurring macromolecular substances known as enzymes. Enzymes possess specific binding sites for substrates, and are usually composed wholly or largely of protein, but RNA that has catalytic activity (ribozyme) is often also regarded as enzymatic."" [GOC:vw, ISBN:0198506732]"	5758	97	60	20195	0.6185567010309279	0.0104202848211184	query_1	['GO:0003674']	['PPIF', 'RBBP8', 'UBE2I', 'PDK4', 'GCSH', 'SPG7', 'PPM1K', 'ADSL', 'OTC', 'ATF7IP', 'DLST', 'HSPA9', 'RAD50', 'XRCC6', 'TALDO1', 'DLAT', 'PDHA2', 'PDHX', 'SETDB2', 'PDHB', 'UFL1', 'PMPCA', 'MCAT', 'METTL21C', 'SDHD', 'DBT', 'BRCA2', 'SETDB1', 'BCKDK', 'BCKDHB', 'PDHA1', 'HSPD1', 'PDK3', 'BLM', 'PIAS1', 'MRE11', 'RAD51', 'AFG3L2', 'HDAC6', 'MOCS3', 'GPD1', 'PDK1', 'NSUN6', 'SDHB', 'NFS1', 'BRCA1', 'SDHA', 'SDHC', 'DLD', 'PDK2', 'NDUFV3', 'TRIM28', 'BARD1', 'MFN1', 'ABHD6', 'PEPD', 'PMPCB', 'UBA5', 'OGDH', 'BCKDHA']
127	GO:BP	GO:0045005	DNA-templated DNA replication maintenance of fidelity	6.06356284270363e-09	True	"""A DNA metabolic process that prevents or corrects errors to ensure that DNA is replicated accurately. Errors can be corrected either by intrinsic DNA polymerase proofreading activity or via mismatch repair."" [GOC:mah, GOC:vw]"	54	96	9	21110	0.09375	0.1666666666666666	query_1	['GO:0006259', 'GO:0006261']	['RBBP8', 'NBN', 'RAD50', 'BRCA2', 'BLM', 'MRE11', 'RAD51', 'BRCA1', 'BARD1']
128	WP	WP:WP5118	SMC1/SMC3 role in DNA damage - Cornelia de Lange Syndrome	8.215021727554726e-09	True	SMC1/SMC3 role in DNA damage - Cornelia de Lange Syndrome	11	60	6	8133	0.1	0.5454545454545454	query_1	['WP:000000']	['NBN', 'RAD50', 'PAXIP1', 'MDC1', 'MRE11', 'BRCA1']
129	GO:BP	GO:0000075	cell cycle checkpoint signaling	1.0281634739278964e-08	True	"""A signaling process that controls cell cycle progression by monitoring the integrity of specific cell cycle events. A cell cycle checkpoint begins with detection of deficiencies or defects and ends with signal transduction."" [GOC:mtg_cell_cycle]"	193	96	13	21110	0.1354166666666666	0.0673575129533678	query_1	['GO:0035556', 'GO:1901988']	['RBBP8', 'CDK5RAP3', 'NBN', 'TP53BP1', 'RAD50', 'H2AX', 'MDC1', 'BRCA2', 'BLM', 'MRE11', 'RAD51', 'BRCA1', 'BARD1']
130	GO:BP	GO:1901362	organic cyclic compound biosynthetic process	1.1252448228261915e-08	True	"""The chemical reactions and pathways resulting in the formation of organic cyclic compound."" [GOC:TermGenie]"	4287	96	50	21110	0.5208333333333334	0.0116631677163517	query_1	['GO:1901360', 'GO:1901576']	['RBBP8', 'SNX6', 'UBE2I', 'PDK4', 'ADSL', 'CDK5RAP3', 'ATF7IP', 'TP53BP1', 'RAD50', 'ZNF45', 'ZNF350', 'XRCC6', 'PAXIP1', 'DLAT', 'PDHA2', 'PDHX', 'SETDB2', 'PDHB', 'DDRGK1', 'UFL1', 'PHB2', 'SDHD', 'BRCA2', 'SETDB1', 'PDHA1', 'SUMO1', 'RPA1', 'PDK3', 'FLYWCH1', 'BLM', 'PIAS1', 'MRE11', 'HDAC6', 'MOCS3', 'PDK1', 'SDHB', 'NFS1', 'CBX5', 'NDUFAB1', 'BRCA1', 'SDHA', 'STAT5A', 'SDHC', 'DLD', 'PDK2', 'MBD1', 'NDUFV3', 'TRIM28', 'PHB1', 'STAT5B']
131	GO:CC	GO:0090734	site of DNA damage	1.2612431471904906e-08	True	"""A region of a chromosome at which DNA damage has occurred. DNA damage signaling and repair proteins accumulate at the lesion to respond to the damage and repair the DNA to form a continuous DNA helix."" [GOC:pg]"	108	97	10	22122	0.1030927835051546	0.0925925925925925	query_1	['GO:0005694', 'GO:0110165']	['RBBP8', 'NBN', 'TP53BP1', 'RAD50', 'H2AX', 'UFL1', 'RPA1', 'MRE11', 'RAD51', 'CBX5']
132	REAC	REAC:R-HSA-73894	DNA Repair	2.1188802912427327e-08	True	DNA Repair	330	84	18	10790	0.2142857142857142	0.0545454545454545	query_1	['REAC:0000000']	['RBBP8', 'UBE2I', 'NBN', 'TP53BP1', 'RAD50', 'XRCC6', 'PAXIP1', 'H2AX', 'MDC1', 'BRCA2', 'SUMO1', 'RPA1', 'BLM', 'PIAS1', 'MRE11', 'RAD51', 'BRCA1', 'BARD1']
133	GO:CC	GO:0043231	intracellular membrane-bounded organelle	2.186587538952757e-08	True	"""Organized structure of distinctive morphology and function, bounded by a single or double lipid bilayer membrane and occurring within the cell. Includes the nucleus, mitochondria, plastids, vacuoles, and vesicles. Excludes the plasma membrane."" [GOC:go_curators]"	14642	97	91	22122	0.9381443298969072	0.0062149979510995	query_1	['GO:0043227', 'GO:0043229']	['PPIF', 'RBBP8', 'SNX6', 'UBE2I', 'PDK4', 'GCSH', 'SPG7', 'PPM1K', 'SNX1', 'LYRM4', 'MAIP1', 'CDK5RAP3', 'NBN', 'OTC', 'ATF7IP', 'DLST', 'HSPA9', 'MCUB', 'TP53BP1', 'RAD50', 'ZNF45', 'UBAC2', 'ZNF350', 'XRCC6', 'TALDO1', 'PAXIP1', 'DLAT', 'PDHA2', 'PDHX', 'SETDB2', 'PDHB', 'H2AX', 'DDRGK1', 'UFL1', 'MDC1', 'PMPCA', 'PHB2', 'MCAT', 'METTL21C', 'SDHD', 'DBT', 'BRCA2', 'MCU', 'SIL1', 'SETDB1', 'BCKDK', 'CDNF', 'BCKDHB', 'PDHA1', 'SUMO1', 'HSPD1', 'RPA1', 'PDK3', 'ARL14EP', 'FLYWCH1', 'BLM', 'PIAS1', 'MRE11', 'VDAC1', 'RAD51', 'AFG3L2', 'HDAC6', 'ISCU', 'PDK1', 'SDHB', 'FAF2', 'NFS1', 'CBX5', 'NDUFAB1', 'BRCA1', 'SDHA', 'MICU1', 'STAT5A', 'SMDT1', 'SDHC', 'DLD', 'PDK2', 'MBD1', 'NDUFV3', 'TRIM28', 'BARD1', 'MICU2', 'MFN1', 'ABHD6', 'PMPCB', 'UBA5', 'OGDH', 'PHB1', 'UFM1', 'STAT5B', 'BCKDHA']
134	KEGG	KEGG:05415	Diabetic cardiomyopathy	2.3299748591419767e-08	True	Diabetic cardiomyopathy	203	63	14	8161	0.2222222222222222	0.0689655172413793	query_1	['KEGG:00000']	['PPIF', 'PDK4', 'PDHA2', 'PDHB', 'SDHD', 'PDHA1', 'PDK3', 'VDAC1', 'SDHB', 'NDUFAB1', 'SDHA', 'SDHC', 'PDK2', 'NDUFV3']
135	HPA	HPA:0160051	endometrium 1; glandular cells[≥Low]	2.4520202411005164e-08	True	endometrium 1; glandular cells[≥Low]	6811	83	77	11006	0.927710843373494	0.0113052415210688	query_1	['HPA:0160000']	['RBBP8', 'UBE2I', 'PDK4', 'GCSH', 'PPM1K', 'SNX1', 'LYRM4', 'ADSL', 'MAIP1', 'CDK5RAP3', 'NBN', 'ATF7IP', 'DLST', 'HSPA9', 'TP53BP1', 'RAD50', 'UBAC2', 'XRCC6', 'PAXIP1', 'DLAT', 'PDHX', 'SETDB2', 'PDHB', 'H2AX', 'DDRGK1', 'UFL1', 'MDC1', 'PMPCA', 'PHB2', 'MCAT', 'DBT', 'MCU', 'SIL1', 'BCKDK', 'BCKDHB', 'PDHA1', 'SUMO1', 'HSPD1', 'RPA1', 'PDK3', 'ARL14EP', 'FLYWCH1', 'BLM', 'PIAS1', 'MRE11', 'VDAC1', 'RAD51', 'AFG3L2', 'HDAC6', 'ISCU', 'GPD1', 'PDK1', 'NSUN6', 'SDHB', 'FAF2', 'NFS1', 'CBX5', 'NDUFAB1', 'BRCA1', 'SDHA', 'MICU1', 'DLD', 'PDK2', 'MBD1', 'NDUFV3', 'TRIM28', 'BARD1', 'MICU2', 'MFN1', 'PEPD', 'PMPCB', 'UBA5', 'OGDH', 'PHB1', 'UFM1', 'STAT5B', 'BCKDHA']
136	GO:BP	GO:0071569	protein ufmylation	2.4917055049700662e-08	True	"""Covalent attachment of the ubiquitin-like protein UFM1 to another protein."" [GOC:vw, PMID:20018847]"	6	96	5	21110	0.0520833333333333	0.8333333333333334	query_1	['GO:0032446']	['CDK5RAP3', 'DDRGK1', 'UFL1', 'UBA5', 'UFM1']
137	GO:BP	GO:0034654	nucleobase-containing compound biosynthetic process	2.5306078174706157e-08	True	"""The chemical reactions and pathways resulting in the formation of nucleobases, nucleosides, nucleotides and nucleic acids."" [GOC:mah]"	4055	96	48	21110	0.5	0.0118372379778051	query_1	['GO:0006139', 'GO:0018130', 'GO:0019438', 'GO:0044271', 'GO:1901362']	['RBBP8', 'SNX6', 'UBE2I', 'PDK4', 'ADSL', 'CDK5RAP3', 'ATF7IP', 'TP53BP1', 'RAD50', 'ZNF45', 'ZNF350', 'XRCC6', 'PAXIP1', 'DLAT', 'PDHA2', 'PDHX', 'SETDB2', 'PDHB', 'DDRGK1', 'UFL1', 'PHB2', 'SDHD', 'BRCA2', 'SETDB1', 'PDHA1', 'SUMO1', 'RPA1', 'PDK3', 'FLYWCH1', 'BLM', 'PIAS1', 'MRE11', 'HDAC6', 'PDK1', 'SDHB', 'CBX5', 'NDUFAB1', 'BRCA1', 'SDHA', 'STAT5A', 'SDHC', 'DLD', 'PDK2', 'MBD1', 'NDUFV3', 'TRIM28', 'PHB1', 'STAT5B']
138	HPA	HPA:0330000	oral mucosa	2.806134278921479e-08	True	oral mucosa	6252	83	74	11006	0.891566265060241	0.0118362124120281	query_1	['HPA:0000000']	['RBBP8', 'UBE2I', 'PDK4', 'GCSH', 'PPM1K', 'SNX1', 'ADSL', 'CDK5RAP3', 'NBN', 'ATF7IP', 'DLST', 'HSPA9', 'MCUB', 'TP53BP1', 'RAD50', 'UBAC2', 'XRCC6', 'PAXIP1', 'DLAT', 'PDHX', 'SETDB2', 'PDHB', 'H2AX', 'DDRGK1', 'MDC1', 'PMPCA', 'PHB2', 'SDHD', 'DBT', 'MCU', 'SIL1', 'BCKDK', 'BCKDHB', 'PDHA1', 'SUMO1', 'HSPD1', 'RPA1', 'PDK3', 'ARL14EP', 'FLYWCH1', 'BLM', 'PIAS1', 'MRE11', 'VDAC1', 'RAD51', 'AFG3L2', 'HDAC6', 'ISCU', 'GPD1', 'PDK1', 'NSUN6', 'SDHB', 'FAF2', 'NFS1', 'CBX5', 'BRCA1', 'SDHA', 'MICU1', 'DLD', 'PDK2', 'MBD1', 'NDUFV3', 'TRIM28', 'BARD1', 'MICU2', 'MFN1', 'PEPD', 'PMPCB', 'UBA5', 'OGDH', 'PHB1', 'UFM1', 'STAT5B', 'BCKDHA']
139	HPA	HPA:0330221	oral mucosa; squamous epithelial cells[≥Low]	2.806134278921479e-08	True	oral mucosa; squamous epithelial cells[≥Low]	6252	83	74	11006	0.891566265060241	0.0118362124120281	query_1	['HPA:0330000']	['RBBP8', 'UBE2I', 'PDK4', 'GCSH', 'PPM1K', 'SNX1', 'ADSL', 'CDK5RAP3', 'NBN', 'ATF7IP', 'DLST', 'HSPA9', 'MCUB', 'TP53BP1', 'RAD50', 'UBAC2', 'XRCC6', 'PAXIP1', 'DLAT', 'PDHX', 'SETDB2', 'PDHB', 'H2AX', 'DDRGK1', 'MDC1', 'PMPCA', 'PHB2', 'SDHD', 'DBT', 'MCU', 'SIL1', 'BCKDK', 'BCKDHB', 'PDHA1', 'SUMO1', 'HSPD1', 'RPA1', 'PDK3', 'ARL14EP', 'FLYWCH1', 'BLM', 'PIAS1', 'MRE11', 'VDAC1', 'RAD51', 'AFG3L2', 'HDAC6', 'ISCU', 'GPD1', 'PDK1', 'NSUN6', 'SDHB', 'FAF2', 'NFS1', 'CBX5', 'BRCA1', 'SDHA', 'MICU1', 'DLD', 'PDK2', 'MBD1', 'NDUFV3', 'TRIM28', 'BARD1', 'MICU2', 'MFN1', 'PEPD', 'PMPCB', 'UBA5', 'OGDH', 'PHB1', 'UFM1', 'STAT5B', 'BCKDHA']
140	GO:CC	GO:0098796	membrane protein complex	2.9737075704194536e-08	True	"""Any protein complex that is part of a membrane."" [GOC:dos]"	1361	97	26	22122	0.268041237113402	0.0191036002939015	query_1	['GO:0016020', 'GO:0032991']	['PPIF', 'SNX6', 'SPG7', 'SNX1', 'HSPA9', 'MCUB', 'PHB2', 'SDHD', 'MCU', 'SUMO1', 'HSPD1', 'VDAC1', 'AFG3L2', 'SDHB', 'FAF2', 'NDUFAB1', 'SDHA', 'MICU1', 'SMDT1', 'SDHC', 'NDUFV3', 'MICU2', 'MFN1', 'ABHD6', 'GJA10', 'PHB1']
141	WP	WP:WP186	Homologous recombination	3.0166389909776954e-08	True	Homologous recombination	13	60	6	8133	0.1	0.4615384615384615	query_1	['WP:000000']	['NBN', 'RAD50', 'BRCA2', 'RPA1', 'MRE11', 'RAD51']
142	HPA	HPA:0160000	endometrium 1	3.2706233806307755e-08	True	endometrium 1	7048	83	78	11006	0.9397590361445785	0.0110669693530079	query_1	['HPA:0000000']	['RBBP8', 'SNX6', 'UBE2I', 'PDK4', 'GCSH', 'PPM1K', 'SNX1', 'LYRM4', 'ADSL', 'MAIP1', 'CDK5RAP3', 'NBN', 'ATF7IP', 'DLST', 'HSPA9', 'TP53BP1', 'RAD50', 'UBAC2', 'XRCC6', 'PAXIP1', 'DLAT', 'PDHX', 'SETDB2', 'PDHB', 'H2AX', 'DDRGK1', 'UFL1', 'MDC1', 'PMPCA', 'PHB2', 'MCAT', 'DBT', 'MCU', 'SIL1', 'BCKDK', 'BCKDHB', 'PDHA1', 'SUMO1', 'HSPD1', 'RPA1', 'PDK3', 'ARL14EP', 'FLYWCH1', 'BLM', 'PIAS1', 'MRE11', 'VDAC1', 'RAD51', 'AFG3L2', 'HDAC6', 'ISCU', 'GPD1', 'PDK1', 'NSUN6', 'SDHB', 'FAF2', 'NFS1', 'CBX5', 'NDUFAB1', 'BRCA1', 'SDHA', 'MICU1', 'DLD', 'PDK2', 'MBD1', 'NDUFV3', 'TRIM28', 'BARD1', 'MICU2', 'MFN1', 'PEPD', 'PMPCB', 'UBA5', 'OGDH', 'PHB1', 'UFM1', 'STAT5B', 'BCKDHA']
143	GO:BP	GO:0051560	mitochondrial calcium ion homeostasis	3.446829407157424e-08	True	"""Any process involved in the maintenance of an internal steady state of calcium ions within the cytoplasm of a cell or between mitochondria and their surroundings."" [GOC:ai, GOC:mah]"	25	96	7	21110	0.0729166666666666	0.28	query_1	['GO:0006874']	['MAIP1', 'MCUB', 'MCU', 'AFG3L2', 'MICU1', 'SMDT1', 'MICU2']
144	HPA	HPA:0550052	stomach 2; glandular cells[≥Medium]	3.5359018771614555e-08	True	stomach 2; glandular cells[≥Medium]	6275	83	74	11006	0.891566265060241	0.0117928286852589	query_1	['HPA:0550051']	['RBBP8', 'SNX6', 'UBE2I', 'PDK4', 'GCSH', 'PPM1K', 'LYRM4', 'ADSL', 'MAIP1', 'CDK5RAP3', 'NBN', 'DLST', 'HSPA9', 'TP53BP1', 'RAD50', 'UBAC2', 'XRCC6', 'PAXIP1', 'DLAT', 'PDHX', 'SETDB2', 'PDHB', 'H2AX', 'DDRGK1', 'UFL1', 'MDC1', 'PMPCA', 'PHB2', 'MCAT', 'SDHD', 'DBT', 'MCU', 'SIL1', 'BCKDK', 'BCKDHB', 'PDHA1', 'SUMO1', 'HSPD1', 'RPA1', 'ARL14EP', 'FLYWCH1', 'BLM', 'PIAS1', 'MRE11', 'VDAC1', 'AFG3L2', 'HDAC6', 'ISCU', 'GPD1', 'PDK1', 'NSUN6', 'SDHB', 'FAF2', 'NFS1', 'CBX5', 'NDUFAB1', 'BRCA1', 'SDHA', 'MICU1', 'DLD', 'PDK2', 'MBD1', 'NDUFV3', 'TRIM28', 'MICU2', 'MFN1', 'PEPD', 'PMPCB', 'UBA5', 'OGDH', 'PHB1', 'UFM1', 'STAT5B', 'BCKDHA']
145	GO:BP	GO:0000077	DNA damage checkpoint signaling	3.57370819636632e-08	True	"""A signal transduction process that contributes to a DNA damage checkpoint."" [GOC:mah]"	128	96	11	21110	0.1145833333333333	0.0859375	query_1	['GO:0031570', 'GO:0042770']	['CDK5RAP3', 'NBN', 'TP53BP1', 'H2AX', 'MDC1', 'BRCA2', 'BLM', 'MRE11', 'RAD51', 'BRCA1', 'BARD1']
146	CORUM	CORUM:2815	BRCA1-BARD1-BACH1-DNA damage complex II	3.757794336449282e-08	True	BRCA1-BARD1-BACH1-DNA damage complex II	8	47	6	3383	0.1276595744680851	0.75	query_1	['CORUM:0000000']	['RBBP8', 'NBN', 'RAD50', 'MRE11', 'BRCA1', 'BARD1']
147	REAC	REAC:R-HSA-5685942	HDR through Homologous Recombination (HRR)	3.8341994734058325e-08	True	HDR through Homologous Recombination (HRR)	68	84	10	10790	0.119047619047619	0.1470588235294117	query_1	['REAC:R-HSA-5693567']	['RBBP8', 'NBN', 'RAD50', 'BRCA2', 'RPA1', 'BLM', 'MRE11', 'RAD51', 'BRCA1', 'BARD1']
148	REAC	REAC:R-HSA-5693571	Nonhomologous End-Joining (NHEJ)	3.8341994734058325e-08	True	Nonhomologous End-Joining (NHEJ)	68	84	10	10790	0.119047619047619	0.1470588235294117	query_1	['REAC:R-HSA-5693532']	['NBN', 'TP53BP1', 'RAD50', 'XRCC6', 'PAXIP1', 'H2AX', 'MDC1', 'MRE11', 'BRCA1', 'BARD1']
149	HPA	HPA:0600441	tonsil; non-germinal center cells[≥Low]	3.8930870026947226e-08	True	tonsil; non-germinal center cells[≥Low]	6107	83	73	11006	0.8795180722891566	0.0119534959882102	query_1	['HPA:0600000']	['RBBP8', 'UBE2I', 'PDK4', 'GCSH', 'PPM1K', 'LYRM4', 'ADSL', 'CDK5RAP3', 'NBN', 'ATF7IP', 'DLST', 'HSPA9', 'MCUB', 'TP53BP1', 'RAD50', 'XRCC6', 'PAXIP1', 'DLAT', 'PDHX', 'SETDB2', 'PDHB', 'H2AX', 'DDRGK1', 'UFL1', 'MDC1', 'PMPCA', 'PHB2', 'MCAT', 'DBT', 'MCU', 'SIL1', 'BCKDK', 'PDHA1', 'SUMO1', 'HSPD1', 'RPA1', 'PDK3', 'ARL14EP', 'FLYWCH1', 'BLM', 'PIAS1', 'MRE11', 'VDAC1', 'RAD51', 'AFG3L2', 'HDAC6', 'ISCU', 'GPD1', 'PDK1', 'NSUN6', 'SDHB', 'FAF2', 'NFS1', 'CBX5', 'NDUFAB1', 'BRCA1', 'SDHA', 'MICU1', 'STAT5A', 'DLD', 'PDK2', 'MBD1', 'NDUFV3', 'TRIM28', 'BARD1', 'PEPD', 'PMPCB', 'UBA5', 'OGDH', 'PHB1', 'UFM1', 'STAT5B', 'BCKDHA']
150	HPA	HPA:0460671	skin 1; melanocytes[≥Low]	4.1559258701681344e-08	True	skin 1; melanocytes[≥Low]	5297	83	68	11006	0.8192771084337349	0.0128374551632999	query_1	['HPA:0460000']	['RBBP8', 'SNX6', 'UBE2I', 'PDK4', 'GCSH', 'PPM1K', 'SNX1', 'LYRM4', 'ADSL', 'CDK5RAP3', 'NBN', 'ATF7IP', 'DLST', 'HSPA9', 'MCUB', 'TP53BP1', 'RAD50', 'XRCC6', 'PAXIP1', 'PDHX', 'SETDB2', 'H2AX', 'UFL1', 'MDC1', 'PMPCA', 'PHB2', 'MCAT', 'SDHD', 'DBT', 'MCU', 'SIL1', 'BCKDK', 'BCKDHB', 'PDHA1', 'SUMO1', 'HSPD1', 'RPA1', 'ARL14EP', 'FLYWCH1', 'BLM', 'PIAS1', 'MRE11', 'VDAC1', 'AFG3L2', 'HDAC6', 'ISCU', 'PDK1', 'NSUN6', 'SDHB', 'NFS1', 'NDUFAB1', 'BRCA1', 'SDHA', 'MICU1', 'STAT5A', 'DLD', 'MBD1', 'NDUFV3', 'TRIM28', 'MICU2', 'MFN1', 'PEPD', 'PMPCB', 'OGDH', 'PHB1', 'UFM1', 'STAT5B', 'BCKDHA']
151	WP	WP:WP2516	ATM signaling pathway	5.0798448359758484e-08	True	ATM signaling pathway	40	60	8	8133	0.1333333333333333	0.2	query_1	['WP:000000']	['NBN', 'TP53BP1', 'RAD50', 'H2AX', 'MDC1', 'MRE11', 'RAD51', 'BRCA1']
152	GO:BP	GO:0006310	DNA recombination	5.17578479782509e-08	True	"""Any process in which a new genotype is formed by reassortment of genes resulting in gene combinations different from those that were present in the parents. In eukaryotes genetic recombination can occur by chromosome assortment, intrachromosomal recombination, or nonreciprocal interchromosomal recombination. Interchromosomal recombination occurs by crossing over. In bacteria it may occur by genetic transformation, conjugation, transduction, or F-duction."" [ISBN:0198506732]"	327	96	15	21110	0.15625	0.0458715596330275	query_1	['GO:0006259']	['RBBP8', 'NBN', 'TP53BP1', 'RAD50', 'XRCC6', 'PAXIP1', 'H2AX', 'BRCA2', 'HSPD1', 'RPA1', 'BLM', 'MRE11', 'RAD51', 'BRCA1', 'BARD1']
153	REAC	REAC:R-HSA-69473	G2/M DNA damage checkpoint	5.3561827480676535e-08	True	G2/M DNA damage checkpoint	94	84	11	10790	0.1309523809523809	0.1170212765957446	query_1	['REAC:R-HSA-69481']	['RBBP8', 'NBN', 'TP53BP1', 'RAD50', 'H2AX', 'MDC1', 'RPA1', 'BLM', 'MRE11', 'BRCA1', 'BARD1']
154	HPA	HPA:0010000	adipose tissue	5.451214085695574e-08	True	adipose tissue	3934	83	58	11006	0.6987951807228916	0.0147432638535841	query_1	['HPA:0000000']	['PDK4', 'GCSH', 'PPM1K', 'SNX1', 'LYRM4', 'ADSL', 'NBN', 'ATF7IP', 'DLST', 'HSPA9', 'TP53BP1', 'RAD50', 'XRCC6', 'PAXIP1', 'PDHX', 'SETDB2', 'PDHB', 'H2AX', 'DDRGK1', 'MDC1', 'PMPCA', 'PHB2', 'MCAT', 'SDHD', 'DBT', 'MCU', 'SIL1', 'BCKDHB', 'PDHA1', 'SUMO1', 'HSPD1', 'RPA1', 'ARL14EP', 'FLYWCH1', 'BLM', 'PIAS1', 'MRE11', 'VDAC1', 'AFG3L2', 'GPD1', 'PDK1', 'SDHB', 'NFS1', 'CBX5', 'BRCA1', 'SDHA', 'MICU1', 'STAT5A', 'DLD', 'PDK2', 'NDUFV3', 'TRIM28', 'MICU2', 'MFN1', 'PEPD', 'OGDH', 'PHB1', 'BCKDHA']
155	HPA	HPA:0010011	adipose tissue; adipocytes[≥Low]	5.451214085695574e-08	True	adipose tissue; adipocytes[≥Low]	3934	83	58	11006	0.6987951807228916	0.0147432638535841	query_1	['HPA:0010000']	['PDK4', 'GCSH', 'PPM1K', 'SNX1', 'LYRM4', 'ADSL', 'NBN', 'ATF7IP', 'DLST', 'HSPA9', 'TP53BP1', 'RAD50', 'XRCC6', 'PAXIP1', 'PDHX', 'SETDB2', 'PDHB', 'H2AX', 'DDRGK1', 'MDC1', 'PMPCA', 'PHB2', 'MCAT', 'SDHD', 'DBT', 'MCU', 'SIL1', 'BCKDHB', 'PDHA1', 'SUMO1', 'HSPD1', 'RPA1', 'ARL14EP', 'FLYWCH1', 'BLM', 'PIAS1', 'MRE11', 'VDAC1', 'AFG3L2', 'GPD1', 'PDK1', 'SDHB', 'NFS1', 'CBX5', 'BRCA1', 'SDHA', 'MICU1', 'STAT5A', 'DLD', 'PDK2', 'NDUFV3', 'TRIM28', 'MICU2', 'MFN1', 'PEPD', 'OGDH', 'PHB1', 'BCKDHA']
156	GO:BP	GO:0019438	aromatic compound biosynthetic process	5.4603837067723674e-08	True	"""The chemical reactions and pathways resulting in the formation of aromatic compounds, any substance containing an aromatic carbon ring."" [GOC:ai]"	4140	96	48	21110	0.5	0.0115942028985507	query_1	['GO:0006725', 'GO:0044249']	['RBBP8', 'SNX6', 'UBE2I', 'PDK4', 'ADSL', 'CDK5RAP3', 'ATF7IP', 'TP53BP1', 'RAD50', 'ZNF45', 'ZNF350', 'XRCC6', 'PAXIP1', 'DLAT', 'PDHA2', 'PDHX', 'SETDB2', 'PDHB', 'DDRGK1', 'UFL1', 'PHB2', 'SDHD', 'BRCA2', 'SETDB1', 'PDHA1', 'SUMO1', 'RPA1', 'PDK3', 'FLYWCH1', 'BLM', 'PIAS1', 'MRE11', 'HDAC6', 'PDK1', 'SDHB', 'CBX5', 'NDUFAB1', 'BRCA1', 'SDHA', 'STAT5A', 'SDHC', 'DLD', 'PDK2', 'MBD1', 'NDUFV3', 'TRIM28', 'PHB1', 'STAT5B']
157	HPA	HPA:0170052	endometrium 2; glandular cells[≥Medium]	5.5985380396603104e-08	True	endometrium 2; glandular cells[≥Medium]	4880	83	65	11006	0.7831325301204819	0.0133196721311475	query_1	['HPA:0170051']	['UBE2I', 'PDK4', 'GCSH', 'PPM1K', 'SNX1', 'LYRM4', 'ADSL', 'CDK5RAP3', 'NBN', 'ATF7IP', 'DLST', 'HSPA9', 'TP53BP1', 'RAD50', 'XRCC6', 'PAXIP1', 'DLAT', 'PDHX', 'SETDB2', 'PDHB', 'H2AX', 'DDRGK1', 'UFL1', 'MDC1', 'PMPCA', 'PHB2', 'MCAT', 'MCU', 'SIL1', 'BCKDK', 'BCKDHB', 'SUMO1', 'HSPD1', 'RPA1', 'ARL14EP', 'FLYWCH1', 'BLM', 'PIAS1', 'MRE11', 'VDAC1', 'AFG3L2', 'ISCU', 'GPD1', 'PDK1', 'NSUN6', 'SDHB', 'NFS1', 'CBX5', 'NDUFAB1', 'BRCA1', 'SDHA', 'MICU1', 'DLD', 'MBD1', 'NDUFV3', 'TRIM28', 'MICU2', 'MFN1', 'PEPD', 'PMPCB', 'UBA5', 'OGDH', 'PHB1', 'UFM1', 'BCKDHA']
158	GO:CC	GO:0000781	chromosome, telomeric region	5.6037671990115486e-08	True	"""The end of a linear chromosome, required for the integrity and maintenance of the end. A chromosome telomere usually includes a region of telomerase-encoded repeats the length of which rarely exceeds 20 bp each and that permits the formation of a telomeric loop (T-loop). The telomeric repeat region is usually preceded by a sub-telomeric region that is gene-poor but rich in repetitive elements. Some telomeres only consist of the latter part (for eg. D. melanogaster telomeres)."" [GOC:elh]"	168	97	11	22122	0.1134020618556701	0.0654761904761904	query_1	['GO:0098687']	['NBN', 'TP53BP1', 'RAD50', 'XRCC6', 'H2AX', 'BRCA2', 'RPA1', 'BLM', 'MRE11', 'RAD51', 'CBX5']
159	HP	HP:0030406	Primary peritoneal carcinoma	6.032849854533759e-08	True	A type of cancer that originates in the peritoneum. It is to be distinguished from metastatic cancer of the peritoneum. Peritoneal cancer can occur anywhere in the abdominal space, and affects the surface of organs contained inside the peritoneum.	14	54	7	4851	0.1296296296296296	0.5	query_1	['HP:0007378']	['NBN', 'RAD50', 'BRCA2', 'MRE11', 'RAD51', 'BRCA1', 'BARD1']
160	HPA	HPA:0030000	appendix	6.157206632893821e-08	True	appendix	7821	83	81	11006	0.9759036144578314	0.0103567318757192	query_1	['HPA:0000000']	['RBBP8', 'SNX6', 'UBE2I', 'PDK4', 'GCSH', 'PPM1K', 'SNX1', 'LYRM4', 'ADSL', 'MAIP1', 'CDK5RAP3', 'NBN', 'OTC', 'ATF7IP', 'DLST', 'HSPA9', 'MCUB', 'TP53BP1', 'RAD50', 'UBAC2', 'XRCC6', 'PAXIP1', 'DLAT', 'PDHX', 'SETDB2', 'PDHB', 'H2AX', 'DDRGK1', 'UFL1', 'MDC1', 'PMPCA', 'PHB2', 'MCAT', 'SDHD', 'DBT', 'MCU', 'SIL1', 'BCKDK', 'BCKDHB', 'PDHA1', 'SUMO1', 'HSPD1', 'RPA1', 'PDK3', 'ARL14EP', 'FLYWCH1', 'BLM', 'PIAS1', 'MRE11', 'VDAC1', 'RAD51', 'AFG3L2', 'HDAC6', 'ISCU', 'GPD1', 'PDK1', 'NSUN6', 'SDHB', 'FAF2', 'NFS1', 'CBX5', 'NDUFAB1', 'BRCA1', 'SDHA', 'MICU1', 'STAT5A', 'DLD', 'PDK2', 'MBD1', 'NDUFV3', 'TRIM28', 'MICU2', 'MFN1', 'PEPD', 'PMPCB', 'UBA5', 'OGDH', 'PHB1', 'UFM1', 'STAT5B', 'BCKDHA']
161	HPA	HPA:0310000	lymph node	6.691656943208425e-08	True	lymph node	6523	83	75	11006	0.9036144578313252	0.011497777096428	query_1	['HPA:0000000']	['RBBP8', 'SNX6', 'UBE2I', 'PDK4', 'GCSH', 'PPM1K', 'SNX1', 'LYRM4', 'ADSL', 'MAIP1', 'CDK5RAP3', 'NBN', 'ATF7IP', 'DLST', 'HSPA9', 'MCUB', 'TP53BP1', 'RAD50', 'XRCC6', 'PAXIP1', 'DLAT', 'PDHX', 'SETDB2', 'PDHB', 'H2AX', 'DDRGK1', 'UFL1', 'MDC1', 'PMPCA', 'PHB2', 'DBT', 'MCU', 'SIL1', 'BCKDK', 'BCKDHB', 'PDHA1', 'SUMO1', 'HSPD1', 'RPA1', 'ARL14EP', 'FLYWCH1', 'BLM', 'PIAS1', 'MRE11', 'VDAC1', 'RAD51', 'AFG3L2', 'HDAC6', 'ISCU', 'GPD1', 'PDK1', 'NSUN6', 'SDHB', 'FAF2', 'NFS1', 'CBX5', 'BRCA1', 'SDHA', 'MICU1', 'STAT5A', 'DLD', 'PDK2', 'MBD1', 'NDUFV3', 'TRIM28', 'BARD1', 'MFN1', 'PEPD', 'PMPCB', 'UBA5', 'OGDH', 'PHB1', 'UFM1', 'STAT5B', 'BCKDHA']
162	GO:BP	GO:0031570	DNA integrity checkpoint signaling	6.941508096321978e-08	True	"""A signaling process that controls cell cycle progression in response to changes in DNA structure by monitoring the integrity of the DNA. The DNA integrity checkpoint begins with detection of DNA damage, defects in DNA structure or DNA replication, and progresses through signal transduction and ends with cell cycle effector processes."" [GOC:mtg_cell_cycle]"	136	96	11	21110	0.1145833333333333	0.0808823529411764	query_1	['GO:0000075']	['CDK5RAP3', 'NBN', 'TP53BP1', 'H2AX', 'MDC1', 'BRCA2', 'BLM', 'MRE11', 'RAD51', 'BRCA1', 'BARD1']
163	GO:BP	GO:0090407	organophosphate biosynthetic process	7.065376439835869e-08	True	"""The chemical reactions and pathways resulting in the biosynthesis of deoxyribose phosphate, the phosphorylated sugar 2-deoxy-erythro-pentose."" [GOC:chem_mtg]"	609	96	19	21110	0.1979166666666666	0.0311986863711001	query_1	['GO:0019637', 'GO:1901576']	['PDK4', 'ADSL', 'DLAT', 'PDHA2', 'PDHX', 'PDHB', 'SDHD', 'PDHA1', 'PDK3', 'MOCS3', 'PDK1', 'SDHB', 'NFS1', 'NDUFAB1', 'SDHA', 'SDHC', 'DLD', 'PDK2', 'NDUFV3']
164	REAC	REAC:R-HSA-71403	Citric acid cycle (TCA cycle)	8.408561231639057e-08	True	Citric acid cycle (TCA cycle)	22	84	7	10790	0.0833333333333333	0.3181818181818182	query_1	['REAC:R-HSA-71406']	['DLST', 'SDHD', 'SDHB', 'SDHA', 'SDHC', 'DLD', 'OGDH']
165	HPA	HPA:0480000	small intestine	9.746783623160285e-08	True	small intestine	7868	83	81	11006	0.9759036144578314	0.0102948652770716	query_1	['HPA:0000000']	['RBBP8', 'SNX6', 'UBE2I', 'PDK4', 'GCSH', 'PPM1K', 'SNX1', 'LYRM4', 'ADSL', 'MAIP1', 'CDK5RAP3', 'NBN', 'OTC', 'ATF7IP', 'DLST', 'HSPA9', 'MCUB', 'TP53BP1', 'RAD50', 'UBAC2', 'XRCC6', 'PAXIP1', 'DLAT', 'PDHX', 'SETDB2', 'PDHB', 'H2AX', 'DDRGK1', 'UFL1', 'MDC1', 'PMPCA', 'PHB2', 'MCAT', 'SDHD', 'DBT', 'MCU', 'SIL1', 'BCKDK', 'BCKDHB', 'PDHA1', 'SUMO1', 'HSPD1', 'RPA1', 'PDK3', 'ARL14EP', 'FLYWCH1', 'BLM', 'PIAS1', 'MRE11', 'VDAC1', 'RAD51', 'AFG3L2', 'HDAC6', 'ISCU', 'GPD1', 'PDK1', 'NSUN6', 'SDHB', 'FAF2', 'NFS1', 'CBX5', 'NDUFAB1', 'BRCA1', 'SDHA', 'MICU1', 'DLD', 'PDK2', 'MBD1', 'NDUFV3', 'TRIM28', 'BARD1', 'MICU2', 'MFN1', 'PEPD', 'PMPCB', 'UBA5', 'OGDH', 'PHB1', 'UFM1', 'STAT5B', 'BCKDHA']
166	GO:CC	GO:0045257	succinate dehydrogenase complex (ubiquinone)	9.866701912210343e-08	True	"""The enzyme that catalyzes the oxidation of succinate and ubiquinone to fumarate and ubiquinol; involved in aerobic respiration, repressed in anaerobic respiration."" [GOC:kd, ISBN:0198547684]"	4	97	4	22122	0.0412371134020618	1.0	query_1	['GO:0045281']	['SDHD', 'SDHB', 'SDHA', 'SDHC']
167	GO:CC	GO:0005749	mitochondrial respiratory chain complex II, succinate dehydrogenase complex (ubiquinone)	9.866701912210343e-08	True	"""A protein complex located in the mitochondrial inner membrane that forms part of the mitochondrial respiratory chain. Contains the four polypeptide subunits of succinate dehydrogenase, flavin-adenine dinucleotide and iron-sulfur. Catalyzes the oxidation of succinate by ubiquinone. Connects the TCA cycle with the respiratory chain."" [GOC:mtg_sensu, GOC:vw, ISBN:0198547684]"	4	97	4	22122	0.0412371134020618	1.0	query_1	['GO:0005746', 'GO:0045257', 'GO:0045283', 'GO:0098800']	['SDHD', 'SDHB', 'SDHA', 'SDHC']
168	GO:CC	GO:0045283	fumarate reductase complex	9.866701912210343e-08	True	"""A membrane-bound flavoenzyme complex consisting of four subunits, A, B, C, and D. A and B comprise the membrane-extrinsic catalytic domain and C (InterPro:IPR003510; InterPro:IPR004224) and D (InterPro:IPR003418) link the catalytic centers to the electron-transport chain. This family consists of the 13 kDa hydrophobic subunit D. This component may be required to anchor the catalytic components of the fumarate reductase complex to the cytoplasmic membrane. Fumarate reductase couples the reduction of fumarate to succinate to the oxidation of quinol to quinone, in a reaction opposite to that catalyzed by the related complex II of the respiratory chain (succinate dehydrogenase-(ubiquinone))."" [InterPro:IPR003418, InterPro:IPR004224]"	4	97	4	22122	0.0412371134020618	1.0	query_1	['GO:0045273', 'GO:0098803', 'GO:1902494']	['SDHD', 'SDHB', 'SDHA', 'SDHC']
169	GO:CC	GO:0045281	succinate dehydrogenase complex	9.866701912210343e-08	True	"""A multimeric complex which consists of flavoprotein (subunit A ; InterPro:IPR003952), iron-sulfur protein (subunit B) and membrane-bound cytochrome b560 (subunit C; InterPro:IPR000701). In some Archaea, the membrane-bound subunits (C or C and D) do not necessarily contain heme. Membrane-bound subunits can bind or react with quinones."" [GOC:kd, InterPro:IPR000701]"	4	97	4	22122	0.0412371134020618	1.0	query_1	['GO:0005622', 'GO:0045273', 'GO:0098803', 'GO:1990204']	['SDHD', 'SDHB', 'SDHA', 'SDHC']
170	GO:CC	GO:0045273	respiratory chain complex II	9.866701912210343e-08	True	"""A part of the respiratory chain, containing the four polypeptide subunits of succinate dehydrogenase, flavin-adenine dinucleotide and iron-sulfur. Catalyzes the oxidation of succinate by ubiquinone. Connects the TCA cycle with the respiratory chain."" [ISBN:0198547684]"	4	97	4	22122	0.0412371134020618	1.0	query_1	['GO:0098803', 'GO:1902494']	['SDHD', 'SDHB', 'SDHA', 'SDHC']
171	HP	HP:0003002	Breast carcinoma	9.93469226022119e-08	True	The presence of a carcinoma of the breast.	66	54	11	4851	0.2037037037037037	0.1666666666666666	query_1	['HP:0100013']	['NBN', 'RAD50', 'SDHD', 'BRCA2', 'MRE11', 'RAD51', 'SDHB', 'BRCA1', 'SDHC', 'BARD1', 'PHB1']
172	GO:CC	GO:0005737	cytoplasm	1.052897470724797e-07	True	"""The contents of a cell excluding the plasma membrane and nucleus, but including other subcellular structures."" [ISBN:0198547684]"	12365	97	83	22122	0.8556701030927835	0.0067124949454104	query_1	['GO:0005622', 'GO:0110165']	['PPIF', 'SNX6', 'UBE2I', 'PDK4', 'GCSH', 'SPG7', 'PPM1K', 'SNX1', 'LYRM4', 'ADSL', 'MAIP1', 'CDK5RAP3', 'NBN', 'OTC', 'ATF7IP', 'DLST', 'HSPA9', 'MCUB', 'TP53BP1', 'UBAC2', 'XRCC6', 'TALDO1', 'DLAT', 'PDHA2', 'PDHX', 'SETDB2', 'PDHB', 'DDRGK1', 'UFL1', 'PMPCA', 'PHB2', 'MCAT', 'METTL21C', 'SDHD', 'DBT', 'BRCA2', 'MCU', 'SIL1', 'SETDB1', 'BCKDK', 'CDNF', 'BCKDHB', 'PDHA1', 'SUMO1', 'HSPD1', 'PDK3', 'ARL14EP', 'FLYWCH1', 'BLM', 'MRE11', 'VDAC1', 'RAD51', 'AFG3L2', 'HDAC6', 'MOCS3', 'ISCU', 'GPD1', 'PDK1', 'NSUN6', 'SDHB', 'FAF2', 'NFS1', 'NDUFAB1', 'BRCA1', 'SDHA', 'MICU1', 'STAT5A', 'SMDT1', 'SDHC', 'DLD', 'PDK2', 'NDUFV3', 'BARD1', 'MICU2', 'MFN1', 'ABHD6', 'PMPCB', 'UBA5', 'OGDH', 'PHB1', 'UFM1', 'STAT5B', 'BCKDHA']
173	GO:CC	GO:0043227	membrane-bounded organelle	1.0585607721968963e-07	True	"""Organized structure of distinctive morphology and function, bounded by a single or double lipid bilayer membrane. Includes the nucleus, mitochondria, plastids, vacuoles, and vesicles. Excludes the plasma membrane."" [GOC:go_curators]"	15705	97	93	22122	0.9587628865979382	0.0059216809933142	query_1	['GO:0043226']	['PPIF', 'RBBP8', 'SNX6', 'UBE2I', 'PDK4', 'GCSH', 'SPG7', 'PPM1K', 'SNX1', 'LYRM4', 'MAIP1', 'CDK5RAP3', 'NBN', 'OTC', 'ATF7IP', 'DLST', 'HSPA9', 'MCUB', 'TP53BP1', 'RAD50', 'ZNF45', 'UBAC2', 'ZNF350', 'XRCC6', 'TALDO1', 'PAXIP1', 'DLAT', 'PDHA2', 'PDHX', 'SETDB2', 'PDHB', 'H2AX', 'DDRGK1', 'UFL1', 'MDC1', 'PMPCA', 'PHB2', 'MCAT', 'METTL21C', 'SDHD', 'DBT', 'BRCA2', 'MCU', 'SIL1', 'SETDB1', 'BCKDK', 'CDNF', 'BCKDHB', 'PDHA1', 'SUMO1', 'HSPD1', 'RPA1', 'PDK3', 'ARL14EP', 'FLYWCH1', 'BLM', 'PIAS1', 'MRE11', 'VDAC1', 'RAD51', 'AFG3L2', 'HDAC6', 'ISCU', 'GPD1', 'PDK1', 'SDHB', 'FAF2', 'NFS1', 'CBX5', 'NDUFAB1', 'BRCA1', 'SDHA', 'MICU1', 'STAT5A', 'SMDT1', 'SDHC', 'DLD', 'PDK2', 'MBD1', 'NDUFV3', 'TRIM28', 'BARD1', 'MICU2', 'MFN1', 'ABHD6', 'PEPD', 'PMPCB', 'UBA5', 'OGDH', 'PHB1', 'UFM1', 'STAT5B', 'BCKDHA']
174	CORUM	CORUM:6473	mitochondrial calcium uniporter complex	1.1022290976757665e-07	True	mitochondrial calcium uniporter complex	5	47	5	3383	0.1063829787234042	1.0	query_1	['CORUM:0000000']	['MCUB', 'MCU', 'MICU1', 'SMDT1', 'MICU2']
175	HPA	HPA:0150000	duodenum	1.218849863576422e-07	True	duodenum	7891	83	81	11006	0.9759036144578314	0.0102648586997845	query_1	['HPA:0000000']	['RBBP8', 'SNX6', 'UBE2I', 'PDK4', 'GCSH', 'PPM1K', 'SNX1', 'LYRM4', 'ADSL', 'MAIP1', 'CDK5RAP3', 'NBN', 'OTC', 'ATF7IP', 'DLST', 'HSPA9', 'MCUB', 'TP53BP1', 'RAD50', 'UBAC2', 'XRCC6', 'PAXIP1', 'DLAT', 'PDHX', 'SETDB2', 'PDHB', 'H2AX', 'DDRGK1', 'UFL1', 'MDC1', 'PMPCA', 'PHB2', 'MCAT', 'SDHD', 'DBT', 'MCU', 'SIL1', 'BCKDK', 'BCKDHB', 'PDHA1', 'SUMO1', 'HSPD1', 'RPA1', 'PDK3', 'ARL14EP', 'FLYWCH1', 'BLM', 'PIAS1', 'MRE11', 'VDAC1', 'RAD51', 'AFG3L2', 'HDAC6', 'ISCU', 'GPD1', 'PDK1', 'NSUN6', 'SDHB', 'FAF2', 'NFS1', 'CBX5', 'NDUFAB1', 'BRCA1', 'SDHA', 'MICU1', 'DLD', 'PDK2', 'MBD1', 'NDUFV3', 'TRIM28', 'BARD1', 'MICU2', 'MFN1', 'PEPD', 'PMPCB', 'UBA5', 'OGDH', 'PHB1', 'UFM1', 'STAT5B', 'BCKDHA']
176	HPA	HPA:0300411	lung; macrophages[≥Low]	1.263460469217201e-07	True	lung; macrophages[≥Low]	6779	83	76	11006	0.9156626506024096	0.0112110930815754	query_1	['HPA:0300000']	['RBBP8', 'SNX6', 'UBE2I', 'PDK4', 'PPM1K', 'SNX1', 'LYRM4', 'ADSL', 'MAIP1', 'CDK5RAP3', 'NBN', 'ATF7IP', 'DLST', 'HSPA9', 'TP53BP1', 'RAD50', 'XRCC6', 'PAXIP1', 'DLAT', 'PDHX', 'SETDB2', 'PDHB', 'H2AX', 'DDRGK1', 'UFL1', 'PMPCA', 'PHB2', 'MCAT', 'SDHD', 'DBT', 'MCU', 'SIL1', 'BCKDK', 'BCKDHB', 'PDHA1', 'SUMO1', 'HSPD1', 'RPA1', 'PDK3', 'ARL14EP', 'FLYWCH1', 'BLM', 'PIAS1', 'MRE11', 'VDAC1', 'RAD51', 'AFG3L2', 'HDAC6', 'ISCU', 'GPD1', 'PDK1', 'NSUN6', 'SDHB', 'FAF2', 'NFS1', 'CBX5', 'NDUFAB1', 'BRCA1', 'SDHA', 'MICU1', 'STAT5A', 'DLD', 'PDK2', 'MBD1', 'NDUFV3', 'TRIM28', 'BARD1', 'MICU2', 'MFN1', 'PEPD', 'PMPCB', 'OGDH', 'PHB1', 'UFM1', 'STAT5B', 'BCKDHA']
177	REAC	REAC:R-HSA-5693565	Recruitment and ATM-mediated phosphorylation of repair and signaling proteins at DNA double strand breaks	1.3672250479268358e-07	True	Recruitment and ATM-mediated phosphorylation of repair and signaling proteins at DNA double strand breaks	77	84	10	10790	0.119047619047619	0.1298701298701298	query_1	['REAC:R-HSA-5693606']	['UBE2I', 'NBN', 'TP53BP1', 'RAD50', 'H2AX', 'MDC1', 'SUMO1', 'MRE11', 'BRCA1', 'BARD1']
178	WP	WP:WP3878	ATM signaling in development and disease 	1.3837180936762552e-07	True	ATM signaling in development and disease 	45	60	8	8133	0.1333333333333333	0.1777777777777777	query_1	['WP:000000']	['RBBP8', 'NBN', 'TP53BP1', 'RAD50', 'H2AX', 'MDC1', 'MRE11', 'TRIM28']
179	WP	WP:WP2453	TCA cycle and deficiency of pyruvate dehydrogenase complex (PDHc)	1.383851008051762e-07	True	TCA cycle and deficiency of pyruvate dehydrogenase complex (PDHc)	16	60	6	8133	0.1	0.375	query_1	['WP:000000']	['DLST', 'DLAT', 'PDHA1', 'SDHA', 'DLD', 'OGDH']
180	HPA	HPA:0540051	stomach 1; glandular cells[≥Low]	1.469272389596164e-07	True	stomach 1; glandular cells[≥Low]	7656	83	80	11006	0.963855421686747	0.0104493207941483	query_1	['HPA:0540000']	['RBBP8', 'SNX6', 'UBE2I', 'PDK4', 'GCSH', 'PPM1K', 'SNX1', 'LYRM4', 'ADSL', 'MAIP1', 'CDK5RAP3', 'NBN', 'ATF7IP', 'DLST', 'HSPA9', 'MCUB', 'TP53BP1', 'RAD50', 'UBAC2', 'XRCC6', 'PAXIP1', 'DLAT', 'PDHX', 'SETDB2', 'PDHB', 'H2AX', 'DDRGK1', 'UFL1', 'MDC1', 'PMPCA', 'PHB2', 'MCAT', 'SDHD', 'DBT', 'MCU', 'SIL1', 'BCKDK', 'BCKDHB', 'PDHA1', 'SUMO1', 'HSPD1', 'RPA1', 'PDK3', 'ARL14EP', 'FLYWCH1', 'BLM', 'PIAS1', 'MRE11', 'VDAC1', 'RAD51', 'AFG3L2', 'HDAC6', 'ISCU', 'GPD1', 'PDK1', 'NSUN6', 'SDHB', 'FAF2', 'NFS1', 'CBX5', 'NDUFAB1', 'BRCA1', 'SDHA', 'MICU1', 'DLD', 'PDK2', 'MBD1', 'NDUFV3', 'TRIM28', 'BARD1', 'MICU2', 'MFN1', 'PEPD', 'PMPCB', 'UBA5', 'OGDH', 'PHB1', 'UFM1', 'STAT5B', 'BCKDHA']
181	HPA	HPA:0540000	stomach 1	1.469272389596164e-07	True	stomach 1	7656	83	80	11006	0.963855421686747	0.0104493207941483	query_1	['HPA:0000000']	['RBBP8', 'SNX6', 'UBE2I', 'PDK4', 'GCSH', 'PPM1K', 'SNX1', 'LYRM4', 'ADSL', 'MAIP1', 'CDK5RAP3', 'NBN', 'ATF7IP', 'DLST', 'HSPA9', 'MCUB', 'TP53BP1', 'RAD50', 'UBAC2', 'XRCC6', 'PAXIP1', 'DLAT', 'PDHX', 'SETDB2', 'PDHB', 'H2AX', 'DDRGK1', 'UFL1', 'MDC1', 'PMPCA', 'PHB2', 'MCAT', 'SDHD', 'DBT', 'MCU', 'SIL1', 'BCKDK', 'BCKDHB', 'PDHA1', 'SUMO1', 'HSPD1', 'RPA1', 'PDK3', 'ARL14EP', 'FLYWCH1', 'BLM', 'PIAS1', 'MRE11', 'VDAC1', 'RAD51', 'AFG3L2', 'HDAC6', 'ISCU', 'GPD1', 'PDK1', 'NSUN6', 'SDHB', 'FAF2', 'NFS1', 'CBX5', 'NDUFAB1', 'BRCA1', 'SDHA', 'MICU1', 'DLD', 'PDK2', 'MBD1', 'NDUFV3', 'TRIM28', 'BARD1', 'MICU2', 'MFN1', 'PEPD', 'PMPCB', 'UBA5', 'OGDH', 'PHB1', 'UFM1', 'STAT5B', 'BCKDHA']
182	HPA	HPA:0220052	gallbladder; glandular cells[≥Medium]	1.503456280891941e-07	True	gallbladder; glandular cells[≥Medium]	6606	83	75	11006	0.9036144578313252	0.011353315168029	query_1	['HPA:0220051']	['RBBP8', 'UBE2I', 'PDK4', 'GCSH', 'PPM1K', 'SNX1', 'LYRM4', 'ADSL', 'MAIP1', 'CDK5RAP3', 'NBN', 'ATF7IP', 'DLST', 'HSPA9', 'MCUB', 'TP53BP1', 'RAD50', 'XRCC6', 'PAXIP1', 'DLAT', 'PDHX', 'SETDB2', 'PDHB', 'H2AX', 'DDRGK1', 'UFL1', 'MDC1', 'PMPCA', 'PHB2', 'MCAT', 'SDHD', 'DBT', 'MCU', 'SIL1', 'BCKDK', 'BCKDHB', 'PDHA1', 'SUMO1', 'HSPD1', 'RPA1', 'ARL14EP', 'FLYWCH1', 'BLM', 'PIAS1', 'MRE11', 'VDAC1', 'AFG3L2', 'HDAC6', 'ISCU', 'GPD1', 'PDK1', 'NSUN6', 'SDHB', 'FAF2', 'NFS1', 'CBX5', 'NDUFAB1', 'BRCA1', 'SDHA', 'MICU1', 'DLD', 'PDK2', 'MBD1', 'NDUFV3', 'TRIM28', 'BARD1', 'MICU2', 'MFN1', 'PEPD', 'PMPCB', 'UBA5', 'OGDH', 'PHB1', 'UFM1', 'BCKDHA']
183	REAC	REAC:R-HSA-5693606	DNA Double Strand Break Response	1.5584804725611269e-07	True	DNA Double Strand Break Response	78	84	10	10790	0.119047619047619	0.1282051282051282	query_1	['REAC:R-HSA-5693532']	['UBE2I', 'NBN', 'TP53BP1', 'RAD50', 'H2AX', 'MDC1', 'SUMO1', 'MRE11', 'BRCA1', 'BARD1']
184	GO:BP	GO:0042770	signal transduction in response to DNA damage	1.7329049282178424e-07	True	"""A cascade of processes induced by the detection of DNA damage within a cell."" [GOC:go_curators]"	192	96	12	21110	0.125	0.0625	query_1	['GO:0006974', 'GO:0035556']	['CDK5RAP3', 'NBN', 'TP53BP1', 'PAXIP1', 'H2AX', 'MDC1', 'BRCA2', 'BLM', 'MRE11', 'RAD51', 'BRCA1', 'BARD1']
185	GO:BP	GO:0044818	mitotic G2/M transition checkpoint	1.7543631694256425e-07	True	"""A cell cycle checkpoint that detects and negatively regulates progression from G2 to M phase as part of a mitotic cell cycle."" [GOC:mtg_cell_cycle]"	51	96	8	21110	0.0833333333333333	0.1568627450980392	query_1	['GO:0007093', 'GO:0010972']	['RBBP8', 'CDK5RAP3', 'NBN', 'RAD50', 'BLM', 'MRE11', 'BRCA1', 'BARD1']
186	GO:CC	GO:0030062	mitochondrial tricarboxylic acid cycle enzyme complex	1.87717213115341e-07	True	"""Any of the heteromeric enzymes, located in the mitochondrion, that act in the tricarboxylic acid (TCA) cycle."" [GOC:mah, GOC:mtg_sensu]"	11	97	5	22122	0.0515463917525773	0.4545454545454545	query_1	['GO:0005759', 'GO:0045239', 'GO:0098798']	['DBT', 'BCKDK', 'BCKDHB', 'DLD', 'BCKDHA']
187	HP	HP:0100013	Neoplasm of the breast	1.880843989976028e-07	True	A tumor (abnormal growth of tissue) of the breast.	90	54	12	4851	0.2222222222222222	0.1333333333333333	query_1	['HP:0011793', 'HP:0031093']	['NBN', 'RAD50', 'SDHD', 'BRCA2', 'BLM', 'MRE11', 'RAD51', 'SDHB', 'BRCA1', 'SDHC', 'BARD1', 'PHB1']
188	HPA	HPA:0160052	endometrium 1; glandular cells[≥Medium]	1.89491987564766e-07	True	endometrium 1; glandular cells[≥Medium]	5144	83	66	11006	0.7951807228915663	0.0128304821150855	query_1	['HPA:0160051']	['UBE2I', 'PDK4', 'GCSH', 'PPM1K', 'LYRM4', 'ADSL', 'MAIP1', 'CDK5RAP3', 'NBN', 'ATF7IP', 'DLST', 'HSPA9', 'TP53BP1', 'RAD50', 'XRCC6', 'DLAT', 'PDHX', 'SETDB2', 'H2AX', 'DDRGK1', 'UFL1', 'MDC1', 'PMPCA', 'PHB2', 'MCAT', 'MCU', 'SIL1', 'BCKDK', 'PDHA1', 'SUMO1', 'HSPD1', 'RPA1', 'PDK3', 'ARL14EP', 'FLYWCH1', 'BLM', 'PIAS1', 'MRE11', 'VDAC1', 'AFG3L2', 'HDAC6', 'ISCU', 'GPD1', 'PDK1', 'NSUN6', 'SDHB', 'NFS1', 'CBX5', 'NDUFAB1', 'BRCA1', 'SDHA', 'MICU1', 'DLD', 'PDK2', 'MBD1', 'NDUFV3', 'TRIM28', 'BARD1', 'MICU2', 'MFN1', 'PEPD', 'UBA5', 'OGDH', 'PHB1', 'UFM1', 'BCKDHA']
189	HPA	HPA:0350472	pancreas; exocrine glandular cells[≥Medium]	1.962024909379699e-07	True	pancreas; exocrine glandular cells[≥Medium]	5297	83	67	11006	0.8072289156626506	0.0126486690579573	query_1	['HPA:0350471']	['RBBP8', 'PDK4', 'GCSH', 'PPM1K', 'SNX1', 'ADSL', 'CDK5RAP3', 'NBN', 'ATF7IP', 'DLST', 'HSPA9', 'MCUB', 'TP53BP1', 'RAD50', 'XRCC6', 'PAXIP1', 'DLAT', 'PDHX', 'SETDB2', 'PDHB', 'H2AX', 'DDRGK1', 'UFL1', 'MDC1', 'PMPCA', 'PHB2', 'MCAT', 'SDHD', 'DBT', 'SIL1', 'BCKDK', 'BCKDHB', 'PDHA1', 'SUMO1', 'HSPD1', 'RPA1', 'PDK3', 'ARL14EP', 'FLYWCH1', 'BLM', 'PIAS1', 'MRE11', 'VDAC1', 'AFG3L2', 'HDAC6', 'ISCU', 'GPD1', 'PDK1', 'NSUN6', 'SDHB', 'FAF2', 'NFS1', 'CBX5', 'NDUFAB1', 'BRCA1', 'SDHA', 'MICU1', 'DLD', 'NDUFV3', 'TRIM28', 'PEPD', 'PMPCB', 'UBA5', 'OGDH', 'PHB1', 'UFM1', 'BCKDHA']
190	GO:CC	GO:0016605	PML body	2.2722393619583394e-07	True	"""A class of nuclear body; they react against SP100 auto-antibodies (PML, promyelocytic leukemia); cells typically contain 10-30 PML bodies per nucleus; alterations in the localization of PML bodies occurs after viral infection."" [GOC:ma, PMID:10944585]"	104	97	9	22122	0.0927835051546391	0.0865384615384615	query_1	['GO:0016604']	['UBE2I', 'NBN', 'SUMO1', 'RPA1', 'BLM', 'PIAS1', 'MRE11', 'RAD51', 'CBX5']
191	HPA	HPA:0460672	skin 1; melanocytes[≥Medium]	2.71736791827232e-07	True	skin 1; melanocytes[≥Medium]	3703	83	55	11006	0.6626506024096386	0.0148528220361868	query_1	['HPA:0460671']	['RBBP8', 'UBE2I', 'GCSH', 'PPM1K', 'ADSL', 'CDK5RAP3', 'NBN', 'ATF7IP', 'DLST', 'HSPA9', 'TP53BP1', 'RAD50', 'XRCC6', 'PAXIP1', 'PDHX', 'SETDB2', 'H2AX', 'UFL1', 'MDC1', 'PMPCA', 'PHB2', 'SDHD', 'DBT', 'SIL1', 'BCKDK', 'PDHA1', 'SUMO1', 'HSPD1', 'RPA1', 'ARL14EP', 'FLYWCH1', 'BLM', 'PIAS1', 'MRE11', 'VDAC1', 'AFG3L2', 'HDAC6', 'ISCU', 'PDK1', 'NSUN6', 'SDHB', 'NFS1', 'NDUFAB1', 'BRCA1', 'SDHA', 'MICU1', 'DLD', 'NDUFV3', 'TRIM28', 'PEPD', 'PMPCB', 'OGDH', 'PHB1', 'UFM1', 'BCKDHA']
192	HPA	HPA:0300412	lung; macrophages[≥Medium]	2.7417745501937685e-07	True	lung; macrophages[≥Medium]	4890	83	64	11006	0.7710843373493976	0.0130879345603271	query_1	['HPA:0300411']	['RBBP8', 'UBE2I', 'PDK4', 'LYRM4', 'ADSL', 'MAIP1', 'CDK5RAP3', 'NBN', 'ATF7IP', 'DLST', 'HSPA9', 'TP53BP1', 'RAD50', 'XRCC6', 'PAXIP1', 'PDHX', 'SETDB2', 'H2AX', 'UFL1', 'PMPCA', 'PHB2', 'MCAT', 'SDHD', 'DBT', 'MCU', 'SIL1', 'BCKDK', 'BCKDHB', 'SUMO1', 'HSPD1', 'RPA1', 'PDK3', 'ARL14EP', 'FLYWCH1', 'BLM', 'PIAS1', 'MRE11', 'VDAC1', 'AFG3L2', 'HDAC6', 'ISCU', 'GPD1', 'PDK1', 'SDHB', 'FAF2', 'NFS1', 'NDUFAB1', 'BRCA1', 'SDHA', 'MICU1', 'DLD', 'PDK2', 'MBD1', 'NDUFV3', 'TRIM28', 'BARD1', 'MICU2', 'PEPD', 'PMPCB', 'OGDH', 'PHB1', 'UFM1', 'STAT5B', 'BCKDHA']
193	HPA	HPA:0040000	bone marrow	2.788751332031605e-07	True	bone marrow	6486	83	74	11006	0.891566265060241	0.01140918902251	query_1	['HPA:0000000']	['RBBP8', 'UBE2I', 'PDK4', 'GCSH', 'PPM1K', 'SNX1', 'LYRM4', 'ADSL', 'MAIP1', 'CDK5RAP3', 'NBN', 'ATF7IP', 'DLST', 'HSPA9', 'MCUB', 'TP53BP1', 'RAD50', 'XRCC6', 'PAXIP1', 'DLAT', 'PDHX', 'SETDB2', 'PDHB', 'H2AX', 'DDRGK1', 'MDC1', 'PMPCA', 'PHB2', 'MCAT', 'SDHD', 'MCU', 'SIL1', 'BCKDK', 'PDHA1', 'SUMO1', 'HSPD1', 'RPA1', 'PDK3', 'FLYWCH1', 'BLM', 'PIAS1', 'MRE11', 'VDAC1', 'RAD51', 'AFG3L2', 'HDAC6', 'ISCU', 'GPD1', 'PDK1', 'NSUN6', 'SDHB', 'FAF2', 'NFS1', 'CBX5', 'NDUFAB1', 'BRCA1', 'SDHA', 'MICU1', 'STAT5A', 'DLD', 'PDK2', 'MBD1', 'NDUFV3', 'TRIM28', 'BARD1', 'MICU2', 'MFN1', 'PEPD', 'PMPCB', 'OGDH', 'PHB1', 'UFM1', 'STAT5B', 'BCKDHA']
194	HPA	HPA:0040081	bone marrow; hematopoietic cells[≥Low]	2.788751332031605e-07	True	bone marrow; hematopoietic cells[≥Low]	6486	83	74	11006	0.891566265060241	0.01140918902251	query_1	['HPA:0040000']	['RBBP8', 'UBE2I', 'PDK4', 'GCSH', 'PPM1K', 'SNX1', 'LYRM4', 'ADSL', 'MAIP1', 'CDK5RAP3', 'NBN', 'ATF7IP', 'DLST', 'HSPA9', 'MCUB', 'TP53BP1', 'RAD50', 'XRCC6', 'PAXIP1', 'DLAT', 'PDHX', 'SETDB2', 'PDHB', 'H2AX', 'DDRGK1', 'MDC1', 'PMPCA', 'PHB2', 'MCAT', 'SDHD', 'MCU', 'SIL1', 'BCKDK', 'PDHA1', 'SUMO1', 'HSPD1', 'RPA1', 'PDK3', 'FLYWCH1', 'BLM', 'PIAS1', 'MRE11', 'VDAC1', 'RAD51', 'AFG3L2', 'HDAC6', 'ISCU', 'GPD1', 'PDK1', 'NSUN6', 'SDHB', 'FAF2', 'NFS1', 'CBX5', 'NDUFAB1', 'BRCA1', 'SDHA', 'MICU1', 'STAT5A', 'DLD', 'PDK2', 'MBD1', 'NDUFV3', 'TRIM28', 'BARD1', 'MICU2', 'MFN1', 'PEPD', 'PMPCB', 'OGDH', 'PHB1', 'UFM1', 'STAT5B', 'BCKDHA']
195	GO:BP	GO:1901987	regulation of cell cycle phase transition	2.805330722859208e-07	True	"""Any process that modulates the frequency, rate or extent of cell cycle phase transition."" [GOC:mtg_cell_cycle, GOC:TermGenie, PMID:22841721]"	435	96	16	21110	0.1666666666666666	0.0367816091954023	query_1	['GO:0010564', 'GO:0044770']	['RBBP8', 'CDK5RAP3', 'NBN', 'TP53BP1', 'RAD50', 'PAXIP1', 'H2AX', 'DDRGK1', 'MDC1', 'PHB2', 'BRCA2', 'BLM', 'MRE11', 'RAD51', 'BRCA1', 'BARD1']
196	HPA	HPA:0600431	tonsil; germinal center cells[≥Low]	3.102494522355777e-07	True	tonsil; germinal center cells[≥Low]	5977	83	71	11006	0.8554216867469879	0.0118788689978249	query_1	['HPA:0600000']	['RBBP8', 'UBE2I', 'PDK4', 'GCSH', 'PPM1K', 'SNX1', 'LYRM4', 'ADSL', 'NBN', 'ATF7IP', 'DLST', 'HSPA9', 'MCUB', 'TP53BP1', 'RAD50', 'XRCC6', 'PAXIP1', 'DLAT', 'PDHX', 'SETDB2', 'PDHB', 'H2AX', 'DDRGK1', 'PMPCA', 'PHB2', 'SDHD', 'MCU', 'SIL1', 'BCKDK', 'BCKDHB', 'PDHA1', 'SUMO1', 'HSPD1', 'RPA1', 'ARL14EP', 'FLYWCH1', 'BLM', 'PIAS1', 'MRE11', 'VDAC1', 'RAD51', 'AFG3L2', 'HDAC6', 'ISCU', 'GPD1', 'PDK1', 'NSUN6', 'SDHB', 'FAF2', 'NFS1', 'CBX5', 'NDUFAB1', 'BRCA1', 'SDHA', 'MICU1', 'STAT5A', 'DLD', 'PDK2', 'MBD1', 'NDUFV3', 'TRIM28', 'BARD1', 'MICU2', 'PEPD', 'PMPCB', 'UBA5', 'OGDH', 'PHB1', 'UFM1', 'STAT5B', 'BCKDHA']
197	HPA	HPA:0380000	placenta	3.386831179242385e-07	True	placenta	7509	83	79	11006	0.9518072289156626	0.0105207084831535	query_1	['HPA:0000000']	['RBBP8', 'UBE2I', 'PDK4', 'GCSH', 'PPM1K', 'LYRM4', 'ADSL', 'MAIP1', 'CDK5RAP3', 'NBN', 'ATF7IP', 'DLST', 'HSPA9', 'MCUB', 'TP53BP1', 'RAD50', 'UBAC2', 'XRCC6', 'PAXIP1', 'DLAT', 'PDHX', 'SETDB2', 'PDHB', 'H2AX', 'DDRGK1', 'UFL1', 'MDC1', 'PMPCA', 'PHB2', 'MCAT', 'SDHD', 'DBT', 'MCU', 'SIL1', 'BCKDK', 'BCKDHB', 'PDHA1', 'SUMO1', 'HSPD1', 'RPA1', 'PDK3', 'ARL14EP', 'FLYWCH1', 'BLM', 'PIAS1', 'MRE11', 'VDAC1', 'RAD51', 'AFG3L2', 'HDAC6', 'ISCU', 'GPD1', 'PDK1', 'NSUN6', 'SDHB', 'FAF2', 'NFS1', 'CBX5', 'NDUFAB1', 'BRCA1', 'SDHA', 'MICU1', 'STAT5A', 'DLD', 'PDK2', 'MBD1', 'NDUFV3', 'TRIM28', 'BARD1', 'MICU2', 'MFN1', 'PEPD', 'PMPCB', 'UBA5', 'OGDH', 'PHB1', 'UFM1', 'STAT5B', 'BCKDHA']
198	GO:MF	GO:0000104	succinate dehydrogenase activity	3.572070306814854e-07	True	"""Catalysis of the reaction: succinate + acceptor = fumarate + reduced acceptor."" [GOC:kd]"	4	97	4	20195	0.0412371134020618	1.0	query_1	['GO:0016627']	['SDHD', 'SDHB', 'SDHA', 'SDHC']
199	GO:BP	GO:0006281	DNA repair	3.69871012998247e-07	True	"""The process of restoring DNA after damage. Genomes are subject to damage by chemical and physical agents in the environment (e.g. UV and ionizing radiations, chemical mutagens, fungal and bacterial toxins, etc.) and by free radicals or alkylating agents endogenously generated in metabolism. DNA is also damaged because of errors during its replication. A variety of different DNA repair pathways have been reported that include direct reversal, base excision repair, nucleotide excision repair, photoreactivation, bypass, double-strand break repair pathway, and mismatch repair pathway."" [PMID:11563486]"	591	96	18	21110	0.1875	0.0304568527918781	query_1	['GO:0006259', 'GO:0006974']	['RBBP8', 'NBN', 'TP53BP1', 'RAD50', 'XRCC6', 'PAXIP1', 'H2AX', 'UFL1', 'MDC1', 'BRCA2', 'SUMO1', 'RPA1', 'BLM', 'MRE11', 'RAD51', 'BRCA1', 'TRIM28', 'BARD1']
200	GO:BP	GO:1901988	negative regulation of cell cycle phase transition	4.109137617440138e-07	True	"""Any process that stops, prevents or reduces the frequency, rate or extent of cell cycle phase transition."" [GOC:mtg_cell_cycle, GOC:TermGenie, PMID:22841721]"	259	96	13	21110	0.1354166666666666	0.0501930501930501	query_1	['GO:0010948', 'GO:0044770', 'GO:1901987']	['RBBP8', 'CDK5RAP3', 'NBN', 'TP53BP1', 'RAD50', 'H2AX', 'MDC1', 'BRCA2', 'BLM', 'MRE11', 'RAD51', 'BRCA1', 'BARD1']
201	HPA	HPA:0170051	endometrium 2; glandular cells[≥Low]	4.2175551186944534e-07	True	endometrium 2; glandular cells[≥Low]	6714	83	75	11006	0.9036144578313252	0.0111706881143878	query_1	['HPA:0170000']	['RBBP8', 'UBE2I', 'PDK4', 'GCSH', 'PPM1K', 'SNX1', 'LYRM4', 'ADSL', 'CDK5RAP3', 'NBN', 'ATF7IP', 'DLST', 'HSPA9', 'TP53BP1', 'RAD50', 'UBAC2', 'XRCC6', 'PAXIP1', 'DLAT', 'PDHX', 'SETDB2', 'PDHB', 'H2AX', 'DDRGK1', 'UFL1', 'MDC1', 'PMPCA', 'PHB2', 'MCAT', 'SDHD', 'DBT', 'MCU', 'SIL1', 'BCKDK', 'BCKDHB', 'PDHA1', 'SUMO1', 'HSPD1', 'RPA1', 'PDK3', 'ARL14EP', 'FLYWCH1', 'BLM', 'PIAS1', 'MRE11', 'VDAC1', 'AFG3L2', 'HDAC6', 'ISCU', 'GPD1', 'PDK1', 'NSUN6', 'SDHB', 'FAF2', 'NFS1', 'CBX5', 'NDUFAB1', 'BRCA1', 'SDHA', 'MICU1', 'DLD', 'PDK2', 'MBD1', 'NDUFV3', 'TRIM28', 'BARD1', 'MICU2', 'MFN1', 'PEPD', 'PMPCB', 'UBA5', 'OGDH', 'PHB1', 'UFM1', 'BCKDHA']
202	HPA	HPA:0170000	endometrium 2	4.329732023321227e-07	True	endometrium 2	6908	83	76	11006	0.9156626506024096	0.0110017371163867	query_1	['HPA:0000000']	['RBBP8', 'SNX6', 'UBE2I', 'PDK4', 'GCSH', 'PPM1K', 'SNX1', 'LYRM4', 'ADSL', 'CDK5RAP3', 'NBN', 'ATF7IP', 'DLST', 'HSPA9', 'TP53BP1', 'RAD50', 'UBAC2', 'XRCC6', 'PAXIP1', 'DLAT', 'PDHX', 'SETDB2', 'PDHB', 'H2AX', 'DDRGK1', 'UFL1', 'MDC1', 'PMPCA', 'PHB2', 'MCAT', 'SDHD', 'DBT', 'MCU', 'SIL1', 'BCKDK', 'BCKDHB', 'PDHA1', 'SUMO1', 'HSPD1', 'RPA1', 'PDK3', 'ARL14EP', 'FLYWCH1', 'BLM', 'PIAS1', 'MRE11', 'VDAC1', 'AFG3L2', 'HDAC6', 'ISCU', 'GPD1', 'PDK1', 'NSUN6', 'SDHB', 'FAF2', 'NFS1', 'CBX5', 'NDUFAB1', 'BRCA1', 'SDHA', 'MICU1', 'DLD', 'PDK2', 'MBD1', 'NDUFV3', 'TRIM28', 'BARD1', 'MICU2', 'MFN1', 'PEPD', 'PMPCB', 'UBA5', 'OGDH', 'PHB1', 'UFM1', 'BCKDHA']
203	REAC	REAC:R-HSA-912446	Meiotic recombination	4.683070575002217e-07	True	Meiotic recombination	87	84	10	10790	0.119047619047619	0.1149425287356321	query_1	['REAC:R-HSA-1500620']	['RBBP8', 'NBN', 'RAD50', 'H2AX', 'BRCA2', 'RPA1', 'BLM', 'MRE11', 'RAD51', 'BRCA1']
204	GO:CC	GO:0035861	site of double-strand break	4.748683810233068e-07	True	"""A region of a chromosome at which a DNA double-strand break has occurred. DNA damage signaling and repair proteins accumulate at the lesion to respond to the damage and repair the DNA to form a continuous DNA helix."" [GOC:bf, GOC:mah, GOC:vw, PMID:20096808, PMID:21035408]"	77	97	8	22122	0.0824742268041237	0.1038961038961039	query_1	['GO:0090734']	['RBBP8', 'NBN', 'TP53BP1', 'RAD50', 'H2AX', 'UFL1', 'MRE11', 'RAD51']
205	HPA	HPA:0600000	tonsil	4.753383141797146e-07	True	tonsil	7779	83	80	11006	0.963855421686747	0.0102840982131379	query_1	['HPA:0000000']	['RBBP8', 'UBE2I', 'PDK4', 'GCSH', 'PPM1K', 'SNX1', 'LYRM4', 'ADSL', 'MAIP1', 'CDK5RAP3', 'NBN', 'ATF7IP', 'DLST', 'HSPA9', 'MCUB', 'TP53BP1', 'RAD50', 'UBAC2', 'XRCC6', 'PAXIP1', 'DLAT', 'PDHX', 'SETDB2', 'PDHB', 'H2AX', 'DDRGK1', 'UFL1', 'MDC1', 'PMPCA', 'PHB2', 'MCAT', 'SDHD', 'DBT', 'MCU', 'SIL1', 'BCKDK', 'BCKDHB', 'PDHA1', 'SUMO1', 'HSPD1', 'RPA1', 'PDK3', 'ARL14EP', 'FLYWCH1', 'BLM', 'PIAS1', 'MRE11', 'VDAC1', 'RAD51', 'AFG3L2', 'HDAC6', 'ISCU', 'GPD1', 'PDK1', 'NSUN6', 'SDHB', 'FAF2', 'NFS1', 'CBX5', 'NDUFAB1', 'BRCA1', 'SDHA', 'MICU1', 'STAT5A', 'DLD', 'PDK2', 'MBD1', 'NDUFV3', 'TRIM28', 'BARD1', 'MICU2', 'MFN1', 'PEPD', 'PMPCB', 'UBA5', 'OGDH', 'PHB1', 'UFM1', 'STAT5B', 'BCKDHA']
206	HPA	HPA:0590051	thyroid gland; glandular cells[≥Low]	4.891481600120951e-07	True	thyroid gland; glandular cells[≥Low]	7120	83	77	11006	0.927710843373494	0.010814606741573	query_1	['HPA:0590000']	['RBBP8', 'UBE2I', 'PDK4', 'GCSH', 'PPM1K', 'SNX1', 'LYRM4', 'ADSL', 'MAIP1', 'CDK5RAP3', 'NBN', 'ATF7IP', 'DLST', 'HSPA9', 'TP53BP1', 'RAD50', 'UBAC2', 'XRCC6', 'PAXIP1', 'DLAT', 'PDHX', 'SETDB2', 'PDHB', 'H2AX', 'DDRGK1', 'UFL1', 'MDC1', 'PMPCA', 'PHB2', 'MCAT', 'SDHD', 'DBT', 'MCU', 'SIL1', 'BCKDK', 'BCKDHB', 'PDHA1', 'SUMO1', 'HSPD1', 'RPA1', 'PDK3', 'ARL14EP', 'FLYWCH1', 'BLM', 'PIAS1', 'MRE11', 'VDAC1', 'AFG3L2', 'HDAC6', 'ISCU', 'GPD1', 'PDK1', 'NSUN6', 'SDHB', 'FAF2', 'NFS1', 'CBX5', 'NDUFAB1', 'BRCA1', 'SDHA', 'MICU1', 'STAT5A', 'DLD', 'PDK2', 'MBD1', 'NDUFV3', 'TRIM28', 'BARD1', 'MICU2', 'MFN1', 'PEPD', 'PMPCB', 'UBA5', 'OGDH', 'PHB1', 'UFM1', 'BCKDHA']
207	HPA	HPA:0590000	thyroid gland	4.891481600120951e-07	True	thyroid gland	7120	83	77	11006	0.927710843373494	0.010814606741573	query_1	['HPA:0000000']	['RBBP8', 'UBE2I', 'PDK4', 'GCSH', 'PPM1K', 'SNX1', 'LYRM4', 'ADSL', 'MAIP1', 'CDK5RAP3', 'NBN', 'ATF7IP', 'DLST', 'HSPA9', 'TP53BP1', 'RAD50', 'UBAC2', 'XRCC6', 'PAXIP1', 'DLAT', 'PDHX', 'SETDB2', 'PDHB', 'H2AX', 'DDRGK1', 'UFL1', 'MDC1', 'PMPCA', 'PHB2', 'MCAT', 'SDHD', 'DBT', 'MCU', 'SIL1', 'BCKDK', 'BCKDHB', 'PDHA1', 'SUMO1', 'HSPD1', 'RPA1', 'PDK3', 'ARL14EP', 'FLYWCH1', 'BLM', 'PIAS1', 'MRE11', 'VDAC1', 'AFG3L2', 'HDAC6', 'ISCU', 'GPD1', 'PDK1', 'NSUN6', 'SDHB', 'FAF2', 'NFS1', 'CBX5', 'NDUFAB1', 'BRCA1', 'SDHA', 'MICU1', 'STAT5A', 'DLD', 'PDK2', 'MBD1', 'NDUFV3', 'TRIM28', 'BARD1', 'MICU2', 'MFN1', 'PEPD', 'PMPCB', 'UBA5', 'OGDH', 'PHB1', 'UFM1', 'BCKDHA']
208	HPA	HPA:0630000	cervix	4.93901983189599e-07	True	cervix	6922	83	76	11006	0.9156626506024096	0.0109794856977752	query_1	['HPA:0000000']	['RBBP8', 'SNX6', 'UBE2I', 'PDK4', 'GCSH', 'PPM1K', 'SNX1', 'LYRM4', 'ADSL', 'CDK5RAP3', 'NBN', 'ATF7IP', 'DLST', 'MCUB', 'TP53BP1', 'RAD50', 'UBAC2', 'XRCC6', 'PAXIP1', 'DLAT', 'PDHX', 'SETDB2', 'PDHB', 'H2AX', 'DDRGK1', 'UFL1', 'MDC1', 'PMPCA', 'PHB2', 'MCAT', 'SDHD', 'DBT', 'MCU', 'SIL1', 'BCKDK', 'BCKDHB', 'PDHA1', 'SUMO1', 'HSPD1', 'RPA1', 'PDK3', 'ARL14EP', 'FLYWCH1', 'BLM', 'PIAS1', 'MRE11', 'VDAC1', 'RAD51', 'AFG3L2', 'HDAC6', 'ISCU', 'GPD1', 'PDK1', 'NSUN6', 'SDHB', 'FAF2', 'NFS1', 'CBX5', 'NDUFAB1', 'BRCA1', 'SDHA', 'MICU1', 'DLD', 'PDK2', 'MBD1', 'NDUFV3', 'TRIM28', 'MICU2', 'MFN1', 'PMPCB', 'UBA5', 'OGDH', 'PHB1', 'UFM1', 'STAT5B', 'BCKDHA']
209	GO:MF	GO:0016620	oxidoreductase activity, acting on the aldehyde or oxo group of donors, NAD or NADP as acceptor	5.538012067108329e-07	True	"""Catalysis of an oxidation-reduction (redox) reaction in which an aldehyde or ketone (oxo) group acts as a hydrogen or electron donor and reduces NAD or NADP."" [GOC:jl]"	40	97	7	20195	0.0721649484536082	0.175	query_1	['GO:0016903']	['DLAT', 'PDHA2', 'PDHX', 'PDHB', 'PDHA1', 'DLD', 'OGDH']
210	HPA	HPA:0350471	pancreas; exocrine glandular cells[≥Low]	5.579363715966523e-07	True	pancreas; exocrine glandular cells[≥Low]	6935	83	76	11006	0.9156626506024096	0.010958904109589	query_1	['HPA:0350000']	['RBBP8', 'PDK4', 'GCSH', 'PPM1K', 'SNX1', 'LYRM4', 'ADSL', 'MAIP1', 'CDK5RAP3', 'NBN', 'ATF7IP', 'DLST', 'HSPA9', 'MCUB', 'TP53BP1', 'RAD50', 'UBAC2', 'XRCC6', 'PAXIP1', 'DLAT', 'PDHX', 'SETDB2', 'PDHB', 'H2AX', 'DDRGK1', 'UFL1', 'MDC1', 'PMPCA', 'PHB2', 'MCAT', 'SDHD', 'DBT', 'MCU', 'SIL1', 'BCKDK', 'BCKDHB', 'PDHA1', 'SUMO1', 'HSPD1', 'RPA1', 'PDK3', 'ARL14EP', 'FLYWCH1', 'BLM', 'PIAS1', 'MRE11', 'VDAC1', 'AFG3L2', 'HDAC6', 'ISCU', 'GPD1', 'PDK1', 'NSUN6', 'SDHB', 'FAF2', 'NFS1', 'CBX5', 'NDUFAB1', 'BRCA1', 'SDHA', 'MICU1', 'STAT5A', 'DLD', 'PDK2', 'MBD1', 'NDUFV3', 'TRIM28', 'MICU2', 'MFN1', 'PEPD', 'PMPCB', 'UBA5', 'OGDH', 'PHB1', 'UFM1', 'BCKDHA']
211	REAC	REAC:R-HSA-1500620	Meiosis	5.829603332211783e-07	True	Meiosis	117	84	11	10790	0.1309523809523809	0.094017094017094	query_1	['REAC:R-HSA-1474165', 'REAC:R-HSA-1640170']	['RBBP8', 'UBE2I', 'NBN', 'RAD50', 'H2AX', 'BRCA2', 'RPA1', 'BLM', 'MRE11', 'RAD51', 'BRCA1']
212	GO:BP	GO:1901135	carbohydrate derivative metabolic process	6.22577910514398e-07	True	"""The chemical reactions and pathways involving carbohydrate derivative."" [GOC:TermGenie]"	1059	96	23	21110	0.2395833333333333	0.0217186024551463	query_1	['GO:0071704']	['PDK4', 'ADSL', 'DLST', 'TALDO1', 'DLAT', 'PDHA2', 'PDHX', 'PDHB', 'SDHD', 'PDHA1', 'PDK3', 'GPD1', 'PDK1', 'SDHB', 'NDUFAB1', 'SDHA', 'SDHC', 'DLD', 'PDK2', 'NDUFV3', 'MFN1', 'ABHD6', 'OGDH']
213	HPA	HPA:0241103	heart muscle; cardiomyocytes[High]	6.380081666505724e-07	True	heart muscle; cardiomyocytes[High]	1169	83	29	11006	0.3493975903614458	0.0248075278015397	query_1	['HPA:0241102']	['PDK4', 'GCSH', 'LYRM4', 'HSPA9', 'TP53BP1', 'RAD50', 'XRCC6', 'PAXIP1', 'PDHX', 'PDHB', 'PMPCA', 'PHB2', 'MCAT', 'SDHD', 'RPA1', 'FLYWCH1', 'BLM', 'PIAS1', 'MRE11', 'ISCU', 'SDHB', 'NDUFAB1', 'SDHA', 'DLD', 'NDUFV3', 'TRIM28', 'PMPCB', 'OGDH', 'BCKDHA']
214	GO:BP	GO:0006974	DNA damage response	7.629957026780601e-07	True	"""Any process that results in a change in state or activity of a cell (in terms of movement, secretion, enzyme production, gene expression, etc.) as a result of a stimulus indicating damage to its DNA from environmental insults or errors during metabolism."" [GOC:go_curators]"	878	96	21	21110	0.21875	0.0239179954441913	query_1	['GO:0033554']	['RBBP8', 'CDK5RAP3', 'NBN', 'TP53BP1', 'RAD50', 'XRCC6', 'PAXIP1', 'H2AX', 'UFL1', 'MDC1', 'BRCA2', 'SUMO1', 'RPA1', 'FLYWCH1', 'BLM', 'MRE11', 'RAD51', 'CBX5', 'BRCA1', 'TRIM28', 'BARD1']
215	GO:BP	GO:0010510	regulation of acetyl-CoA biosynthetic process from pyruvate	9.56151831450965e-07	True	"""Any process that modulates the frequency, rate or extent of the chemical reactions and pathways resulting in the formation of acetyl-CoA from pyruvate."" [GOC:dph, GOC:tb]"	4	96	4	21110	0.0416666666666666	1.0	query_1	['GO:0006086', 'GO:0050812']	['PDK4', 'PDK3', 'PDK1', 'PDK2']
216	HPA	HPA:0050051	breast; glandular cells[≥Low]	9.870168195297922e-07	True	breast; glandular cells[≥Low]	6805	83	75	11006	0.9036144578313252	0.0110213078618662	query_1	['HPA:0050000']	['RBBP8', 'SNX6', 'UBE2I', 'PDK4', 'GCSH', 'PPM1K', 'SNX1', 'LYRM4', 'ADSL', 'CDK5RAP3', 'NBN', 'ATF7IP', 'HSPA9', 'MCUB', 'TP53BP1', 'RAD50', 'XRCC6', 'PAXIP1', 'DLAT', 'PDHX', 'SETDB2', 'PDHB', 'H2AX', 'DDRGK1', 'UFL1', 'MDC1', 'PMPCA', 'PHB2', 'MCAT', 'SDHD', 'DBT', 'MCU', 'SIL1', 'BCKDK', 'BCKDHB', 'PDHA1', 'SUMO1', 'HSPD1', 'RPA1', 'ARL14EP', 'FLYWCH1', 'BLM', 'PIAS1', 'MRE11', 'VDAC1', 'AFG3L2', 'HDAC6', 'ISCU', 'GPD1', 'PDK1', 'NSUN6', 'SDHB', 'FAF2', 'NFS1', 'CBX5', 'NDUFAB1', 'BRCA1', 'SDHA', 'MICU1', 'STAT5A', 'DLD', 'PDK2', 'MBD1', 'NDUFV3', 'TRIM28', 'BARD1', 'MICU2', 'MFN1', 'PMPCB', 'UBA5', 'OGDH', 'PHB1', 'UFM1', 'STAT5B', 'BCKDHA']
217	GO:BP	GO:0010972	negative regulation of G2/M transition of mitotic cell cycle	1.0205338993907395e-06	True	"""Any signalling pathway that decreases or inhibits the activity of a cell cycle cyclin-dependent protein kinase to modulate the switch from G2 phase to M phase of the mitotic cell cycle."" [GOC:mtg_cell_cycle]"	63	96	8	21110	0.0833333333333333	0.1269841269841269	query_1	['GO:0000086', 'GO:0010389', 'GO:1901991', 'GO:1902750']	['RBBP8', 'CDK5RAP3', 'NBN', 'RAD50', 'BLM', 'MRE11', 'BRCA1', 'BARD1']
218	GO:BP	GO:0000725	recombinational repair	1.123507302191515e-06	True	"""A DNA repair process that involves the exchange, reciprocal or nonreciprocal, of genetic material between the broken DNA molecule and a homologous DNA region."" [GOC:elh]"	176	96	11	21110	0.1145833333333333	0.0625	query_1	['GO:0006281', 'GO:0006310']	['RBBP8', 'NBN', 'TP53BP1', 'XRCC6', 'H2AX', 'BRCA2', 'RPA1', 'BLM', 'MRE11', 'RAD51', 'BRCA1']
219	HPA	HPA:0301371	lung; alveolar cells type II[≥Low]	1.2040521637443027e-06	True	lung; alveolar cells type II[≥Low]	1533	83	33	11006	0.3975903614457831	0.0215264187866927	query_1	['HPA:0300000']	['ADSL', 'CDK5RAP3', 'NBN', 'DLST', 'HSPA9', 'TP53BP1', 'RAD50', 'XRCC6', 'PAXIP1', 'PDHX', 'H2AX', 'UFL1', 'PMPCA', 'PHB2', 'SIL1', 'BCKDK', 'BCKDHB', 'SUMO1', 'HSPD1', 'RPA1', 'PIAS1', 'MRE11', 'GPD1', 'SDHB', 'NFS1', 'CBX5', 'SDHA', 'DLD', 'PDK2', 'NDUFV3', 'TRIM28', 'PEPD', 'OGDH']
220	GO:BP	GO:1902750	negative regulation of cell cycle G2/M phase transition	1.3201796326427378e-06	True	"""Any signalling pathway that decreases or inhibits the activity of a cell cycle cyclin-dependent protein kinase to modulate the switch from G2 phase to M phase of the cell cycle."" [GO_REF:0000058, GOC:jl, GOC:TermGenie]"	65	96	8	21110	0.0833333333333333	0.123076923076923	query_1	['GO:0044839', 'GO:1901988', 'GO:1902749']	['RBBP8', 'CDK5RAP3', 'NBN', 'RAD50', 'BLM', 'MRE11', 'BRCA1', 'BARD1']
221	HPA	HPA:0220051	gallbladder; glandular cells[≥Low]	1.339373908998822e-06	True	gallbladder; glandular cells[≥Low]	7656	83	79	11006	0.9518072289156626	0.0103187042842215	query_1	['HPA:0220000']	['RBBP8', 'UBE2I', 'PDK4', 'GCSH', 'PPM1K', 'SNX1', 'LYRM4', 'ADSL', 'MAIP1', 'CDK5RAP3', 'NBN', 'ATF7IP', 'DLST', 'HSPA9', 'MCUB', 'TP53BP1', 'RAD50', 'UBAC2', 'XRCC6', 'PAXIP1', 'DLAT', 'PDHX', 'SETDB2', 'PDHB', 'H2AX', 'DDRGK1', 'UFL1', 'MDC1', 'PMPCA', 'PHB2', 'MCAT', 'SDHD', 'DBT', 'MCU', 'SIL1', 'BCKDK', 'BCKDHB', 'PDHA1', 'SUMO1', 'HSPD1', 'RPA1', 'ARL14EP', 'FLYWCH1', 'BLM', 'PIAS1', 'MRE11', 'VDAC1', 'RAD51', 'AFG3L2', 'HDAC6', 'ISCU', 'GPD1', 'PDK1', 'NSUN6', 'SDHB', 'FAF2', 'NFS1', 'CBX5', 'NDUFAB1', 'BRCA1', 'SDHA', 'MICU1', 'STAT5A', 'DLD', 'PDK2', 'MBD1', 'NDUFV3', 'TRIM28', 'BARD1', 'MICU2', 'MFN1', 'PEPD', 'PMPCB', 'UBA5', 'OGDH', 'PHB1', 'UFM1', 'STAT5B', 'BCKDHA']
222	HPA	HPA:0220000	gallbladder	1.339373908998822e-06	True	gallbladder	7656	83	79	11006	0.9518072289156626	0.0103187042842215	query_1	['HPA:0000000']	['RBBP8', 'UBE2I', 'PDK4', 'GCSH', 'PPM1K', 'SNX1', 'LYRM4', 'ADSL', 'MAIP1', 'CDK5RAP3', 'NBN', 'ATF7IP', 'DLST', 'HSPA9', 'MCUB', 'TP53BP1', 'RAD50', 'UBAC2', 'XRCC6', 'PAXIP1', 'DLAT', 'PDHX', 'SETDB2', 'PDHB', 'H2AX', 'DDRGK1', 'UFL1', 'MDC1', 'PMPCA', 'PHB2', 'MCAT', 'SDHD', 'DBT', 'MCU', 'SIL1', 'BCKDK', 'BCKDHB', 'PDHA1', 'SUMO1', 'HSPD1', 'RPA1', 'ARL14EP', 'FLYWCH1', 'BLM', 'PIAS1', 'MRE11', 'VDAC1', 'RAD51', 'AFG3L2', 'HDAC6', 'ISCU', 'GPD1', 'PDK1', 'NSUN6', 'SDHB', 'FAF2', 'NFS1', 'CBX5', 'NDUFAB1', 'BRCA1', 'SDHA', 'MICU1', 'STAT5A', 'DLD', 'PDK2', 'MBD1', 'NDUFV3', 'TRIM28', 'BARD1', 'MICU2', 'MFN1', 'PEPD', 'PMPCB', 'UBA5', 'OGDH', 'PHB1', 'UFM1', 'STAT5B', 'BCKDHA']
223	HPA	HPA:0020053	adrenal gland; glandular cells[High]	1.3603142489469495e-06	True	adrenal gland; glandular cells[High]	2287	83	41	11006	0.4939759036144578	0.0179274158285964	query_1	['HPA:0020052']	['PDK4', 'GCSH', 'LYRM4', 'ADSL', 'DLST', 'HSPA9', 'TP53BP1', 'XRCC6', 'PAXIP1', 'SETDB2', 'MDC1', 'PMPCA', 'PHB2', 'MCAT', 'DBT', 'MCU', 'SIL1', 'BCKDK', 'BCKDHB', 'PDHA1', 'SUMO1', 'HSPD1', 'RPA1', 'FLYWCH1', 'BLM', 'PIAS1', 'MRE11', 'AFG3L2', 'ISCU', 'SDHB', 'NFS1', 'NDUFAB1', 'SDHA', 'MICU1', 'DLD', 'PDK2', 'TRIM28', 'PMPCB', 'OGDH', 'PHB1', 'BCKDHA']
224	GO:MF	GO:0003684	damaged DNA binding	1.4025229686135617e-06	True	"""Binding to damaged DNA."" [GOC:jl]"	72	97	8	20195	0.0824742268041237	0.1111111111111111	query_1	['GO:0003677']	['RBBP8', 'NBN', 'TP53BP1', 'XRCC6', 'H2AX', 'RPA1', 'BLM', 'BRCA1']
225	HPA	HPA:0310442	lymph node; non-germinal center cells[≥Medium]	1.441997956702127e-06	True	lymph node; non-germinal center cells[≥Medium]	3981	83	56	11006	0.6746987951807228	0.0140668173825671	query_1	['HPA:0310441']	['RBBP8', 'UBE2I', 'PDK4', 'GCSH', 'PPM1K', 'LYRM4', 'ADSL', 'CDK5RAP3', 'NBN', 'ATF7IP', 'DLST', 'HSPA9', 'MCUB', 'TP53BP1', 'RAD50', 'XRCC6', 'PAXIP1', 'DLAT', 'PDHX', 'SETDB2', 'PDHB', 'H2AX', 'MDC1', 'PMPCA', 'PHB2', 'MCU', 'SIL1', 'BCKDK', 'PDHA1', 'SUMO1', 'RPA1', 'FLYWCH1', 'BLM', 'PIAS1', 'MRE11', 'AFG3L2', 'ISCU', 'GPD1', 'NSUN6', 'SDHB', 'BRCA1', 'SDHA', 'MICU1', 'STAT5A', 'DLD', 'PDK2', 'MBD1', 'NDUFV3', 'TRIM28', 'BARD1', 'PEPD', 'OGDH', 'PHB1', 'UFM1', 'STAT5B', 'BCKDHA']
226	HPA	HPA:0351182	pancreas; pancreatic endocrine cells[≥Medium]	1.5476273018181972e-06	True	pancreas; pancreatic endocrine cells[≥Medium]	3618	83	53	11006	0.6385542168674698	0.0146489773355444	query_1	['HPA:0351181']	['GCSH', 'PPM1K', 'LYRM4', 'ADSL', 'CDK5RAP3', 'NBN', 'ATF7IP', 'HSPA9', 'TP53BP1', 'RAD50', 'XRCC6', 'PAXIP1', 'DLAT', 'PDHX', 'SETDB2', 'H2AX', 'UFL1', 'PMPCA', 'PHB2', 'MCAT', 'DBT', 'MCU', 'SIL1', 'BCKDK', 'BCKDHB', 'PDHA1', 'SUMO1', 'RPA1', 'ARL14EP', 'FLYWCH1', 'BLM', 'PIAS1', 'MRE11', 'VDAC1', 'AFG3L2', 'HDAC6', 'ISCU', 'GPD1', 'NSUN6', 'SDHB', 'NFS1', 'CBX5', 'BRCA1', 'SDHA', 'DLD', 'PDK2', 'NDUFV3', 'TRIM28', 'MICU2', 'PMPCB', 'OGDH', 'UFM1', 'BCKDHA']
227	HPA	HPA:0210000	fallopian tube	1.614796800178407e-06	True	fallopian tube	7457	83	78	11006	0.9397590361445785	0.0104599704975191	query_1	['HPA:0000000']	['RBBP8', 'UBE2I', 'PDK4', 'GCSH', 'PPM1K', 'SNX1', 'LYRM4', 'ADSL', 'MAIP1', 'CDK5RAP3', 'NBN', 'ATF7IP', 'DLST', 'HSPA9', 'MCUB', 'TP53BP1', 'RAD50', 'XRCC6', 'PAXIP1', 'DLAT', 'PDHX', 'SETDB2', 'PDHB', 'H2AX', 'DDRGK1', 'UFL1', 'MDC1', 'PMPCA', 'PHB2', 'MCAT', 'SDHD', 'DBT', 'MCU', 'SIL1', 'BCKDK', 'BCKDHB', 'PDHA1', 'SUMO1', 'HSPD1', 'RPA1', 'PDK3', 'ARL14EP', 'FLYWCH1', 'BLM', 'PIAS1', 'MRE11', 'VDAC1', 'RAD51', 'AFG3L2', 'HDAC6', 'ISCU', 'GPD1', 'PDK1', 'NSUN6', 'SDHB', 'FAF2', 'NFS1', 'CBX5', 'NDUFAB1', 'BRCA1', 'SDHA', 'MICU1', 'STAT5A', 'DLD', 'PDK2', 'NDUFV3', 'TRIM28', 'BARD1', 'MICU2', 'MFN1', 'PEPD', 'PMPCB', 'UBA5', 'OGDH', 'PHB1', 'UFM1', 'STAT5B', 'BCKDHA']
228	HPA	HPA:0360053	parathyroid gland; glandular cells[High]	1.6221228016412837e-06	True	parathyroid gland; glandular cells[High]	1551	83	33	11006	0.3975903614457831	0.0212765957446808	query_1	['HPA:0360052']	['PDK4', 'GCSH', 'ADSL', 'DLST', 'TP53BP1', 'RAD50', 'PAXIP1', 'PDHX', 'SETDB2', 'PDHB', 'PMPCA', 'PHB2', 'MCAT', 'MCU', 'PDHA1', 'SUMO1', 'BLM', 'PIAS1', 'MRE11', 'VDAC1', 'AFG3L2', 'ISCU', 'SDHB', 'FAF2', 'CBX5', 'SDHA', 'MICU1', 'DLD', 'MICU2', 'UBA5', 'OGDH', 'PHB1', 'BCKDHA']
229	HPA	HPA:0530722	spleen; cells in white pulp[≥Medium]	1.6398798641629456e-06	True	spleen; cells in white pulp[≥Medium]	2715	83	45	11006	0.5421686746987951	0.0165745856353591	query_1	['HPA:0530721']	['UBE2I', 'PDK4', 'GCSH', 'PPM1K', 'LYRM4', 'ADSL', 'ATF7IP', 'DLST', 'HSPA9', 'TP53BP1', 'RAD50', 'XRCC6', 'PAXIP1', 'DLAT', 'PDHX', 'SETDB2', 'PDHB', 'H2AX', 'MDC1', 'PMPCA', 'PHB2', 'MCU', 'PDHA1', 'RPA1', 'FLYWCH1', 'BLM', 'PIAS1', 'MRE11', 'VDAC1', 'AFG3L2', 'PDK1', 'SDHB', 'NFS1', 'SDHA', 'MICU1', 'DLD', 'MBD1', 'NDUFV3', 'TRIM28', 'BARD1', 'PEPD', 'OGDH', 'PHB1', 'UFM1', 'BCKDHA']
230	GO:CC	GO:0016604	nuclear body	2.370667894307251e-06	True	"""Extra-nucleolar nuclear domains usually visualized by confocal microscopy and fluorescent antibodies to specific proteins."" [GOC:ma, PMID:10330182]"	885	97	19	22122	0.1958762886597938	0.0214689265536723	query_1	['GO:0005654', 'GO:0110165']	['UBE2I', 'LYRM4', 'NBN', 'ATF7IP', 'TP53BP1', 'ZNF350', 'H2AX', 'MDC1', 'SUMO1', 'RPA1', 'FLYWCH1', 'BLM', 'PIAS1', 'MRE11', 'RAD51', 'CBX5', 'BRCA1', 'MBD1', 'BARD1']
231	HPA	HPA:0610831	urinary bladder; urothelial cells[≥Low]	2.502204698337923e-06	True	urinary bladder; urothelial cells[≥Low]	7297	83	77	11006	0.927710843373494	0.0105522817596272	query_1	['HPA:0610000']	['RBBP8', 'SNX6', 'UBE2I', 'PDK4', 'GCSH', 'PPM1K', 'SNX1', 'LYRM4', 'ADSL', 'CDK5RAP3', 'NBN', 'ATF7IP', 'DLST', 'HSPA9', 'MCUB', 'TP53BP1', 'RAD50', 'UBAC2', 'XRCC6', 'PAXIP1', 'DLAT', 'PDHX', 'SETDB2', 'PDHB', 'H2AX', 'DDRGK1', 'UFL1', 'MDC1', 'PMPCA', 'PHB2', 'MCAT', 'SDHD', 'DBT', 'MCU', 'SIL1', 'BCKDK', 'BCKDHB', 'PDHA1', 'SUMO1', 'HSPD1', 'RPA1', 'ARL14EP', 'FLYWCH1', 'BLM', 'PIAS1', 'MRE11', 'VDAC1', 'RAD51', 'AFG3L2', 'HDAC6', 'ISCU', 'GPD1', 'PDK1', 'NSUN6', 'SDHB', 'FAF2', 'NFS1', 'CBX5', 'NDUFAB1', 'BRCA1', 'SDHA', 'MICU1', 'STAT5A', 'DLD', 'PDK2', 'MBD1', 'NDUFV3', 'TRIM28', 'MICU2', 'MFN1', 'PEPD', 'PMPCB', 'UBA5', 'OGDH', 'PHB1', 'UFM1', 'BCKDHA']
232	HPA	HPA:0610000	urinary bladder	2.502204698337923e-06	True	urinary bladder	7297	83	77	11006	0.927710843373494	0.0105522817596272	query_1	['HPA:0000000']	['RBBP8', 'SNX6', 'UBE2I', 'PDK4', 'GCSH', 'PPM1K', 'SNX1', 'LYRM4', 'ADSL', 'CDK5RAP3', 'NBN', 'ATF7IP', 'DLST', 'HSPA9', 'MCUB', 'TP53BP1', 'RAD50', 'UBAC2', 'XRCC6', 'PAXIP1', 'DLAT', 'PDHX', 'SETDB2', 'PDHB', 'H2AX', 'DDRGK1', 'UFL1', 'MDC1', 'PMPCA', 'PHB2', 'MCAT', 'SDHD', 'DBT', 'MCU', 'SIL1', 'BCKDK', 'BCKDHB', 'PDHA1', 'SUMO1', 'HSPD1', 'RPA1', 'ARL14EP', 'FLYWCH1', 'BLM', 'PIAS1', 'MRE11', 'VDAC1', 'RAD51', 'AFG3L2', 'HDAC6', 'ISCU', 'GPD1', 'PDK1', 'NSUN6', 'SDHB', 'FAF2', 'NFS1', 'CBX5', 'NDUFAB1', 'BRCA1', 'SDHA', 'MICU1', 'STAT5A', 'DLD', 'PDK2', 'MBD1', 'NDUFV3', 'TRIM28', 'MICU2', 'MFN1', 'PEPD', 'PMPCB', 'UBA5', 'OGDH', 'PHB1', 'UFM1', 'BCKDHA']
233	HPA	HPA:0400000	rectum	2.68016350277364e-06	True	rectum	7965	83	80	11006	0.963855421686747	0.010043942247332	query_1	['HPA:0000000']	['RBBP8', 'SNX6', 'UBE2I', 'PDK4', 'GCSH', 'PPM1K', 'SNX1', 'LYRM4', 'ADSL', 'MAIP1', 'CDK5RAP3', 'NBN', 'OTC', 'ATF7IP', 'DLST', 'HSPA9', 'MCUB', 'TP53BP1', 'RAD50', 'UBAC2', 'XRCC6', 'PAXIP1', 'DLAT', 'PDHX', 'SETDB2', 'PDHB', 'H2AX', 'DDRGK1', 'UFL1', 'MDC1', 'PMPCA', 'PHB2', 'MCAT', 'SDHD', 'DBT', 'MCU', 'SIL1', 'BCKDK', 'BCKDHB', 'PDHA1', 'SUMO1', 'HSPD1', 'RPA1', 'PDK3', 'ARL14EP', 'FLYWCH1', 'BLM', 'PIAS1', 'MRE11', 'VDAC1', 'RAD51', 'AFG3L2', 'HDAC6', 'ISCU', 'GPD1', 'PDK1', 'NSUN6', 'SDHB', 'FAF2', 'NFS1', 'CBX5', 'NDUFAB1', 'BRCA1', 'SDHA', 'MICU1', 'DLD', 'PDK2', 'MBD1', 'NDUFV3', 'TRIM28', 'MICU2', 'MFN1', 'PEPD', 'PMPCB', 'UBA5', 'OGDH', 'PHB1', 'UFM1', 'STAT5B', 'BCKDHA']
234	REAC	REAC:R-HSA-3108232	SUMO E3 ligases SUMOylate target proteins	2.702816620558011e-06	True	SUMO E3 ligases SUMOylate target proteins	170	84	12	10790	0.1428571428571428	0.0705882352941176	query_1	['REAC:R-HSA-2990846']	['UBE2I', 'TP53BP1', 'ZNF350', 'MDC1', 'SUMO1', 'RPA1', 'BLM', 'PIAS1', 'CBX5', 'BRCA1', 'MBD1', 'TRIM28']
235	GO:BP	GO:0010948	negative regulation of cell cycle process	2.81059287536525e-06	True	"""Any process that decreases the rate, frequency or extent of a cellular process that is involved in the progression of biochemical and morphological phases and events that occur in a cell during successive cell replication or nuclear replication events."" [GOC:dph, GOC:tb]"	303	96	13	21110	0.1354166666666666	0.0429042904290429	query_1	['GO:0010564', 'GO:0022402', 'GO:0045786']	['RBBP8', 'CDK5RAP3', 'NBN', 'TP53BP1', 'RAD50', 'H2AX', 'MDC1', 'BRCA2', 'BLM', 'MRE11', 'RAD51', 'BRCA1', 'BARD1']
236	HPA	HPA:0080121	caudate; glial cells[≥Low]	2.895191073639485e-06	True	caudate; glial cells[≥Low]	4572	83	60	11006	0.7228915662650602	0.0131233595800524	query_1	['HPA:0080000']	['PDK4', 'GCSH', 'PPM1K', 'SNX1', 'LYRM4', 'ADSL', 'MAIP1', 'CDK5RAP3', 'NBN', 'ATF7IP', 'DLST', 'HSPA9', 'TP53BP1', 'RAD50', 'UBAC2', 'XRCC6', 'PAXIP1', 'DLAT', 'PDHX', 'SETDB2', 'H2AX', 'MDC1', 'PMPCA', 'PHB2', 'MCAT', 'MCU', 'SIL1', 'BCKDK', 'SUMO1', 'HSPD1', 'RPA1', 'ARL14EP', 'FLYWCH1', 'BLM', 'PIAS1', 'MRE11', 'VDAC1', 'AFG3L2', 'HDAC6', 'ISCU', 'GPD1', 'PDK1', 'SDHB', 'NFS1', 'CBX5', 'NDUFAB1', 'BRCA1', 'SDHA', 'MICU1', 'DLD', 'MBD1', 'NDUFV3', 'TRIM28', 'BARD1', 'MICU2', 'UBA5', 'OGDH', 'PHB1', 'UFM1', 'BCKDHA']
237	HPA	HPA:0270000	kidney	2.9476254723787453e-06	True	kidney	8228	83	81	11006	0.9759036144578314	0.009844433641225	query_1	['HPA:0000000']	['RBBP8', 'SNX6', 'UBE2I', 'PDK4', 'GCSH', 'PPM1K', 'SNX1', 'LYRM4', 'ADSL', 'MAIP1', 'CDK5RAP3', 'NBN', 'ATF7IP', 'DLST', 'HSPA9', 'MCUB', 'TP53BP1', 'RAD50', 'UBAC2', 'XRCC6', 'PAXIP1', 'DLAT', 'PDHX', 'SETDB2', 'PDHB', 'H2AX', 'DDRGK1', 'UFL1', 'MDC1', 'PMPCA', 'PHB2', 'MCAT', 'SDHD', 'DBT', 'MCU', 'SIL1', 'BCKDK', 'BCKDHB', 'PDHA1', 'SUMO1', 'HSPD1', 'RPA1', 'PDK3', 'ARL14EP', 'FLYWCH1', 'BLM', 'PIAS1', 'MRE11', 'VDAC1', 'RAD51', 'AFG3L2', 'HDAC6', 'ISCU', 'GPD1', 'PDK1', 'NSUN6', 'SDHB', 'FAF2', 'NFS1', 'CBX5', 'NDUFAB1', 'BRCA1', 'SDHA', 'MICU1', 'STAT5A', 'DLD', 'PDK2', 'MBD1', 'NDUFV3', 'TRIM28', 'BARD1', 'MICU2', 'MFN1', 'PEPD', 'PMPCB', 'UBA5', 'OGDH', 'PHB1', 'UFM1', 'STAT5B', 'BCKDHA']
238	HPA	HPA:0180000	epididymis	3.370342383894694e-06	True	epididymis	7330	83	77	11006	0.927710843373494	0.0105047748976807	query_1	['HPA:0000000']	['RBBP8', 'SNX6', 'UBE2I', 'PDK4', 'GCSH', 'PPM1K', 'SNX1', 'LYRM4', 'ADSL', 'CDK5RAP3', 'NBN', 'ATF7IP', 'DLST', 'HSPA9', 'TP53BP1', 'RAD50', 'UBAC2', 'XRCC6', 'PAXIP1', 'DLAT', 'PDHX', 'SETDB2', 'PDHB', 'H2AX', 'DDRGK1', 'UFL1', 'MDC1', 'PMPCA', 'PHB2', 'MCAT', 'SDHD', 'DBT', 'MCU', 'SIL1', 'BCKDK', 'BCKDHB', 'PDHA1', 'SUMO1', 'HSPD1', 'RPA1', 'PDK3', 'ARL14EP', 'FLYWCH1', 'BLM', 'PIAS1', 'MRE11', 'VDAC1', 'AFG3L2', 'HDAC6', 'ISCU', 'GPD1', 'PDK1', 'NSUN6', 'SDHB', 'FAF2', 'NFS1', 'CBX5', 'NDUFAB1', 'BRCA1', 'SDHA', 'MICU1', 'DLD', 'PDK2', 'MBD1', 'NDUFV3', 'TRIM28', 'BARD1', 'MICU2', 'MFN1', 'PEPD', 'PMPCB', 'UBA5', 'OGDH', 'PHB1', 'UFM1', 'STAT5B', 'BCKDHA']
239	HPA	HPA:0180051	epididymis; glandular cells[≥Low]	3.370342383894694e-06	True	epididymis; glandular cells[≥Low]	7330	83	77	11006	0.927710843373494	0.0105047748976807	query_1	['HPA:0180000']	['RBBP8', 'SNX6', 'UBE2I', 'PDK4', 'GCSH', 'PPM1K', 'SNX1', 'LYRM4', 'ADSL', 'CDK5RAP3', 'NBN', 'ATF7IP', 'DLST', 'HSPA9', 'TP53BP1', 'RAD50', 'UBAC2', 'XRCC6', 'PAXIP1', 'DLAT', 'PDHX', 'SETDB2', 'PDHB', 'H2AX', 'DDRGK1', 'UFL1', 'MDC1', 'PMPCA', 'PHB2', 'MCAT', 'SDHD', 'DBT', 'MCU', 'SIL1', 'BCKDK', 'BCKDHB', 'PDHA1', 'SUMO1', 'HSPD1', 'RPA1', 'PDK3', 'ARL14EP', 'FLYWCH1', 'BLM', 'PIAS1', 'MRE11', 'VDAC1', 'AFG3L2', 'HDAC6', 'ISCU', 'GPD1', 'PDK1', 'NSUN6', 'SDHB', 'FAF2', 'NFS1', 'CBX5', 'NDUFAB1', 'BRCA1', 'SDHA', 'MICU1', 'DLD', 'PDK2', 'MBD1', 'NDUFV3', 'TRIM28', 'BARD1', 'MICU2', 'MFN1', 'PEPD', 'PMPCB', 'UBA5', 'OGDH', 'PHB1', 'UFM1', 'STAT5B', 'BCKDHA']
240	GO:BP	GO:0033143	regulation of intracellular steroid hormone receptor signaling pathway	3.412996311826849e-06	True	"""Any process that modulates the frequency, rate or extent of the activity of any intracellular steroid hormone receptor signaling pathway."" [GOC:mah]"	73	96	8	21110	0.0833333333333333	0.1095890410958904	query_1	['GO:0009966', 'GO:0030518']	['DDRGK1', 'UFL1', 'PHB2', 'HDAC6', 'BRCA1', 'UBA5', 'PHB1', 'UFM1']
241	REAC	REAC:R-HSA-70895	Branched-chain amino acid catabolism	3.7017739211221807e-06	True	Branched-chain amino acid catabolism	21	84	6	10790	0.0714285714285714	0.2857142857142857	query_1	['REAC:R-HSA-71291']	['PPM1K', 'DBT', 'BCKDK', 'BCKDHB', 'DLD', 'BCKDHA']
242	GO:CC	GO:0031981	nuclear lumen	3.983564030104742e-06	True	"""The volume enclosed by the nuclear inner membrane."" [GOC:mah, GOC:pz]"	5499	97	50	22122	0.5154639175257731	0.0090925622840516	query_1	['GO:0005634', 'GO:0070013']	['RBBP8', 'UBE2I', 'LYRM4', 'CDK5RAP3', 'NBN', 'ATF7IP', 'DLST', 'HSPA9', 'MCUB', 'TP53BP1', 'RAD50', 'ZNF45', 'ZNF350', 'XRCC6', 'PAXIP1', 'PDHA2', 'SETDB2', 'PDHB', 'H2AX', 'DDRGK1', 'MDC1', 'PHB2', 'BRCA2', 'SETDB1', 'BCKDHB', 'PDHA1', 'SUMO1', 'RPA1', 'PDK3', 'ARL14EP', 'FLYWCH1', 'BLM', 'PIAS1', 'MRE11', 'RAD51', 'HDAC6', 'SDHB', 'NFS1', 'CBX5', 'NDUFAB1', 'BRCA1', 'SDHA', 'STAT5A', 'SMDT1', 'PDK2', 'MBD1', 'TRIM28', 'BARD1', 'PHB1', 'STAT5B']
243	REAC	REAC:R-HSA-2990846	SUMOylation	4.002756992404237e-06	True	SUMOylation	176	84	12	10790	0.1428571428571428	0.0681818181818181	query_1	['REAC:R-HSA-597592']	['UBE2I', 'TP53BP1', 'ZNF350', 'MDC1', 'SUMO1', 'RPA1', 'BLM', 'PIAS1', 'CBX5', 'BRCA1', 'MBD1', 'TRIM28']
244	GO:BP	GO:0071479	cellular response to ionizing radiation	4.25192311855576e-06	True	"""Any process that results in a change in state or activity of a cell (in terms of movement, secretion, enzyme production, gene expression, etc.) as a result of a ionizing radiation stimulus. Ionizing radiation is radiation with sufficient energy to remove electrons from atoms and may arise from spontaneous decay of unstable isotopes, resulting in alpha and beta particles and gamma rays. Ionizing radiation also includes X-rays."" [GOC:mah]"	75	96	8	21110	0.0833333333333333	0.1066666666666666	query_1	['GO:0010212', 'GO:0071478']	['TP53BP1', 'XRCC6', 'H2AX', 'BRCA2', 'BLM', 'RAD51', 'BRCA1', 'BARD1']
245	HPA	HPA:0530711	spleen; cells in red pulp[≥Low]	4.419537983112401e-06	True	spleen; cells in red pulp[≥Low]	5322	83	65	11006	0.7831325301204819	0.0122134535888763	query_1	['HPA:0530000']	['RBBP8', 'UBE2I', 'PDK4', 'GCSH', 'PPM1K', 'LYRM4', 'ADSL', 'CDK5RAP3', 'NBN', 'ATF7IP', 'DLST', 'HSPA9', 'MCUB', 'TP53BP1', 'RAD50', 'UBAC2', 'XRCC6', 'PAXIP1', 'DLAT', 'PDHX', 'SETDB2', 'H2AX', 'DDRGK1', 'MDC1', 'PMPCA', 'PHB2', 'SDHD', 'MCU', 'BCKDK', 'BCKDHB', 'PDHA1', 'SUMO1', 'HSPD1', 'RPA1', 'ARL14EP', 'FLYWCH1', 'BLM', 'PIAS1', 'MRE11', 'VDAC1', 'AFG3L2', 'HDAC6', 'ISCU', 'PDK1', 'SDHB', 'FAF2', 'NFS1', 'CBX5', 'BRCA1', 'SDHA', 'MICU1', 'DLD', 'PDK2', 'MBD1', 'NDUFV3', 'TRIM28', 'BARD1', 'MFN1', 'PEPD', 'PMPCB', 'OGDH', 'PHB1', 'UFM1', 'STAT5B', 'BCKDHA']
246	GO:BP	GO:1902749	regulation of cell cycle G2/M phase transition	4.660990554998144e-06	True	"""Any signalling pathway that modulates the activity of a cell cycle cyclin-dependent protein kinase to modulate the switch from G2 phase to M phase of the cell cycle."" [GO_REF:0000058, GOC:jl, GOC:TermGenie]"	111	96	9	21110	0.09375	0.081081081081081	query_1	['GO:0044839', 'GO:1901987']	['RBBP8', 'CDK5RAP3', 'NBN', 'RAD50', 'PAXIP1', 'BLM', 'MRE11', 'BRCA1', 'BARD1']
247	GO:BP	GO:0044272	sulfur compound biosynthetic process	4.686217356164167e-06	True	"""The chemical reactions and pathways resulting in the formation of compounds that contain sulfur, such as the amino acids methionine and cysteine or the tripeptide glutathione."" [GOC:jl]"	153	96	10	21110	0.1041666666666666	0.065359477124183	query_1	['GO:0006790', 'GO:0044249']	['PDK4', 'DLAT', 'PDHA2', 'PDHX', 'PDHB', 'PDHA1', 'PDK3', 'PDK1', 'DLD', 'PDK2']
248	GO:BP	GO:1990564	protein polyufmylation	4.764087884916421e-06	True	"""Covalent attachment of the ubiquitin-like protein UFM1 to a protein, forming an UFM1 chain."" [PMID:25219498]"	5	96	4	21110	0.0416666666666666	0.8	query_1	['GO:0071569']	['DDRGK1', 'UFL1', 'UBA5', 'UFM1']
249	GO:BP	GO:1990592	protein K69-linked ufmylation	4.764087884916421e-06	True	"""A protein ufmylation process in which a polymer of the ubiquitin-like protein UFM1 is formed by linkages between lysine residues at position 69 of the UFM1 monomers, is added to a protein."" [PMID:25219498]"	5	96	4	21110	0.0416666666666666	0.8	query_1	['GO:1990564']	['DDRGK1', 'UFL1', 'UBA5', 'UFM1']
250	GO:BP	GO:0050812	regulation of acyl-CoA biosynthetic process	4.764087884916421e-06	True	"""Any process that modulates the frequency, rate or extent of the chemical reactions and pathways resulting in the formation of acyl-CoA."" [GOC:ai]"	5	96	4	21110	0.0416666666666666	0.8	query_1	['GO:0019217', 'GO:0034248', 'GO:0042762', 'GO:0071616', 'GO:1900371']	['PDK4', 'PDK3', 'PDK1', 'PDK2']
251	HPA	HPA:0300000	lung	4.822684096989735e-06	True	lung	7370	83	77	11006	0.927710843373494	0.0104477611940298	query_1	['HPA:0000000']	['RBBP8', 'SNX6', 'UBE2I', 'PDK4', 'PPM1K', 'SNX1', 'LYRM4', 'ADSL', 'MAIP1', 'CDK5RAP3', 'NBN', 'ATF7IP', 'DLST', 'HSPA9', 'TP53BP1', 'RAD50', 'XRCC6', 'PAXIP1', 'DLAT', 'PDHX', 'SETDB2', 'PDHB', 'H2AX', 'DDRGK1', 'UFL1', 'MDC1', 'PMPCA', 'PHB2', 'MCAT', 'SDHD', 'DBT', 'MCU', 'SIL1', 'BCKDK', 'BCKDHB', 'PDHA1', 'SUMO1', 'HSPD1', 'RPA1', 'PDK3', 'ARL14EP', 'FLYWCH1', 'BLM', 'PIAS1', 'MRE11', 'VDAC1', 'RAD51', 'AFG3L2', 'HDAC6', 'ISCU', 'GPD1', 'PDK1', 'NSUN6', 'SDHB', 'FAF2', 'NFS1', 'CBX5', 'NDUFAB1', 'BRCA1', 'SDHA', 'MICU1', 'STAT5A', 'DLD', 'PDK2', 'MBD1', 'NDUFV3', 'TRIM28', 'BARD1', 'MICU2', 'MFN1', 'PEPD', 'PMPCB', 'OGDH', 'PHB1', 'UFM1', 'STAT5B', 'BCKDHA']
252	HP	HP:0003128	Lactic acidosis	4.914470643758588e-06	True	An abnormal buildup of lactic acid in the body, leading to acidification of the blood and other bodily fluids.	176	54	14	4851	0.2592592592592592	0.0795454545454545	query_1	['HP:0001941']	['LYRM4', 'DLAT', 'PDHX', 'PDHB', 'PMPCA', 'SDHD', 'DBT', 'BCKDHB', 'PDHA1', 'ISCU', 'SDHA', 'DLD', 'OGDH', 'BCKDHA']
253	REAC	REAC:R-HSA-1474165	Reproduction	4.9307762883880764e-06	True	Reproduction	143	84	11	10790	0.1309523809523809	0.0769230769230769	query_1	['REAC:0000000']	['RBBP8', 'UBE2I', 'NBN', 'RAD50', 'H2AX', 'BRCA2', 'RPA1', 'BLM', 'MRE11', 'RAD51', 'BRCA1']
254	HPA	HPA:0050000	breast	5.034601206262108e-06	True	breast	7176	83	76	11006	0.9156626506024096	0.0105908584169453	query_1	['HPA:0000000']	['RBBP8', 'SNX6', 'UBE2I', 'PDK4', 'GCSH', 'PPM1K', 'SNX1', 'LYRM4', 'ADSL', 'CDK5RAP3', 'NBN', 'ATF7IP', 'HSPA9', 'MCUB', 'TP53BP1', 'RAD50', 'XRCC6', 'PAXIP1', 'DLAT', 'PDHX', 'SETDB2', 'PDHB', 'H2AX', 'DDRGK1', 'UFL1', 'MDC1', 'PMPCA', 'PHB2', 'MCAT', 'SDHD', 'DBT', 'MCU', 'SIL1', 'BCKDK', 'BCKDHB', 'PDHA1', 'SUMO1', 'HSPD1', 'RPA1', 'PDK3', 'ARL14EP', 'FLYWCH1', 'BLM', 'PIAS1', 'MRE11', 'VDAC1', 'AFG3L2', 'HDAC6', 'ISCU', 'GPD1', 'PDK1', 'NSUN6', 'SDHB', 'FAF2', 'NFS1', 'CBX5', 'NDUFAB1', 'BRCA1', 'SDHA', 'MICU1', 'STAT5A', 'DLD', 'PDK2', 'MBD1', 'NDUFV3', 'TRIM28', 'BARD1', 'MICU2', 'MFN1', 'PMPCB', 'UBA5', 'OGDH', 'PHB1', 'UFM1', 'STAT5B', 'BCKDHA']
255	HP	HP:0033107	Abnormal circulating proteinogenic amino acid concentration	5.068694490928341e-06	True	An elevated level of a proteinogenic amino acid in the blood circulation. These are the 23 alpha-amino acids that are precursors to proteins, and are incorporated into proteins during translation. The group includes the 20 amino acids encoded by the nuclear genes of eukaryotes together with selenocysteine, pyrrolysine, and N-formylmethionine.	94	54	11	4851	0.2037037037037037	0.1170212765957446	query_1	['HP:0003112']	['GCSH', 'PPM1K', 'OTC', 'TALDO1', 'DBT', 'BCKDK', 'BCKDHB', 'NFS1', 'MICU1', 'DLD', 'BCKDHA']
256	GO:BP	GO:0044271	cellular nitrogen compound biosynthetic process	5.459651389249226e-06	True	"""The chemical reactions and pathways resulting in the formation of organic and inorganic nitrogenous compounds."" [GOC:jl, ISBN:0198506732]"	4878	96	49	21110	0.5104166666666666	0.0100451004510045	query_1	['GO:0034641', 'GO:0044249']	['RBBP8', 'SNX6', 'UBE2I', 'PDK4', 'ADSL', 'CDK5RAP3', 'OTC', 'ATF7IP', 'TP53BP1', 'RAD50', 'ZNF45', 'ZNF350', 'XRCC6', 'PAXIP1', 'DLAT', 'PDHA2', 'PDHX', 'SETDB2', 'PDHB', 'DDRGK1', 'UFL1', 'PHB2', 'SDHD', 'BRCA2', 'SETDB1', 'PDHA1', 'SUMO1', 'RPA1', 'PDK3', 'FLYWCH1', 'BLM', 'PIAS1', 'MRE11', 'HDAC6', 'PDK1', 'SDHB', 'CBX5', 'NDUFAB1', 'BRCA1', 'SDHA', 'STAT5A', 'SDHC', 'DLD', 'PDK2', 'MBD1', 'NDUFV3', 'TRIM28', 'PHB1', 'STAT5B']
257	HPA	HPA:0030052	appendix; glandular cells[≥Medium]	5.712970656741264e-06	True	appendix; glandular cells[≥Medium]	5499	83	66	11006	0.7951807228915663	0.0120021822149481	query_1	['HPA:0030051']	['RBBP8', 'UBE2I', 'PDK4', 'GCSH', 'PPM1K', 'SNX1', 'LYRM4', 'ADSL', 'MAIP1', 'NBN', 'ATF7IP', 'DLST', 'HSPA9', 'MCUB', 'UBAC2', 'XRCC6', 'PAXIP1', 'DLAT', 'PDHX', 'SETDB2', 'PDHB', 'H2AX', 'DDRGK1', 'UFL1', 'MDC1', 'PMPCA', 'MCAT', 'SDHD', 'DBT', 'MCU', 'BCKDK', 'BCKDHB', 'PDHA1', 'RPA1', 'ARL14EP', 'FLYWCH1', 'BLM', 'PIAS1', 'MRE11', 'VDAC1', 'AFG3L2', 'HDAC6', 'ISCU', 'PDK1', 'NSUN6', 'SDHB', 'FAF2', 'NFS1', 'CBX5', 'NDUFAB1', 'BRCA1', 'SDHA', 'MICU1', 'DLD', 'PDK2', 'MBD1', 'NDUFV3', 'MICU2', 'MFN1', 'PEPD', 'PMPCB', 'UBA5', 'OGDH', 'PHB1', 'UFM1', 'BCKDHA']
258	HPA	HPA:0550051	stomach 2; glandular cells[≥Low]	6.0931796987525305e-06	True	stomach 2; glandular cells[≥Low]	7604	83	78	11006	0.9397590361445785	0.0102577590741714	query_1	['HPA:0550000']	['RBBP8', 'SNX6', 'UBE2I', 'PDK4', 'GCSH', 'PPM1K', 'LYRM4', 'ADSL', 'MAIP1', 'CDK5RAP3', 'NBN', 'ATF7IP', 'DLST', 'HSPA9', 'MCUB', 'TP53BP1', 'RAD50', 'UBAC2', 'XRCC6', 'PAXIP1', 'DLAT', 'PDHX', 'SETDB2', 'PDHB', 'H2AX', 'DDRGK1', 'UFL1', 'MDC1', 'PMPCA', 'PHB2', 'MCAT', 'SDHD', 'DBT', 'MCU', 'SIL1', 'BCKDK', 'BCKDHB', 'PDHA1', 'SUMO1', 'HSPD1', 'RPA1', 'ARL14EP', 'FLYWCH1', 'BLM', 'PIAS1', 'MRE11', 'VDAC1', 'RAD51', 'AFG3L2', 'HDAC6', 'ISCU', 'GPD1', 'PDK1', 'NSUN6', 'SDHB', 'FAF2', 'NFS1', 'CBX5', 'NDUFAB1', 'BRCA1', 'SDHA', 'MICU1', 'DLD', 'PDK2', 'MBD1', 'NDUFV3', 'TRIM28', 'BARD1', 'MICU2', 'MFN1', 'PEPD', 'PMPCB', 'UBA5', 'OGDH', 'PHB1', 'UFM1', 'STAT5B', 'BCKDHA']
259	HPA	HPA:0550000	stomach 2	6.0931796987525305e-06	True	stomach 2	7604	83	78	11006	0.9397590361445785	0.0102577590741714	query_1	['HPA:0000000']	['RBBP8', 'SNX6', 'UBE2I', 'PDK4', 'GCSH', 'PPM1K', 'LYRM4', 'ADSL', 'MAIP1', 'CDK5RAP3', 'NBN', 'ATF7IP', 'DLST', 'HSPA9', 'MCUB', 'TP53BP1', 'RAD50', 'UBAC2', 'XRCC6', 'PAXIP1', 'DLAT', 'PDHX', 'SETDB2', 'PDHB', 'H2AX', 'DDRGK1', 'UFL1', 'MDC1', 'PMPCA', 'PHB2', 'MCAT', 'SDHD', 'DBT', 'MCU', 'SIL1', 'BCKDK', 'BCKDHB', 'PDHA1', 'SUMO1', 'HSPD1', 'RPA1', 'ARL14EP', 'FLYWCH1', 'BLM', 'PIAS1', 'MRE11', 'VDAC1', 'RAD51', 'AFG3L2', 'HDAC6', 'ISCU', 'GPD1', 'PDK1', 'NSUN6', 'SDHB', 'FAF2', 'NFS1', 'CBX5', 'NDUFAB1', 'BRCA1', 'SDHA', 'MICU1', 'DLD', 'PDK2', 'MBD1', 'NDUFV3', 'TRIM28', 'BARD1', 'MICU2', 'MFN1', 'PEPD', 'PMPCB', 'UBA5', 'OGDH', 'PHB1', 'UFM1', 'STAT5B', 'BCKDHA']
260	HPA	HPA:0350000	pancreas	6.2973538181605865e-06	True	pancreas	7400	83	77	11006	0.927710843373494	0.0104054054054054	query_1	['HPA:0000000']	['RBBP8', 'UBE2I', 'PDK4', 'GCSH', 'PPM1K', 'SNX1', 'LYRM4', 'ADSL', 'MAIP1', 'CDK5RAP3', 'NBN', 'ATF7IP', 'DLST', 'HSPA9', 'MCUB', 'TP53BP1', 'RAD50', 'UBAC2', 'XRCC6', 'PAXIP1', 'DLAT', 'PDHX', 'SETDB2', 'PDHB', 'H2AX', 'DDRGK1', 'UFL1', 'MDC1', 'PMPCA', 'PHB2', 'MCAT', 'SDHD', 'DBT', 'MCU', 'SIL1', 'BCKDK', 'BCKDHB', 'PDHA1', 'SUMO1', 'HSPD1', 'RPA1', 'PDK3', 'ARL14EP', 'FLYWCH1', 'BLM', 'PIAS1', 'MRE11', 'VDAC1', 'AFG3L2', 'HDAC6', 'ISCU', 'GPD1', 'PDK1', 'NSUN6', 'SDHB', 'FAF2', 'NFS1', 'CBX5', 'NDUFAB1', 'BRCA1', 'SDHA', 'MICU1', 'STAT5A', 'DLD', 'PDK2', 'MBD1', 'NDUFV3', 'TRIM28', 'MICU2', 'MFN1', 'PEPD', 'PMPCB', 'UBA5', 'OGDH', 'PHB1', 'UFM1', 'BCKDHA']
261	HPA	HPA:0130052	colon; glandular cells[≥Medium]	6.410717304354308e-06	True	colon; glandular cells[≥Medium]	5977	83	69	11006	0.8313253012048193	0.0115442529697172	query_1	['HPA:0130051']	['RBBP8', 'SNX6', 'UBE2I', 'PDK4', 'GCSH', 'PPM1K', 'SNX1', 'LYRM4', 'ADSL', 'MAIP1', 'NBN', 'ATF7IP', 'DLST', 'HSPA9', 'MCUB', 'UBAC2', 'XRCC6', 'PAXIP1', 'DLAT', 'PDHX', 'SETDB2', 'PDHB', 'H2AX', 'DDRGK1', 'UFL1', 'MDC1', 'PMPCA', 'MCAT', 'SDHD', 'DBT', 'MCU', 'BCKDK', 'BCKDHB', 'PDHA1', 'SUMO1', 'RPA1', 'ARL14EP', 'FLYWCH1', 'BLM', 'PIAS1', 'MRE11', 'VDAC1', 'AFG3L2', 'HDAC6', 'ISCU', 'PDK1', 'NSUN6', 'SDHB', 'FAF2', 'NFS1', 'CBX5', 'NDUFAB1', 'BRCA1', 'SDHA', 'MICU1', 'DLD', 'PDK2', 'MBD1', 'NDUFV3', 'BARD1', 'MICU2', 'MFN1', 'PEPD', 'PMPCB', 'UBA5', 'OGDH', 'PHB1', 'UFM1', 'BCKDHA']
262	HPA	HPA:0020051	adrenal gland; glandular cells[≥Low]	6.64118490500626e-06	True	adrenal gland; glandular cells[≥Low]	7406	83	77	11006	0.927710843373494	0.0103969754253308	query_1	['HPA:0020000']	['RBBP8', 'UBE2I', 'PDK4', 'GCSH', 'PPM1K', 'SNX1', 'LYRM4', 'ADSL', 'MAIP1', 'CDK5RAP3', 'NBN', 'ATF7IP', 'DLST', 'HSPA9', 'TP53BP1', 'RAD50', 'UBAC2', 'XRCC6', 'PAXIP1', 'DLAT', 'PDHX', 'SETDB2', 'PDHB', 'H2AX', 'DDRGK1', 'UFL1', 'MDC1', 'PMPCA', 'PHB2', 'MCAT', 'SDHD', 'DBT', 'MCU', 'SIL1', 'BCKDK', 'BCKDHB', 'PDHA1', 'SUMO1', 'HSPD1', 'RPA1', 'ARL14EP', 'FLYWCH1', 'BLM', 'PIAS1', 'MRE11', 'VDAC1', 'RAD51', 'AFG3L2', 'HDAC6', 'ISCU', 'GPD1', 'PDK1', 'NSUN6', 'SDHB', 'FAF2', 'NFS1', 'CBX5', 'NDUFAB1', 'BRCA1', 'SDHA', 'MICU1', 'STAT5A', 'DLD', 'PDK2', 'MBD1', 'NDUFV3', 'TRIM28', 'MICU2', 'MFN1', 'PEPD', 'PMPCB', 'UBA5', 'OGDH', 'PHB1', 'UFM1', 'STAT5B', 'BCKDHA']
263	HPA	HPA:0020000	adrenal gland	7.065527950382375e-06	True	adrenal gland	7413	83	77	11006	0.927710843373494	0.0103871576959395	query_1	['HPA:0000000']	['RBBP8', 'UBE2I', 'PDK4', 'GCSH', 'PPM1K', 'SNX1', 'LYRM4', 'ADSL', 'MAIP1', 'CDK5RAP3', 'NBN', 'ATF7IP', 'DLST', 'HSPA9', 'TP53BP1', 'RAD50', 'UBAC2', 'XRCC6', 'PAXIP1', 'DLAT', 'PDHX', 'SETDB2', 'PDHB', 'H2AX', 'DDRGK1', 'UFL1', 'MDC1', 'PMPCA', 'PHB2', 'MCAT', 'SDHD', 'DBT', 'MCU', 'SIL1', 'BCKDK', 'BCKDHB', 'PDHA1', 'SUMO1', 'HSPD1', 'RPA1', 'ARL14EP', 'FLYWCH1', 'BLM', 'PIAS1', 'MRE11', 'VDAC1', 'RAD51', 'AFG3L2', 'HDAC6', 'ISCU', 'GPD1', 'PDK1', 'NSUN6', 'SDHB', 'FAF2', 'NFS1', 'CBX5', 'NDUFAB1', 'BRCA1', 'SDHA', 'MICU1', 'STAT5A', 'DLD', 'PDK2', 'MBD1', 'NDUFV3', 'TRIM28', 'MICU2', 'MFN1', 'PEPD', 'PMPCB', 'UBA5', 'OGDH', 'PHB1', 'UFM1', 'STAT5B', 'BCKDHA']
264	HPA	HPA:0430052	seminal vesicle; glandular cells[≥Medium]	7.283135587572245e-06	True	seminal vesicle; glandular cells[≥Medium]	5230	83	64	11006	0.7710843373493976	0.0122370936902485	query_1	['HPA:0430051']	['PDK4', 'GCSH', 'PPM1K', 'SNX1', 'LYRM4', 'ADSL', 'CDK5RAP3', 'NBN', 'ATF7IP', 'DLST', 'HSPA9', 'TP53BP1', 'RAD50', 'XRCC6', 'PAXIP1', 'PDHX', 'SETDB2', 'PDHB', 'H2AX', 'DDRGK1', 'UFL1', 'MDC1', 'PMPCA', 'PHB2', 'MCAT', 'SDHD', 'DBT', 'MCU', 'SIL1', 'BCKDK', 'BCKDHB', 'PDHA1', 'SUMO1', 'RPA1', 'ARL14EP', 'FLYWCH1', 'PIAS1', 'MRE11', 'VDAC1', 'AFG3L2', 'ISCU', 'GPD1', 'PDK1', 'NSUN6', 'SDHB', 'FAF2', 'NFS1', 'CBX5', 'BRCA1', 'SDHA', 'MICU1', 'DLD', 'PDK2', 'NDUFV3', 'TRIM28', 'BARD1', 'MFN1', 'PEPD', 'PMPCB', 'UBA5', 'OGDH', 'PHB1', 'UFM1', 'BCKDHA']
265	HPA	HPA:0390052	prostate; glandular cells[≥Medium]	7.340082621530096e-06	True	prostate; glandular cells[≥Medium]	4806	83	61	11006	0.7349397590361446	0.0126924677486475	query_1	['HPA:0390051']	['PDK4', 'GCSH', 'PPM1K', 'SNX1', 'LYRM4', 'ADSL', 'MAIP1', 'CDK5RAP3', 'HSPA9', 'TP53BP1', 'RAD50', 'XRCC6', 'PAXIP1', 'DLAT', 'PDHX', 'SETDB2', 'PDHB', 'H2AX', 'UFL1', 'MDC1', 'PMPCA', 'PHB2', 'MCAT', 'SDHD', 'DBT', 'SIL1', 'BCKDHB', 'PDHA1', 'SUMO1', 'HSPD1', 'RPA1', 'PDK3', 'ARL14EP', 'FLYWCH1', 'BLM', 'PIAS1', 'MRE11', 'VDAC1', 'AFG3L2', 'HDAC6', 'ISCU', 'GPD1', 'PDK1', 'NSUN6', 'SDHB', 'NFS1', 'NDUFAB1', 'BRCA1', 'SDHA', 'MICU1', 'DLD', 'PDK2', 'NDUFV3', 'TRIM28', 'MFN1', 'PMPCB', 'UBA5', 'OGDH', 'PHB1', 'UFM1', 'BCKDHA']
266	HPA	HPA:0600222	tonsil; squamous epithelial cells[≥Medium]	7.3907452588588735e-06	True	tonsil; squamous epithelial cells[≥Medium]	4946	83	62	11006	0.7469879518072289	0.0125353821269712	query_1	['HPA:0600221']	['UBE2I', 'PDK4', 'GCSH', 'PPM1K', 'SNX1', 'LYRM4', 'ADSL', 'CDK5RAP3', 'ATF7IP', 'DLST', 'HSPA9', 'TP53BP1', 'RAD50', 'XRCC6', 'PAXIP1', 'DLAT', 'PDHX', 'SETDB2', 'PDHB', 'H2AX', 'DDRGK1', 'MDC1', 'PMPCA', 'PHB2', 'SDHD', 'MCU', 'SIL1', 'PDHA1', 'SUMO1', 'HSPD1', 'RPA1', 'ARL14EP', 'FLYWCH1', 'BLM', 'PIAS1', 'MRE11', 'RAD51', 'AFG3L2', 'HDAC6', 'ISCU', 'PDK1', 'NSUN6', 'SDHB', 'FAF2', 'CBX5', 'NDUFAB1', 'BRCA1', 'SDHA', 'MICU1', 'DLD', 'PDK2', 'MBD1', 'NDUFV3', 'TRIM28', 'MICU2', 'MFN1', 'PEPD', 'PMPCB', 'OGDH', 'PHB1', 'UFM1', 'BCKDHA']
267	HPA	HPA:0470000	skin 2	7.447602021325003e-06	True	skin 2	7029	83	75	11006	0.9036144578313252	0.0106700810926163	query_1	['HPA:0000000']	['RBBP8', 'UBE2I', 'PDK4', 'GCSH', 'PPM1K', 'SNX1', 'LYRM4', 'ADSL', 'CDK5RAP3', 'NBN', 'ATF7IP', 'DLST', 'HSPA9', 'TP53BP1', 'RAD50', 'UBAC2', 'XRCC6', 'PAXIP1', 'DLAT', 'PDHX', 'SETDB2', 'PDHB', 'H2AX', 'DDRGK1', 'UFL1', 'PMPCA', 'PHB2', 'MCAT', 'SDHD', 'DBT', 'MCU', 'SIL1', 'BCKDK', 'BCKDHB', 'PDHA1', 'SUMO1', 'HSPD1', 'RPA1', 'PDK3', 'ARL14EP', 'FLYWCH1', 'BLM', 'PIAS1', 'MRE11', 'VDAC1', 'RAD51', 'AFG3L2', 'HDAC6', 'ISCU', 'GPD1', 'PDK1', 'NSUN6', 'SDHB', 'NFS1', 'CBX5', 'NDUFAB1', 'BRCA1', 'SDHA', 'MICU1', 'DLD', 'PDK2', 'MBD1', 'NDUFV3', 'TRIM28', 'BARD1', 'MICU2', 'MFN1', 'PEPD', 'PMPCB', 'UBA5', 'OGDH', 'PHB1', 'UFM1', 'STAT5B', 'BCKDHA']
268	HP	HP:0003112	Abnormal circulating amino acid concentration	7.455080432122737e-06	True	The presence of an abnormal decrease or increase of one or more amino acids in the blood circulation.	151	54	13	4851	0.2407407407407407	0.086092715231788	query_1	['HP:0004354']	['GCSH', 'PPM1K', 'OTC', 'TALDO1', 'PDHX', 'DBT', 'BCKDK', 'BCKDHB', 'PDHA1', 'NFS1', 'MICU1', 'DLD', 'BCKDHA']
269	HPA	HPA:0130000	colon	7.482962272961442e-06	True	colon	8330	83	81	11006	0.9759036144578314	0.0097238895558223	query_1	['HPA:0000000']	['RBBP8', 'SNX6', 'UBE2I', 'PDK4', 'GCSH', 'PPM1K', 'SNX1', 'LYRM4', 'ADSL', 'MAIP1', 'CDK5RAP3', 'NBN', 'OTC', 'ATF7IP', 'DLST', 'HSPA9', 'MCUB', 'TP53BP1', 'RAD50', 'UBAC2', 'XRCC6', 'PAXIP1', 'DLAT', 'PDHX', 'SETDB2', 'PDHB', 'H2AX', 'DDRGK1', 'UFL1', 'MDC1', 'PMPCA', 'PHB2', 'MCAT', 'SDHD', 'DBT', 'MCU', 'SIL1', 'BCKDK', 'BCKDHB', 'PDHA1', 'SUMO1', 'HSPD1', 'RPA1', 'ARL14EP', 'FLYWCH1', 'BLM', 'PIAS1', 'MRE11', 'VDAC1', 'RAD51', 'AFG3L2', 'HDAC6', 'ISCU', 'GPD1', 'PDK1', 'NSUN6', 'SDHB', 'FAF2', 'NFS1', 'CBX5', 'NDUFAB1', 'BRCA1', 'SDHA', 'MICU1', 'STAT5A', 'DLD', 'PDK2', 'MBD1', 'NDUFV3', 'TRIM28', 'BARD1', 'MICU2', 'MFN1', 'PEPD', 'PMPCB', 'UBA5', 'OGDH', 'PHB1', 'UFM1', 'STAT5B', 'BCKDHA']
270	GO:BP	GO:0032787	monocarboxylic acid metabolic process	7.542057984168045e-06	True	"""The chemical reactions and pathways involving monocarboxylic acids, any organic acid containing one carboxyl (COOH) group or anion (COO-)."" [GOC:vk]"	628	96	17	21110	0.1770833333333333	0.0270700636942675	query_1	['GO:0019752']	['PDK4', 'DLAT', 'PDHA2', 'PDHX', 'PDHB', 'MCAT', 'PDHA1', 'PDK3', 'VDAC1', 'GPD1', 'PDK1', 'NDUFAB1', 'BRCA1', 'DLD', 'PDK2', 'ABHD6', 'OGDH']
271	HPA	HPA:0240000	heart muscle	7.5665895242076995e-06	True	heart muscle	6323	83	71	11006	0.8554216867469879	0.011228847066266	query_1	['HPA:0000000']	['SNX6', 'UBE2I', 'PDK4', 'GCSH', 'PPM1K', 'SNX1', 'LYRM4', 'ADSL', 'MAIP1', 'CDK5RAP3', 'NBN', 'ATF7IP', 'DLST', 'HSPA9', 'MCUB', 'TP53BP1', 'RAD50', 'UBAC2', 'XRCC6', 'PAXIP1', 'DLAT', 'PDHX', 'SETDB2', 'PDHB', 'H2AX', 'UFL1', 'MDC1', 'PMPCA', 'PHB2', 'MCAT', 'SDHD', 'DBT', 'MCU', 'SIL1', 'BCKDHB', 'PDHA1', 'SUMO1', 'HSPD1', 'RPA1', 'ARL14EP', 'FLYWCH1', 'BLM', 'PIAS1', 'MRE11', 'VDAC1', 'AFG3L2', 'HDAC6', 'ISCU', 'GPD1', 'PDK1', 'NSUN6', 'SDHB', 'NFS1', 'NDUFAB1', 'BRCA1', 'SDHA', 'MICU1', 'DLD', 'PDK2', 'MBD1', 'NDUFV3', 'TRIM28', 'BARD1', 'MICU2', 'PMPCB', 'UBA5', 'OGDH', 'PHB1', 'UFM1', 'STAT5B', 'BCKDHA']
272	HPA	HPA:0241101	heart muscle; cardiomyocytes[≥Low]	7.5665895242076995e-06	True	heart muscle; cardiomyocytes[≥Low]	6323	83	71	11006	0.8554216867469879	0.011228847066266	query_1	['HPA:0240000']	['SNX6', 'UBE2I', 'PDK4', 'GCSH', 'PPM1K', 'SNX1', 'LYRM4', 'ADSL', 'MAIP1', 'CDK5RAP3', 'NBN', 'ATF7IP', 'DLST', 'HSPA9', 'MCUB', 'TP53BP1', 'RAD50', 'UBAC2', 'XRCC6', 'PAXIP1', 'DLAT', 'PDHX', 'SETDB2', 'PDHB', 'H2AX', 'UFL1', 'MDC1', 'PMPCA', 'PHB2', 'MCAT', 'SDHD', 'DBT', 'MCU', 'SIL1', 'BCKDHB', 'PDHA1', 'SUMO1', 'HSPD1', 'RPA1', 'ARL14EP', 'FLYWCH1', 'BLM', 'PIAS1', 'MRE11', 'VDAC1', 'AFG3L2', 'HDAC6', 'ISCU', 'GPD1', 'PDK1', 'NSUN6', 'SDHB', 'NFS1', 'NDUFAB1', 'BRCA1', 'SDHA', 'MICU1', 'DLD', 'PDK2', 'MBD1', 'NDUFV3', 'TRIM28', 'BARD1', 'MICU2', 'PMPCB', 'UBA5', 'OGDH', 'PHB1', 'UFM1', 'STAT5B', 'BCKDHA']
273	REAC	REAC:R-HSA-5685939	HDR through MMEJ (alt-NHEJ)	7.757228678147362e-06	True	HDR through MMEJ (alt-NHEJ)	12	84	5	10790	0.0595238095238095	0.4166666666666667	query_1	['REAC:R-HSA-5693538']	['RBBP8', 'NBN', 'RAD50', 'BRCA2', 'MRE11']
274	REAC	REAC:R-HSA-71291	Metabolism of amino acids and derivatives	7.807572435651652e-06	True	Metabolism of amino acids and derivatives	369	84	16	10790	0.1904761904761904	0.043360433604336	query_1	['REAC:R-HSA-1430728']	['GCSH', 'PPM1K', 'OTC', 'DLST', 'DLAT', 'PDHA2', 'PDHX', 'PDHB', 'DBT', 'BCKDK', 'BCKDHB', 'PDHA1', 'NDUFAB1', 'DLD', 'OGDH', 'BCKDHA']
275	HPA	HPA:0050092	breast; myoepithelial cells[≥Medium]	8.185546750351837e-06	True	breast; myoepithelial cells[≥Medium]	3777	83	53	11006	0.6385542168674698	0.0140323007678051	query_1	['HPA:0050091']	['GCSH', 'PPM1K', 'SNX1', 'LYRM4', 'CDK5RAP3', 'NBN', 'ATF7IP', 'HSPA9', 'TP53BP1', 'XRCC6', 'PAXIP1', 'DLAT', 'PDHX', 'SETDB2', 'PDHB', 'H2AX', 'DDRGK1', 'MDC1', 'PMPCA', 'PHB2', 'MCAT', 'DBT', 'MCU', 'BCKDK', 'BCKDHB', 'PDHA1', 'SUMO1', 'RPA1', 'ARL14EP', 'FLYWCH1', 'BLM', 'PIAS1', 'MRE11', 'VDAC1', 'HDAC6', 'ISCU', 'GPD1', 'PDK1', 'SDHB', 'NFS1', 'NDUFAB1', 'BRCA1', 'SDHA', 'MICU1', 'DLD', 'NDUFV3', 'TRIM28', 'MFN1', 'PMPCB', 'OGDH', 'PHB1', 'UFM1', 'BCKDHA']
276	CORUM	CORUM:964	BRCA1-RAD50-MRE11-NBS1 complex	8.661470048945153e-06	True	BRCA1-RAD50-MRE11-NBS1 complex	4	47	4	3383	0.0851063829787234	1.0	query_1	['CORUM:0000000']	['NBN', 'RAD50', 'MRE11', 'BRCA1']
277	CORUM	CORUM:202	BRCA1-RAD50-MRE11-NBS1 complex	8.661470048945153e-06	True	BRCA1-RAD50-MRE11-NBS1 complex	4	47	4	3383	0.0851063829787234	1.0	query_1	['CORUM:0000000']	['NBN', 'RAD50', 'MRE11', 'BRCA1']
278	CORUM	CORUM:2218	MDC1-MRE11-RAD50-NBS1 complex	8.661470048945153e-06	True	MDC1-MRE11-RAD50-NBS1 complex	4	47	4	3383	0.0851063829787234	1.0	query_1	['CORUM:0000000']	['NBN', 'RAD50', 'MDC1', 'MRE11']
279	GO:BP	GO:0006261	DNA-templated DNA replication	8.665668101940683e-06	True	"""A DNA replication process that uses parental DNA as a template for the DNA-dependent DNA polymerases that synthesize the new strands."" [GOC:mah, ISBN:0198506732]"	163	96	10	21110	0.1041666666666666	0.0613496932515337	query_1	['GO:0006260']	['RBBP8', 'NBN', 'RAD50', 'BRCA2', 'RPA1', 'BLM', 'MRE11', 'RAD51', 'BRCA1', 'BARD1']
280	HP	HP:0011017	Abnormal cellular physiology	8.745584081337393e-06	True	An abnormality in a cellular process.	563	54	23	4851	0.4259259259259259	0.0408525754884547	query_1	['HP:0001939', 'HP:0025354']	['SPG7', 'LYRM4', 'NBN', 'RAD50', 'DLAT', 'PDHX', 'PDHB', 'SDHD', 'BRCA2', 'PDHA1', 'RPA1', 'BLM', 'MRE11', 'RAD51', 'AFG3L2', 'ISCU', 'SDHB', 'NFS1', 'BRCA1', 'SDHA', 'DLD', 'PEPD', 'STAT5B']
281	HP	HP:0002861	Melanoma	8.803863028870816e-06	True	The presence of a melanoma, a malignant cancer originating from pigment producing melanocytes. Melanoma can originate from the skin or the pigmented layers of the eye (the uvea).	76	54	10	4851	0.1851851851851851	0.131578947368421	query_1	['HP:0011792']	['NBN', 'RAD50', 'SDHD', 'BRCA2', 'MRE11', 'RAD51', 'SDHB', 'BRCA1', 'SDHC', 'BARD1']
282	HPA	HPA:0301372	lung; alveolar cells type II[≥Medium]	9.396043776088096e-06	True	lung; alveolar cells type II[≥Medium]	1233	83	28	11006	0.3373493975903614	0.0227088402270884	query_1	['HPA:0301371']	['ADSL', 'CDK5RAP3', 'NBN', 'HSPA9', 'TP53BP1', 'XRCC6', 'PAXIP1', 'PDHX', 'H2AX', 'UFL1', 'PMPCA', 'PHB2', 'SIL1', 'BCKDK', 'BCKDHB', 'SUMO1', 'HSPD1', 'RPA1', 'PIAS1', 'MRE11', 'GPD1', 'SDHB', 'NFS1', 'DLD', 'NDUFV3', 'TRIM28', 'PEPD', 'OGDH']
283	GO:CC	GO:0005654	nucleoplasm	9.4601675555781e-06	True	"""That part of the nuclear content other than the chromosomes or the nucleolus."" [GOC:ma, ISBN:0124325653]"	4203	97	42	22122	0.4329896907216495	0.0099928622412562	query_1	['GO:0031981', 'GO:0110165']	['RBBP8', 'UBE2I', 'LYRM4', 'NBN', 'ATF7IP', 'DLST', 'MCUB', 'TP53BP1', 'RAD50', 'ZNF45', 'ZNF350', 'XRCC6', 'PAXIP1', 'SETDB2', 'PDHB', 'H2AX', 'MDC1', 'BRCA2', 'SETDB1', 'BCKDHB', 'SUMO1', 'RPA1', 'ARL14EP', 'FLYWCH1', 'BLM', 'PIAS1', 'MRE11', 'RAD51', 'HDAC6', 'SDHB', 'NFS1', 'CBX5', 'NDUFAB1', 'BRCA1', 'STAT5A', 'SMDT1', 'PDK2', 'MBD1', 'TRIM28', 'BARD1', 'PHB1', 'STAT5B']
284	HPA	HPA:0380521	placenta; trophoblastic cells[≥Low]	9.85036956946206e-06	True	placenta; trophoblastic cells[≥Low]	6353	83	71	11006	0.8554216867469879	0.0111758224460884	query_1	['HPA:0380000']	['RBBP8', 'UBE2I', 'PDK4', 'GCSH', 'PPM1K', 'LYRM4', 'ADSL', 'MAIP1', 'NBN', 'ATF7IP', 'DLST', 'HSPA9', 'MCUB', 'TP53BP1', 'RAD50', 'UBAC2', 'XRCC6', 'DLAT', 'SETDB2', 'PDHB', 'DDRGK1', 'UFL1', 'MDC1', 'PMPCA', 'PHB2', 'MCAT', 'SDHD', 'DBT', 'MCU', 'SIL1', 'BCKDK', 'BCKDHB', 'PDHA1', 'SUMO1', 'HSPD1', 'RPA1', 'PDK3', 'ARL14EP', 'FLYWCH1', 'BLM', 'PIAS1', 'MRE11', 'AFG3L2', 'HDAC6', 'ISCU', 'GPD1', 'PDK1', 'NSUN6', 'SDHB', 'FAF2', 'NFS1', 'NDUFAB1', 'BRCA1', 'SDHA', 'MICU1', 'STAT5A', 'DLD', 'PDK2', 'MBD1', 'NDUFV3', 'TRIM28', 'MICU2', 'MFN1', 'PEPD', 'PMPCB', 'UBA5', 'OGDH', 'PHB1', 'UFM1', 'STAT5B', 'BCKDHA']
285	GO:BP	GO:0022904	respiratory electron transport chain	1.0799337325802244e-05	True	"""A process in which a series of electron carriers operate together to transfer electrons from donors such as NADH and FADH2 to any of several different terminal electron acceptors to generate a transmembrane electrochemical gradient."" [GOC:mtg_electron_transport, ISBN:0716720094]"	122	96	9	21110	0.09375	0.0737704918032786	query_1	['GO:0022900', 'GO:0045333']	['SDHD', 'ISCU', 'GPD1', 'SDHB', 'NDUFAB1', 'SDHA', 'SDHC', 'DLD', 'NDUFV3']
286	GO:BP	GO:0044770	cell cycle phase transition	1.0800351772340493e-05	True	"""The cell cycle process by which a cell commits to entering the next cell cycle phase."" [GOC:mtg_cell_cycle]"	560	96	16	21110	0.1666666666666666	0.0285714285714285	query_1	['GO:0022402']	['RBBP8', 'CDK5RAP3', 'NBN', 'TP53BP1', 'RAD50', 'PAXIP1', 'H2AX', 'DDRGK1', 'MDC1', 'PHB2', 'BRCA2', 'BLM', 'MRE11', 'RAD51', 'BRCA1', 'BARD1']
287	HPA	HPA:0530000	spleen	1.1249887377050269e-05	True	spleen	5882	83	68	11006	0.8192771084337349	0.0115606936416184	query_1	['HPA:0000000']	['RBBP8', 'UBE2I', 'PDK4', 'GCSH', 'PPM1K', 'LYRM4', 'ADSL', 'CDK5RAP3', 'NBN', 'ATF7IP', 'DLST', 'HSPA9', 'MCUB', 'TP53BP1', 'RAD50', 'UBAC2', 'XRCC6', 'PAXIP1', 'DLAT', 'PDHX', 'SETDB2', 'PDHB', 'H2AX', 'DDRGK1', 'MDC1', 'PMPCA', 'PHB2', 'SDHD', 'MCU', 'BCKDK', 'BCKDHB', 'PDHA1', 'SUMO1', 'HSPD1', 'RPA1', 'ARL14EP', 'FLYWCH1', 'BLM', 'PIAS1', 'MRE11', 'VDAC1', 'AFG3L2', 'HDAC6', 'ISCU', 'GPD1', 'PDK1', 'SDHB', 'FAF2', 'NFS1', 'CBX5', 'BRCA1', 'SDHA', 'MICU1', 'STAT5A', 'DLD', 'PDK2', 'MBD1', 'NDUFV3', 'TRIM28', 'BARD1', 'MFN1', 'PEPD', 'PMPCB', 'OGDH', 'PHB1', 'UFM1', 'STAT5B', 'BCKDHA']
288	GO:BP	GO:0044249	cellular biosynthetic process	1.1749461191063948e-05	True	"""The chemical reactions and pathways resulting in the formation of substances, carried out by individual cells."" [GOC:jl]"	5521	96	52	21110	0.5416666666666666	0.0094185835899293	query_1	['GO:0009058', 'GO:0044237']	['RBBP8', 'SNX6', 'UBE2I', 'PDK4', 'ADSL', 'CDK5RAP3', 'OTC', 'ATF7IP', 'TP53BP1', 'RAD50', 'ZNF45', 'ZNF350', 'XRCC6', 'PAXIP1', 'DLAT', 'PDHA2', 'PDHX', 'SETDB2', 'PDHB', 'DDRGK1', 'UFL1', 'PHB2', 'MCAT', 'SDHD', 'BRCA2', 'SETDB1', 'PDHA1', 'SUMO1', 'RPA1', 'PDK3', 'FLYWCH1', 'BLM', 'PIAS1', 'MRE11', 'HDAC6', 'MOCS3', 'PDK1', 'SDHB', 'NFS1', 'CBX5', 'NDUFAB1', 'BRCA1', 'SDHA', 'STAT5A', 'SDHC', 'DLD', 'PDK2', 'MBD1', 'NDUFV3', 'TRIM28', 'PHB1', 'STAT5B']
289	GO:BP	GO:1901576	organic substance biosynthetic process	1.207274770688492e-05	True	"""The chemical reactions and pathways resulting in the formation of an organic substance, any molecular entity containing carbon."" [GOC:pr, GOC:TermGenie]"	5894	96	54	21110	0.5625	0.009161859518154	query_1	['GO:0009058', 'GO:0071704']	['RBBP8', 'SNX6', 'UBE2I', 'PDK4', 'ADSL', 'CDK5RAP3', 'OTC', 'ATF7IP', 'TP53BP1', 'RAD50', 'ZNF45', 'ZNF350', 'XRCC6', 'PAXIP1', 'DLAT', 'PDHA2', 'PDHX', 'SETDB2', 'PDHB', 'DDRGK1', 'UFL1', 'PHB2', 'MCAT', 'SDHD', 'BRCA2', 'SETDB1', 'PDHA1', 'SUMO1', 'RPA1', 'PDK3', 'FLYWCH1', 'BLM', 'PIAS1', 'MRE11', 'HDAC6', 'MOCS3', 'GPD1', 'PDK1', 'SDHB', 'NFS1', 'CBX5', 'NDUFAB1', 'BRCA1', 'SDHA', 'STAT5A', 'SDHC', 'DLD', 'PDK2', 'MBD1', 'NDUFV3', 'TRIM28', 'ABHD6', 'PHB1', 'STAT5B']
290	HPA	HPA:0160251	endometrium 1; cells in endometrial stroma[≥Low]	1.2637385735732152e-05	True	endometrium 1; cells in endometrial stroma[≥Low]	4070	83	55	11006	0.6626506024096386	0.0135135135135135	query_1	['HPA:0160000']	['RBBP8', 'SNX6', 'UBE2I', 'PDK4', 'GCSH', 'PPM1K', 'SNX1', 'LYRM4', 'ADSL', 'NBN', 'DLST', 'HSPA9', 'TP53BP1', 'RAD50', 'XRCC6', 'PAXIP1', 'DLAT', 'PDHX', 'SETDB2', 'H2AX', 'DDRGK1', 'MDC1', 'PMPCA', 'PHB2', 'MCU', 'SIL1', 'PDHA1', 'SUMO1', 'RPA1', 'PDK3', 'ARL14EP', 'FLYWCH1', 'BLM', 'PIAS1', 'MRE11', 'VDAC1', 'RAD51', 'HDAC6', 'ISCU', 'PDK1', 'SDHB', 'NFS1', 'CBX5', 'NDUFAB1', 'BRCA1', 'SDHA', 'MICU1', 'PDK2', 'MBD1', 'NDUFV3', 'TRIM28', 'PEPD', 'OGDH', 'PHB1', 'BCKDHA']
291	HPA	HPA:0530721	spleen; cells in white pulp[≥Low]	1.3248164885051977e-05	True	spleen; cells in white pulp[≥Low]	4332	83	57	11006	0.6867469879518072	0.0131578947368421	query_1	['HPA:0530000']	['RBBP8', 'UBE2I', 'PDK4', 'GCSH', 'PPM1K', 'LYRM4', 'ADSL', 'NBN', 'ATF7IP', 'DLST', 'HSPA9', 'TP53BP1', 'RAD50', 'XRCC6', 'PAXIP1', 'DLAT', 'PDHX', 'SETDB2', 'PDHB', 'H2AX', 'MDC1', 'PMPCA', 'PHB2', 'MCU', 'BCKDK', 'PDHA1', 'HSPD1', 'RPA1', 'ARL14EP', 'FLYWCH1', 'BLM', 'PIAS1', 'MRE11', 'VDAC1', 'AFG3L2', 'HDAC6', 'ISCU', 'GPD1', 'PDK1', 'SDHB', 'FAF2', 'NFS1', 'CBX5', 'SDHA', 'MICU1', 'STAT5A', 'DLD', 'MBD1', 'NDUFV3', 'TRIM28', 'BARD1', 'PEPD', 'PMPCB', 'OGDH', 'PHB1', 'UFM1', 'BCKDHA']
292	HP	HP:0011027	Abnormal fallopian tube morphology	1.397131020273833e-05	True	An abnormality of the fallopian tube.	27	54	7	4851	0.1296296296296296	0.2592592592592592	query_1	['HP:0000008']	['NBN', 'RAD50', 'BRCA2', 'MRE11', 'RAD51', 'BRCA1', 'BARD1']
293	GO:BP	GO:0006121	mitochondrial electron transport, succinate to ubiquinone	1.4242429544649927e-05	True	"""The transfer of electrons from succinate to ubiquinone that occurs during oxidative phosphorylation, mediated by the multisubunit enzyme known as complex II."" [ISBN:0716731363]"	6	96	4	21110	0.0416666666666666	0.6666666666666666	query_1	['GO:0019646', 'GO:0042775']	['SDHD', 'SDHB', 'SDHA', 'SDHC']
294	GO:BP	GO:0000724	double-strand break repair via homologous recombination	1.4561220544641018e-05	True	"""The error-free repair of a double-strand break in DNA in which the broken DNA molecule is repaired using homologous sequences. A strand in the broken DNA searches for a homologous region in an intact chromosome to serve as the template for DNA synthesis. The restoration of two intact DNA molecules results in the exchange, reciprocal or nonreciprocal, of genetic material between the intact DNA molecule and the broken DNA molecule."" [GOC:elh, PMID:10357855]"	172	96	10	21110	0.1041666666666666	0.0581395348837209	query_1	['GO:0000725', 'GO:0006302']	['RBBP8', 'NBN', 'TP53BP1', 'H2AX', 'BRCA2', 'RPA1', 'BLM', 'MRE11', 'RAD51', 'BRCA1']
295	GO:BP	GO:0043412	macromolecule modification	1.4640581758183783e-05	True	"""The covalent alteration of one or more monomeric units in a polypeptide, polynucleotide, polysaccharide, or other biological macromolecule, resulting in a change in its properties."" [GOC:go_curators]"	3840	96	42	21110	0.4375	0.0109375	query_1	['GO:0043170']	['PPIF', 'SNX6', 'UBE2I', 'PDK4', 'GCSH', 'PPM1K', 'CDK5RAP3', 'NBN', 'ATF7IP', 'DLST', 'RAD50', 'XRCC6', 'PAXIP1', 'SETDB2', 'DDRGK1', 'UFL1', 'PHB2', 'METTL21C', 'BRCA2', 'SETDB1', 'BCKDK', 'SUMO1', 'PDK3', 'BLM', 'PIAS1', 'MRE11', 'RAD51', 'HDAC6', 'MOCS3', 'PDK1', 'NSUN6', 'NFS1', 'NDUFAB1', 'BRCA1', 'DLD', 'PDK2', 'TRIM28', 'BARD1', 'UBA5', 'OGDH', 'PHB1', 'UFM1']
296	GO:BP	GO:1901137	carbohydrate derivative biosynthetic process	1.652993154947598e-05	True	"""The chemical reactions and pathways resulting in the formation of carbohydrate derivative."" [GOC:TermGenie]"	662	96	17	21110	0.1770833333333333	0.0256797583081571	query_1	['GO:1901135', 'GO:1901576']	['PDK4', 'ADSL', 'DLAT', 'PDHA2', 'PDHX', 'PDHB', 'SDHD', 'PDHA1', 'PDK3', 'PDK1', 'SDHB', 'NDUFAB1', 'SDHA', 'SDHC', 'DLD', 'PDK2', 'NDUFV3']
297	GO:BP	GO:0006259	DNA metabolic process	1.7345971335998865e-05	True	"""Any cellular metabolic process involving deoxyribonucleic acid. This is one of the two main types of nucleic acid, consisting of a long, unbranched macromolecule formed from one, or more commonly, two, strands of linked deoxyribonucleotides."" [ISBN:0198506732]"	1046	96	21	21110	0.21875	0.020076481835564	query_1	['GO:0090304']	['RBBP8', 'NBN', 'ATF7IP', 'TP53BP1', 'RAD50', 'XRCC6', 'PAXIP1', 'H2AX', 'UFL1', 'MDC1', 'BRCA2', 'SUMO1', 'HSPD1', 'RPA1', 'BLM', 'MRE11', 'RAD51', 'BRCA1', 'TRIM28', 'BARD1', 'PHB1']
298	HP	HP:0008344	Elevated plasma branched chain amino acids	1.8056839939946237e-05	True	An increased concentration of a branched chain amino acid in the blood.	4	54	4	4851	0.074074074074074	1.0	query_1	['HP:0010892']	['DBT', 'BCKDHB', 'DLD', 'BCKDHA']
299	GO:BP	GO:0044237	cellular metabolic process	1.8351430864557948e-05	True	"""The chemical reactions and pathways by which individual cells transform chemical substances."" [GOC:go_curators]"	11477	96	79	21110	0.8229166666666666	0.0068833318811536	query_1	['GO:0008152', 'GO:0009987']	['PPIF', 'RBBP8', 'SNX6', 'UBE2I', 'PDK4', 'GCSH', 'PPM1K', 'LYRM4', 'ADSL', 'CDK5RAP3', 'NBN', 'OTC', 'ATF7IP', 'DLST', 'HSPA9', 'TP53BP1', 'RAD50', 'ZNF45', 'ZNF350', 'XRCC6', 'TALDO1', 'PAXIP1', 'DLAT', 'PDHA2', 'PDHX', 'SETDB2', 'PDHB', 'H2AX', 'DDRGK1', 'UFL1', 'MDC1', 'PHB2', 'MCAT', 'SDHD', 'DBT', 'BRCA2', 'SETDB1', 'BCKDK', 'BCKDHB', 'PDHA1', 'SUMO1', 'HSPD1', 'RPA1', 'PDK3', 'FLYWCH1', 'BLM', 'PIAS1', 'MRE11', 'VDAC1', 'RAD51', 'HDAC6', 'MOCS3', 'ISCU', 'GPD1', 'PDK1', 'NSUN6', 'SDHB', 'NFS1', 'CBX5', 'NDUFAB1', 'BRCA1', 'SDHA', 'STAT5A', 'SDHC', 'DLD', 'PDK2', 'MBD1', 'NDUFV3', 'TRIM28', 'BARD1', 'MFN1', 'ABHD6', 'PEPD', 'UBA5', 'OGDH', 'PHB1', 'UFM1', 'STAT5B', 'BCKDHA']
300	HPA	HPA:0100201	cerebral cortex; endothelial cells[≥Low]	1.8509635900234e-05	True	cerebral cortex; endothelial cells[≥Low]	4633	83	59	11006	0.7108433734939759	0.0127347291172026	query_1	['HPA:0100000']	['RBBP8', 'PDK4', 'GCSH', 'SNX1', 'LYRM4', 'ADSL', 'CDK5RAP3', 'NBN', 'ATF7IP', 'DLST', 'HSPA9', 'TP53BP1', 'XRCC6', 'PAXIP1', 'PDHX', 'SETDB2', 'PDHB', 'H2AX', 'MDC1', 'PMPCA', 'PHB2', 'SDHD', 'DBT', 'MCU', 'SIL1', 'BCKDK', 'BCKDHB', 'PDHA1', 'SUMO1', 'ARL14EP', 'FLYWCH1', 'BLM', 'PIAS1', 'MRE11', 'VDAC1', 'AFG3L2', 'HDAC6', 'ISCU', 'GPD1', 'PDK1', 'SDHB', 'NFS1', 'CBX5', 'BRCA1', 'SDHA', 'MICU1', 'DLD', 'MBD1', 'NDUFV3', 'TRIM28', 'MICU2', 'MFN1', 'PEPD', 'UBA5', 'OGDH', 'PHB1', 'UFM1', 'STAT5B', 'BCKDHA']
301	HPA	HPA:0190222	esophagus; squamous epithelial cells[≥Medium]	1.9410598393962015e-05	True	esophagus; squamous epithelial cells[≥Medium]	5052	83	62	11006	0.7469879518072289	0.0122723673792557	query_1	['HPA:0190221']	['RBBP8', 'UBE2I', 'PDK4', 'GCSH', 'PPM1K', 'SNX1', 'LYRM4', 'ADSL', 'CDK5RAP3', 'ATF7IP', 'DLST', 'HSPA9', 'TP53BP1', 'RAD50', 'UBAC2', 'XRCC6', 'PAXIP1', 'DLAT', 'PDHX', 'SETDB2', 'PDHB', 'H2AX', 'DDRGK1', 'MDC1', 'PMPCA', 'PHB2', 'SDHD', 'DBT', 'MCU', 'BCKDK', 'BCKDHB', 'SUMO1', 'HSPD1', 'RPA1', 'ARL14EP', 'FLYWCH1', 'BLM', 'PIAS1', 'MRE11', 'VDAC1', 'AFG3L2', 'ISCU', 'GPD1', 'NSUN6', 'SDHB', 'NFS1', 'NDUFAB1', 'BRCA1', 'SDHA', 'MICU1', 'DLD', 'PDK2', 'MBD1', 'NDUFV3', 'TRIM28', 'MICU2', 'MFN1', 'PMPCB', 'OGDH', 'PHB1', 'UFM1', 'BCKDHA']
302	GO:BP	GO:0009058	biosynthetic process	1.9612036979496465e-05	True	"""The chemical reactions and pathways resulting in the formation of substances; typically the energy-requiring part of metabolism in which simpler substances are transformed into more complex ones."" [GOC:curators, ISBN:0198547684]"	5969	96	54	21110	0.5625	0.0090467414977383	query_1	['GO:0008152']	['RBBP8', 'SNX6', 'UBE2I', 'PDK4', 'ADSL', 'CDK5RAP3', 'OTC', 'ATF7IP', 'TP53BP1', 'RAD50', 'ZNF45', 'ZNF350', 'XRCC6', 'PAXIP1', 'DLAT', 'PDHA2', 'PDHX', 'SETDB2', 'PDHB', 'DDRGK1', 'UFL1', 'PHB2', 'MCAT', 'SDHD', 'BRCA2', 'SETDB1', 'PDHA1', 'SUMO1', 'RPA1', 'PDK3', 'FLYWCH1', 'BLM', 'PIAS1', 'MRE11', 'HDAC6', 'MOCS3', 'GPD1', 'PDK1', 'SDHB', 'NFS1', 'CBX5', 'NDUFAB1', 'BRCA1', 'SDHA', 'STAT5A', 'SDHC', 'DLD', 'PDK2', 'MBD1', 'NDUFV3', 'TRIM28', 'ABHD6', 'PHB1', 'STAT5B']
303	HPA	HPA:0080000	caudate	1.965217197962227e-05	True	caudate	6956	83	74	11006	0.891566265060241	0.0106382978723404	query_1	['HPA:0000000']	['UBE2I', 'PDK4', 'GCSH', 'PPM1K', 'SNX1', 'LYRM4', 'ADSL', 'MAIP1', 'CDK5RAP3', 'NBN', 'ATF7IP', 'DLST', 'HSPA9', 'TP53BP1', 'RAD50', 'UBAC2', 'XRCC6', 'PAXIP1', 'DLAT', 'PDHX', 'SETDB2', 'PDHB', 'H2AX', 'UFL1', 'MDC1', 'PMPCA', 'PHB2', 'MCAT', 'SDHD', 'DBT', 'MCU', 'SIL1', 'BCKDK', 'BCKDHB', 'PDHA1', 'SUMO1', 'HSPD1', 'RPA1', 'PDK3', 'ARL14EP', 'FLYWCH1', 'BLM', 'PIAS1', 'MRE11', 'VDAC1', 'RAD51', 'AFG3L2', 'HDAC6', 'ISCU', 'GPD1', 'PDK1', 'NSUN6', 'SDHB', 'FAF2', 'NFS1', 'CBX5', 'NDUFAB1', 'BRCA1', 'SDHA', 'MICU1', 'DLD', 'PDK2', 'MBD1', 'NDUFV3', 'TRIM28', 'BARD1', 'MICU2', 'MFN1', 'PMPCB', 'UBA5', 'OGDH', 'PHB1', 'UFM1', 'BCKDHA']
304	GO:CC	GO:0000794	condensed nuclear chromosome	2.0661974734770347e-05	True	"""A highly compacted molecule of DNA and associated proteins resulting in a cytologically distinct nuclear chromosome."" [GOC:elh]"	82	97	7	22122	0.0721649484536082	0.0853658536585365	query_1	['GO:0000228', 'GO:0000793']	['UBE2I', 'RAD50', 'H2AX', 'BRCA2', 'BLM', 'RAD51', 'BRCA1']
305	HPA	HPA:0610832	urinary bladder; urothelial cells[≥Medium]	2.089488057877882e-05	True	urinary bladder; urothelial cells[≥Medium]	5953	83	68	11006	0.8192771084337349	0.0114228120275491	query_1	['HPA:0610831']	['RBBP8', 'UBE2I', 'PDK4', 'GCSH', 'PPM1K', 'SNX1', 'LYRM4', 'ADSL', 'CDK5RAP3', 'NBN', 'ATF7IP', 'DLST', 'HSPA9', 'TP53BP1', 'RAD50', 'UBAC2', 'XRCC6', 'PAXIP1', 'PDHX', 'SETDB2', 'PDHB', 'H2AX', 'DDRGK1', 'UFL1', 'MDC1', 'PMPCA', 'PHB2', 'SDHD', 'DBT', 'MCU', 'SIL1', 'BCKDK', 'BCKDHB', 'SUMO1', 'RPA1', 'ARL14EP', 'FLYWCH1', 'BLM', 'PIAS1', 'MRE11', 'VDAC1', 'AFG3L2', 'HDAC6', 'ISCU', 'GPD1', 'PDK1', 'NSUN6', 'SDHB', 'FAF2', 'NFS1', 'CBX5', 'NDUFAB1', 'BRCA1', 'SDHA', 'MICU1', 'DLD', 'PDK2', 'NDUFV3', 'TRIM28', 'MICU2', 'MFN1', 'PEPD', 'PMPCB', 'UBA5', 'OGDH', 'PHB1', 'UFM1', 'BCKDHA']
306	HPA	HPA:0300413	lung; macrophages[High]	2.198349599593759e-05	True	lung; macrophages[High]	1367	83	29	11006	0.3493975903614458	0.0212143379663496	query_1	['HPA:0300412']	['NBN', 'HSPA9', 'RAD50', 'XRCC6', 'SETDB2', 'H2AX', 'PHB2', 'MCAT', 'SDHD', 'MCU', 'BCKDK', 'BCKDHB', 'SUMO1', 'HSPD1', 'RPA1', 'FLYWCH1', 'BLM', 'PIAS1', 'MRE11', 'VDAC1', 'GPD1', 'SDHB', 'NFS1', 'NDUFAB1', 'MICU1', 'TRIM28', 'OGDH', 'PHB1', 'UFM1']
307	GO:BP	GO:0019646	aerobic electron transport chain	2.202397820919528e-05	True	"""A process in which a series of electron carriers operate together to transfer electrons from donors such as NADH and FADH2 to oxygen to generate a transmembrane electrochemical gradient."" [GOC:ai, GOC:mtg_electron_transport]"	92	96	8	21110	0.0833333333333333	0.0869565217391304	query_1	['GO:0006119', 'GO:0009060', 'GO:0022904']	['SDHD', 'ISCU', 'SDHB', 'NDUFAB1', 'SDHA', 'SDHC', 'DLD', 'NDUFV3']
308	HP	HP:0025354	Abnormal cellular phenotype	2.403561222666709e-05	True	An anomaly of cellular morphology or physiology.	593	54	23	4851	0.4259259259259259	0.0387858347386172	query_1	['HP:0000118']	['SPG7', 'LYRM4', 'NBN', 'RAD50', 'DLAT', 'PDHX', 'PDHB', 'SDHD', 'BRCA2', 'PDHA1', 'RPA1', 'BLM', 'MRE11', 'RAD51', 'AFG3L2', 'ISCU', 'SDHB', 'NFS1', 'BRCA1', 'SDHA', 'DLD', 'PEPD', 'STAT5B']
309	REAC	REAC:R-HSA-69481	G2/M Checkpoints	2.4773352709942848e-05	True	G2/M Checkpoints	167	84	11	10790	0.1309523809523809	0.0658682634730539	query_1	['REAC:R-HSA-69620']	['RBBP8', 'NBN', 'TP53BP1', 'RAD50', 'H2AX', 'MDC1', 'RPA1', 'BLM', 'MRE11', 'BRCA1', 'BARD1']
310	HPA	HPA:0570731	testis; Leydig cells[≥Low]	2.545784034914416e-05	True	testis; Leydig cells[≥Low]	7171	83	75	11006	0.9036144578313252	0.010458792358109	query_1	['HPA:0570000']	['RBBP8', 'SNX6', 'UBE2I', 'PDK4', 'GCSH', 'PPM1K', 'SNX1', 'LYRM4', 'ADSL', 'MAIP1', 'CDK5RAP3', 'NBN', 'ATF7IP', 'DLST', 'HSPA9', 'TP53BP1', 'RAD50', 'UBAC2', 'XRCC6', 'PAXIP1', 'DLAT', 'PDHA2', 'PDHX', 'SETDB2', 'PDHB', 'DDRGK1', 'UFL1', 'MDC1', 'PMPCA', 'PHB2', 'MCAT', 'SDHD', 'DBT', 'MCU', 'SIL1', 'BCKDK', 'BCKDHB', 'PDHA1', 'HSPD1', 'ARL14EP', 'FLYWCH1', 'BLM', 'MRE11', 'VDAC1', 'RAD51', 'AFG3L2', 'HDAC6', 'ISCU', 'GPD1', 'PDK1', 'NSUN6', 'SDHB', 'FAF2', 'NFS1', 'NDUFAB1', 'BRCA1', 'SDHA', 'MICU1', 'STAT5A', 'DLD', 'PDK2', 'MBD1', 'NDUFV3', 'TRIM28', 'BARD1', 'MICU2', 'MFN1', 'PEPD', 'PMPCB', 'UBA5', 'OGDH', 'PHB1', 'UFM1', 'STAT5B', 'BCKDHA']
311	WP	WP:WP4946	DNA repair pathways, full network	2.6272106776197745e-05	True	DNA repair pathways, full network	119	60	9	8133	0.15	0.0756302521008403	query_1	['WP:000000']	['NBN', 'RAD50', 'XRCC6', 'H2AX', 'BRCA2', 'RPA1', 'MRE11', 'RAD51', 'BRCA1']
312	HPA	HPA:0310432	lymph node; germinal center cells[≥Medium]	2.657308661620667e-05	True	lymph node; germinal center cells[≥Medium]	3297	83	48	11006	0.5783132530120482	0.0145586897179253	query_1	['HPA:0310431']	['UBE2I', 'SNX1', 'ADSL', 'CDK5RAP3', 'NBN', 'ATF7IP', 'DLST', 'HSPA9', 'MCUB', 'TP53BP1', 'RAD50', 'XRCC6', 'PAXIP1', 'DLAT', 'PDHX', 'SETDB2', 'H2AX', 'MDC1', 'PMPCA', 'PHB2', 'SIL1', 'SUMO1', 'RPA1', 'FLYWCH1', 'BLM', 'PIAS1', 'MRE11', 'VDAC1', 'AFG3L2', 'GPD1', 'PDK1', 'NSUN6', 'SDHB', 'BRCA1', 'MICU1', 'STAT5A', 'DLD', 'PDK2', 'MBD1', 'NDUFV3', 'TRIM28', 'BARD1', 'PEPD', 'PMPCB', 'UBA5', 'OGDH', 'UFM1', 'BCKDHA']
313	WP	WP:WP4920	Mitochondrial complex II assembly	2.6874394617406403e-05	True	Mitochondrial complex II assembly	8	60	4	8133	0.0666666666666666	0.5	query_1	['WP:000000']	['SDHD', 'SDHB', 'SDHA', 'SDHC']
314	GO:CC	GO:0043229	intracellular organelle	2.7039844291018503e-05	True	"""Organized structure of distinctive morphology and function, occurring within the cell. Includes the nucleus, mitochondria, plastids, vacuoles, vesicles, ribosomes and the cytoskeleton. Excludes the plasma membrane."" [GOC:go_curators]"	16038	97	91	22122	0.9381443298969072	0.0056740241925427	query_1	['GO:0005622', 'GO:0043226']	['PPIF', 'RBBP8', 'SNX6', 'UBE2I', 'PDK4', 'GCSH', 'SPG7', 'PPM1K', 'SNX1', 'LYRM4', 'MAIP1', 'CDK5RAP3', 'NBN', 'OTC', 'ATF7IP', 'DLST', 'HSPA9', 'MCUB', 'TP53BP1', 'RAD50', 'ZNF45', 'UBAC2', 'ZNF350', 'XRCC6', 'TALDO1', 'PAXIP1', 'DLAT', 'PDHA2', 'PDHX', 'SETDB2', 'PDHB', 'H2AX', 'DDRGK1', 'UFL1', 'MDC1', 'PMPCA', 'PHB2', 'MCAT', 'METTL21C', 'SDHD', 'DBT', 'BRCA2', 'MCU', 'SIL1', 'SETDB1', 'BCKDK', 'CDNF', 'BCKDHB', 'PDHA1', 'SUMO1', 'HSPD1', 'RPA1', 'PDK3', 'ARL14EP', 'FLYWCH1', 'BLM', 'PIAS1', 'MRE11', 'VDAC1', 'RAD51', 'AFG3L2', 'HDAC6', 'ISCU', 'PDK1', 'SDHB', 'FAF2', 'NFS1', 'CBX5', 'NDUFAB1', 'BRCA1', 'SDHA', 'MICU1', 'STAT5A', 'SMDT1', 'SDHC', 'DLD', 'PDK2', 'MBD1', 'NDUFV3', 'TRIM28', 'BARD1', 'MICU2', 'MFN1', 'ABHD6', 'PMPCB', 'UBA5', 'OGDH', 'PHB1', 'UFM1', 'STAT5B', 'BCKDHA']
315	GO:BP	GO:0006302	double-strand break repair	2.902148464636221e-05	True	"""The repair of double-strand breaks in DNA via homologous and nonhomologous mechanisms to reform a continuous DNA helix."" [GOC:elh]"	301	96	12	21110	0.125	0.0398671096345514	query_1	['GO:0006281']	['RBBP8', 'NBN', 'TP53BP1', 'RAD50', 'XRCC6', 'H2AX', 'BRCA2', 'RPA1', 'BLM', 'MRE11', 'RAD51', 'BRCA1']
316	HPA	HPA:0320000	nasopharynx	2.9665557467476543e-05	True	nasopharynx	7189	83	75	11006	0.9036144578313252	0.0104326053693142	query_1	['HPA:0000000']	['RBBP8', 'UBE2I', 'PDK4', 'GCSH', 'PPM1K', 'SNX1', 'LYRM4', 'ADSL', 'MAIP1', 'CDK5RAP3', 'NBN', 'DLST', 'HSPA9', 'MCUB', 'TP53BP1', 'RAD50', 'UBAC2', 'XRCC6', 'PAXIP1', 'DLAT', 'PDHX', 'SETDB2', 'PDHB', 'H2AX', 'DDRGK1', 'UFL1', 'MDC1', 'PMPCA', 'PHB2', 'MCAT', 'SDHD', 'DBT', 'MCU', 'SIL1', 'BCKDK', 'BCKDHB', 'PDHA1', 'SUMO1', 'RPA1', 'ARL14EP', 'FLYWCH1', 'BLM', 'PIAS1', 'MRE11', 'VDAC1', 'RAD51', 'AFG3L2', 'HDAC6', 'ISCU', 'GPD1', 'PDK1', 'NSUN6', 'SDHB', 'FAF2', 'NFS1', 'CBX5', 'NDUFAB1', 'BRCA1', 'SDHA', 'MICU1', 'DLD', 'PDK2', 'MBD1', 'NDUFV3', 'TRIM28', 'BARD1', 'MICU2', 'MFN1', 'PEPD', 'PMPCB', 'UBA5', 'OGDH', 'UFM1', 'STAT5B', 'BCKDHA']
317	GO:BP	GO:0006006	glucose metabolic process	3.0853142833597134e-05	True	"""The chemical reactions and pathways involving glucose, the aldohexose gluco-hexose. D-glucose is dextrorotatory and is sometimes known as dextrose; it is an important source of energy for living organisms and is found free as well as combined in homo- and hetero-oligosaccharides and polysaccharides."" [ISBN:0198506732]"	186	96	10	21110	0.1041666666666666	0.053763440860215	query_1	['GO:0019318']	['PDK4', 'DLAT', 'PDHA2', 'PDHB', 'BCKDK', 'PDHA1', 'PDK3', 'GPD1', 'PDK1', 'PDK2']
318	GO:BP	GO:0036211	protein modification process	3.1257860070779904e-05	True	"""The covalent alteration of one or more amino acids occurring in proteins, peptides and nascent polypeptides (co-translational, post-translational modifications). Includes the modification of charged tRNAs that are destined to occur in a protein (pre-translation modification)."" [GOC:bf, GOC:jl]"	3617	96	40	21110	0.4166666666666667	0.0110588885816975	query_1	['GO:0019538', 'GO:0043412']	['PPIF', 'SNX6', 'UBE2I', 'PDK4', 'GCSH', 'PPM1K', 'CDK5RAP3', 'NBN', 'DLST', 'RAD50', 'XRCC6', 'PAXIP1', 'SETDB2', 'DDRGK1', 'UFL1', 'PHB2', 'METTL21C', 'BRCA2', 'SETDB1', 'BCKDK', 'SUMO1', 'PDK3', 'BLM', 'PIAS1', 'MRE11', 'RAD51', 'HDAC6', 'MOCS3', 'PDK1', 'NFS1', 'NDUFAB1', 'BRCA1', 'DLD', 'PDK2', 'TRIM28', 'BARD1', 'UBA5', 'OGDH', 'PHB1', 'UFM1']
319	GO:BP	GO:0033146	regulation of intracellular estrogen receptor signaling pathway	3.136314641291341e-05	True	"""Any process that modulates the frequency, rate or extent of the activity of an intracellular estrogen receptor signaling pathway."" [GOC:mah]"	36	96	6	21110	0.0625	0.1666666666666666	query_1	['GO:0030520', 'GO:0033143']	['DDRGK1', 'UFL1', 'PHB2', 'BRCA1', 'UBA5', 'UFM1']
320	HPA	HPA:0060103	bronchus; respiratory epithelial cells[High]	3.3334551677936e-05	True	bronchus; respiratory epithelial cells[High]	1845	83	34	11006	0.4096385542168674	0.0184281842818428	query_1	['HPA:0060102']	['PDK4', 'GCSH', 'LYRM4', 'ADSL', 'CDK5RAP3', 'HSPA9', 'TP53BP1', 'XRCC6', 'DLAT', 'PDHX', 'SETDB2', 'MDC1', 'PHB2', 'MCAT', 'BCKDK', 'SUMO1', 'HSPD1', 'RPA1', 'FLYWCH1', 'BLM', 'MRE11', 'SDHB', 'NFS1', 'NDUFAB1', 'SDHA', 'MICU1', 'DLD', 'PDK2', 'NDUFV3', 'TRIM28', 'OGDH', 'PHB1', 'UFM1', 'BCKDHA']
321	GO:CC	GO:0043226	organelle	3.399117818927202e-05	True	"""Organized structure of distinctive morphology and function. Includes the nucleus, mitochondria, plastids, vacuoles, vesicles, ribosomes and the cytoskeleton, and prokaryotic structures such as anammoxosomes and pirellulosomes. Excludes the plasma membrane."" [GOC:go_curators]"	16842	97	93	22122	0.9587628865979382	0.0055219095119344	query_1	['GO:0110165']	['PPIF', 'RBBP8', 'SNX6', 'UBE2I', 'PDK4', 'GCSH', 'SPG7', 'PPM1K', 'SNX1', 'LYRM4', 'MAIP1', 'CDK5RAP3', 'NBN', 'OTC', 'ATF7IP', 'DLST', 'HSPA9', 'MCUB', 'TP53BP1', 'RAD50', 'ZNF45', 'UBAC2', 'ZNF350', 'XRCC6', 'TALDO1', 'PAXIP1', 'DLAT', 'PDHA2', 'PDHX', 'SETDB2', 'PDHB', 'H2AX', 'DDRGK1', 'UFL1', 'MDC1', 'PMPCA', 'PHB2', 'MCAT', 'METTL21C', 'SDHD', 'DBT', 'BRCA2', 'MCU', 'SIL1', 'SETDB1', 'BCKDK', 'CDNF', 'BCKDHB', 'PDHA1', 'SUMO1', 'HSPD1', 'RPA1', 'PDK3', 'ARL14EP', 'FLYWCH1', 'BLM', 'PIAS1', 'MRE11', 'VDAC1', 'RAD51', 'AFG3L2', 'HDAC6', 'ISCU', 'GPD1', 'PDK1', 'SDHB', 'FAF2', 'NFS1', 'CBX5', 'NDUFAB1', 'BRCA1', 'SDHA', 'MICU1', 'STAT5A', 'SMDT1', 'SDHC', 'DLD', 'PDK2', 'MBD1', 'NDUFV3', 'TRIM28', 'BARD1', 'MICU2', 'MFN1', 'ABHD6', 'PEPD', 'PMPCB', 'UBA5', 'OGDH', 'PHB1', 'UFM1', 'STAT5B', 'BCKDHA']
322	GO:BP	GO:0018205	peptidyl-lysine modification	3.858763926940184e-05	True	"""The modification of peptidyl-lysine."" [GOC:go_curators]"	377	96	13	21110	0.1354166666666666	0.0344827586206896	query_1	['GO:0018193']	['UBE2I', 'GCSH', 'PAXIP1', 'SETDB2', 'METTL21C', 'BRCA2', 'SETDB1', 'SUMO1', 'PIAS1', 'HDAC6', 'NDUFAB1', 'BRCA1', 'TRIM28']
323	HPA	HPA:0600442	tonsil; non-germinal center cells[≥Medium]	3.942946766801225e-05	True	tonsil; non-germinal center cells[≥Medium]	4190	83	55	11006	0.6626506024096386	0.013126491646778	query_1	['HPA:0600441']	['UBE2I', 'PDK4', 'GCSH', 'PPM1K', 'LYRM4', 'ADSL', 'CDK5RAP3', 'NBN', 'ATF7IP', 'HSPA9', 'MCUB', 'TP53BP1', 'RAD50', 'XRCC6', 'PAXIP1', 'PDHX', 'SETDB2', 'H2AX', 'DDRGK1', 'MDC1', 'PMPCA', 'PHB2', 'SIL1', 'BCKDK', 'PDHA1', 'SUMO1', 'RPA1', 'PDK3', 'ARL14EP', 'FLYWCH1', 'BLM', 'PIAS1', 'MRE11', 'VDAC1', 'AFG3L2', 'ISCU', 'NSUN6', 'SDHB', 'NFS1', 'BRCA1', 'SDHA', 'MICU1', 'STAT5A', 'DLD', 'MBD1', 'NDUFV3', 'TRIM28', 'BARD1', 'PEPD', 'UBA5', 'OGDH', 'PHB1', 'UFM1', 'STAT5B', 'BCKDHA']
324	GO:BP	GO:0010389	regulation of G2/M transition of mitotic cell cycle	3.946903391949201e-05	True	"""Any signalling pathway that modulates the activity of a cell cycle cyclin-dependent protein kinase to modulate the switch from G2 phase to M phase of the mitotic cell cycle."" [GOC:mtg_cell_cycle, PMID:17329565]"	99	96	8	21110	0.0833333333333333	0.0808080808080808	query_1	['GO:0000086', 'GO:1901990', 'GO:1902749']	['RBBP8', 'CDK5RAP3', 'NBN', 'RAD50', 'BLM', 'MRE11', 'BRCA1', 'BARD1']
325	HPA	HPA:0340000	ovary	3.962558837670179e-05	True	ovary	5421	83	64	11006	0.7710843373493976	0.0118059398634938	query_1	['HPA:0000000']	['RBBP8', 'UBE2I', 'PDK4', 'GCSH', 'PPM1K', 'LYRM4', 'ADSL', 'MAIP1', 'CDK5RAP3', 'NBN', 'ATF7IP', 'DLST', 'HSPA9', 'MCUB', 'TP53BP1', 'RAD50', 'XRCC6', 'PAXIP1', 'PDHX', 'SETDB2', 'H2AX', 'DDRGK1', 'MDC1', 'PMPCA', 'PHB2', 'MCU', 'SIL1', 'BCKDHB', 'PDHA1', 'SUMO1', 'HSPD1', 'RPA1', 'ARL14EP', 'FLYWCH1', 'BLM', 'PIAS1', 'MRE11', 'VDAC1', 'RAD51', 'AFG3L2', 'HDAC6', 'ISCU', 'GPD1', 'PDK1', 'SDHB', 'FAF2', 'NFS1', 'CBX5', 'BRCA1', 'SDHA', 'MICU1', 'STAT5A', 'DLD', 'PDK2', 'MBD1', 'NDUFV3', 'TRIM28', 'MFN1', 'PEPD', 'UBA5', 'OGDH', 'PHB1', 'UFM1', 'BCKDHA']
326	GO:BP	GO:0006807	nitrogen compound metabolic process	3.991555828537506e-05	True	"""The chemical reactions and pathways involving organic or inorganic compounds that contain nitrogen."" [GOC:jl, ISBN:0198506732]"	12164	96	81	21110	0.84375	0.0066589937520552	query_1	['GO:0008152']	['PPIF', 'RBBP8', 'SNX6', 'UBE2I', 'PDK4', 'GCSH', 'SPG7', 'PPM1K', 'SNX1', 'ADSL', 'CDK5RAP3', 'NBN', 'OTC', 'ATF7IP', 'DLST', 'TP53BP1', 'RAD50', 'ZNF45', 'UBAC2', 'ZNF350', 'XRCC6', 'TALDO1', 'PAXIP1', 'DLAT', 'PDHA2', 'PDHX', 'SETDB2', 'PDHB', 'H2AX', 'DDRGK1', 'UFL1', 'MDC1', 'PMPCA', 'PHB2', 'METTL21C', 'SDHD', 'DBT', 'BRCA2', 'SETDB1', 'BCKDK', 'BCKDHB', 'PDHA1', 'SUMO1', 'HSPD1', 'RPA1', 'PDK3', 'FLYWCH1', 'BLM', 'PIAS1', 'MRE11', 'RAD51', 'AFG3L2', 'HDAC6', 'MOCS3', 'GPD1', 'PDK1', 'NSUN6', 'SDHB', 'FAF2', 'NFS1', 'CBX5', 'NDUFAB1', 'BRCA1', 'SDHA', 'STAT5A', 'SDHC', 'DLD', 'PDK2', 'MBD1', 'NDUFV3', 'TRIM28', 'BARD1', 'MFN1', 'PEPD', 'PMPCB', 'UBA5', 'OGDH', 'PHB1', 'UFM1', 'STAT5B', 'BCKDHA']
327	GO:BP	GO:0044238	primary metabolic process	4.155027633936117e-05	True	"""The chemical reactions and pathways involving those compounds which are formed as a part of the normal anabolic and catabolic processes. These processes take place in most, if not all, cells of the organism."" [GOC:go_curators, http://www.metacyc.org]"	12729	96	83	21110	0.8645833333333334	0.0065205436405059	query_1	['GO:0008152']	['PPIF', 'RBBP8', 'SNX6', 'UBE2I', 'PDK4', 'GCSH', 'SPG7', 'PPM1K', 'SNX1', 'ADSL', 'CDK5RAP3', 'NBN', 'OTC', 'ATF7IP', 'DLST', 'TP53BP1', 'RAD50', 'ZNF45', 'UBAC2', 'ZNF350', 'XRCC6', 'TALDO1', 'PAXIP1', 'DLAT', 'PDHA2', 'PDHX', 'SETDB2', 'PDHB', 'H2AX', 'DDRGK1', 'UFL1', 'MDC1', 'PMPCA', 'PHB2', 'MCAT', 'METTL21C', 'SDHD', 'DBT', 'BRCA2', 'SETDB1', 'BCKDK', 'BCKDHB', 'PDHA1', 'SUMO1', 'HSPD1', 'RPA1', 'PDK3', 'FLYWCH1', 'BLM', 'PIAS1', 'MRE11', 'RAD51', 'AFG3L2', 'HDAC6', 'MOCS3', 'GPD1', 'PDK1', 'NSUN6', 'SDHB', 'FAF2', 'NFS1', 'CBX5', 'NDUFAB1', 'BRCA1', 'SDHA', 'STAT5A', 'SDHC', 'DLD', 'PDK2', 'MBD1', 'NDUFV3', 'TRIM28', 'BARD1', 'MFN1', 'ABHD6', 'PEPD', 'PMPCB', 'UBA5', 'OGDH', 'PHB1', 'UFM1', 'STAT5B', 'BCKDHA']
328	WP	WP:WP3925	Amino acid metabolism	4.193940621677316e-05	True	Amino acid metabolism	91	60	8	8133	0.1333333333333333	0.0879120879120879	query_1	['WP:000000']	['PDK4', 'OTC', 'DLST', 'PDHX', 'PDHA1', 'SDHA', 'DLD', 'OGDH']
329	GO:BP	GO:0042775	mitochondrial ATP synthesis coupled electron transport	4.274217454953915e-05	True	"""The transfer of electrons through a series of electron donors and acceptors, generating energy that is ultimately used for synthesis of ATP, as it occurs in the mitochondrial inner membrane or chloroplast thylakoid membrane."" [GOC:mtg_sensu, ISBN:0716731363]"	100	96	8	21110	0.0833333333333333	0.08	query_1	['GO:0042773']	['SDHD', 'ISCU', 'SDHB', 'NDUFAB1', 'SDHA', 'SDHC', 'DLD', 'NDUFV3']
330	GO:BP	GO:0042773	ATP synthesis coupled electron transport	4.274217454953915e-05	True	"""The transfer of electrons through a series of electron donors and acceptors, generating energy that is ultimately used for synthesis of ATP."" [ISBN:0716731363]"	100	96	8	21110	0.0833333333333333	0.08	query_1	['GO:0006119', 'GO:0022904']	['SDHD', 'ISCU', 'SDHB', 'NDUFAB1', 'SDHA', 'SDHC', 'DLD', 'NDUFV3']
331	GO:BP	GO:0035825	homologous recombination	4.306177014722023e-05	True	"""A DNA recombination process that results in the exchange of an equal amount of genetic material between highly homologous DNA molecules."" [GOC:mah, PMID:11139492, PMID:17304215]"	65	96	7	21110	0.0729166666666666	0.1076923076923077	query_1	['GO:0006310']	['RBBP8', 'NBN', 'RAD50', 'MRE11', 'RAD51', 'BRCA1', 'BARD1']
332	GO:BP	GO:0010212	response to ionizing radiation	4.364479967461365e-05	True	"""Any process that results in a change in state or activity of a cell or an organism (in terms of movement, secretion, enzyme production, gene expression, etc.) as a result of a ionizing radiation stimulus. Ionizing radiation is radiation with sufficient energy to remove electrons from atoms and may arise from spontaneous decay of unstable isotopes, resulting in alpha and beta particles and gamma rays. Ionizing radiation also includes X-rays."" [PMID:12509526]"	143	96	9	21110	0.09375	0.0629370629370629	query_1	['GO:0009314']	['TP53BP1', 'XRCC6', 'PAXIP1', 'H2AX', 'BRCA2', 'BLM', 'RAD51', 'BRCA1', 'BARD1']
333	HPA	HPA:0460000	skin 1	4.484293186288699e-05	True	skin 1	7238	83	75	11006	0.9036144578313252	0.0103619784470848	query_1	['HPA:0000000']	['RBBP8', 'SNX6', 'UBE2I', 'PDK4', 'GCSH', 'PPM1K', 'SNX1', 'LYRM4', 'ADSL', 'CDK5RAP3', 'NBN', 'ATF7IP', 'DLST', 'HSPA9', 'MCUB', 'TP53BP1', 'RAD50', 'UBAC2', 'XRCC6', 'PAXIP1', 'DLAT', 'PDHX', 'SETDB2', 'PDHB', 'H2AX', 'UFL1', 'MDC1', 'PMPCA', 'PHB2', 'MCAT', 'SDHD', 'DBT', 'MCU', 'SIL1', 'BCKDK', 'BCKDHB', 'PDHA1', 'SUMO1', 'HSPD1', 'RPA1', 'ARL14EP', 'FLYWCH1', 'BLM', 'PIAS1', 'MRE11', 'VDAC1', 'RAD51', 'AFG3L2', 'HDAC6', 'ISCU', 'PDK1', 'NSUN6', 'SDHB', 'NFS1', 'CBX5', 'NDUFAB1', 'BRCA1', 'SDHA', 'MICU1', 'STAT5A', 'DLD', 'PDK2', 'MBD1', 'NDUFV3', 'TRIM28', 'BARD1', 'MICU2', 'MFN1', 'PEPD', 'PMPCB', 'OGDH', 'PHB1', 'UFM1', 'STAT5B', 'BCKDHA']
334	HPA	HPA:0420052	salivary gland; glandular cells[≥Medium]	4.498621555653138e-05	True	salivary gland; glandular cells[≥Medium]	4868	83	60	11006	0.7228915662650602	0.0123253903040262	query_1	['HPA:0420051']	['UBE2I', 'PDK4', 'GCSH', 'PPM1K', 'SNX1', 'LYRM4', 'ADSL', 'CDK5RAP3', 'NBN', 'ATF7IP', 'HSPA9', 'TP53BP1', 'RAD50', 'XRCC6', 'DLAT', 'PDHX', 'SETDB2', 'PDHB', 'H2AX', 'DDRGK1', 'UFL1', 'MDC1', 'PMPCA', 'PHB2', 'MCAT', 'DBT', 'MCU', 'SIL1', 'BCKDK', 'BCKDHB', 'PDHA1', 'SUMO1', 'RPA1', 'ARL14EP', 'FLYWCH1', 'BLM', 'PIAS1', 'MRE11', 'VDAC1', 'HDAC6', 'ISCU', 'GPD1', 'PDK1', 'NSUN6', 'SDHB', 'FAF2', 'NFS1', 'CBX5', 'NDUFAB1', 'SDHA', 'MICU1', 'DLD', 'NDUFV3', 'TRIM28', 'MICU2', 'UBA5', 'OGDH', 'PHB1', 'UFM1', 'BCKDHA']
335	GO:CC	GO:0098687	chromosomal region	4.721197931547016e-05	True	"""Any subdivision of a chromosome along its length."" [GOC:dos]"	396	97	12	22122	0.1237113402061855	0.0303030303030303	query_1	['GO:0005694', 'GO:0110165']	['NBN', 'TP53BP1', 'RAD50', 'XRCC6', 'H2AX', 'BRCA2', 'RPA1', 'FLYWCH1', 'BLM', 'MRE11', 'RAD51', 'CBX5']
336	GO:CC	GO:1990229	iron-sulfur cluster assembly complex	4.754170885859919e-05	True	"""A protein complex capable of assembling an iron-sulfur (Fe-S) cluster."" [GOC:bhm, PMID:17350958]"	12	97	4	22122	0.0412371134020618	0.3333333333333333	query_1	['GO:0005829', 'GO:0032991']	['LYRM4', 'ISCU', 'NFS1', 'NDUFAB1']
337	WP	WP:WP4297	Thiamine metabolic pathways	4.81074529078532e-05	True	Thiamine metabolic pathways	9	60	4	8133	0.0666666666666666	0.4444444444444444	query_1	['WP:000000']	['BCKDK', 'PDHA1', 'OGDH', 'BCKDHA']
338	GO:BP	GO:0007093	mitotic cell cycle checkpoint signaling	4.9267400541009046e-05	True	"""A signaling process that ensures accurate chromosome replication and segregation by preventing progression through a mitotic cell cycle until conditions are suitable for the cell to proceed to the next stage."" [GOC:mtg_cell_cycle]"	145	96	9	21110	0.09375	0.0620689655172413	query_1	['GO:0000075', 'GO:0045930', 'GO:1903047']	['RBBP8', 'CDK5RAP3', 'NBN', 'RAD50', 'MDC1', 'BLM', 'MRE11', 'BRCA1', 'BARD1']
339	HPA	HPA:0250131	hippocampus; neuronal cells[≥Low]	5.183354770758767e-05	True	hippocampus; neuronal cells[≥Low]	6219	83	69	11006	0.8313253012048193	0.0110950313555233	query_1	['HPA:0250000']	['PDK4', 'GCSH', 'PPM1K', 'SNX1', 'LYRM4', 'ADSL', 'MAIP1', 'CDK5RAP3', 'NBN', 'DLST', 'HSPA9', 'TP53BP1', 'RAD50', 'UBAC2', 'XRCC6', 'DLAT', 'PDHX', 'SETDB2', 'PDHB', 'H2AX', 'DDRGK1', 'MDC1', 'PMPCA', 'PHB2', 'MCAT', 'SDHD', 'DBT', 'MCU', 'SIL1', 'BCKDK', 'BCKDHB', 'PDHA1', 'SUMO1', 'HSPD1', 'RPA1', 'PDK3', 'ARL14EP', 'FLYWCH1', 'BLM', 'PIAS1', 'MRE11', 'VDAC1', 'AFG3L2', 'ISCU', 'GPD1', 'PDK1', 'NSUN6', 'SDHB', 'FAF2', 'NFS1', 'CBX5', 'NDUFAB1', 'BRCA1', 'SDHA', 'MICU1', 'DLD', 'PDK2', 'MBD1', 'NDUFV3', 'TRIM28', 'BARD1', 'MICU2', 'MFN1', 'PMPCB', 'UBA5', 'OGDH', 'PHB1', 'UFM1', 'BCKDHA']
340	HPA	HPA:0420051	salivary gland; glandular cells[≥Low]	5.238458607753749e-05	True	salivary gland; glandular cells[≥Low]	6893	83	73	11006	0.8795180722891566	0.0105904540838531	query_1	['HPA:0420000']	['SNX6', 'UBE2I', 'PDK4', 'GCSH', 'PPM1K', 'SNX1', 'LYRM4', 'ADSL', 'CDK5RAP3', 'NBN', 'ATF7IP', 'DLST', 'HSPA9', 'TP53BP1', 'RAD50', 'XRCC6', 'PAXIP1', 'DLAT', 'PDHX', 'SETDB2', 'PDHB', 'H2AX', 'DDRGK1', 'UFL1', 'MDC1', 'PMPCA', 'PHB2', 'MCAT', 'SDHD', 'DBT', 'MCU', 'SIL1', 'BCKDK', 'BCKDHB', 'PDHA1', 'SUMO1', 'RPA1', 'ARL14EP', 'FLYWCH1', 'BLM', 'PIAS1', 'MRE11', 'VDAC1', 'RAD51', 'AFG3L2', 'HDAC6', 'ISCU', 'GPD1', 'PDK1', 'NSUN6', 'SDHB', 'FAF2', 'NFS1', 'CBX5', 'NDUFAB1', 'BRCA1', 'SDHA', 'MICU1', 'DLD', 'PDK2', 'MBD1', 'NDUFV3', 'TRIM28', 'MICU2', 'MFN1', 'PEPD', 'PMPCB', 'UBA5', 'OGDH', 'PHB1', 'UFM1', 'STAT5B', 'BCKDHA']
341	HPA	HPA:0420000	salivary gland	5.238458607753749e-05	True	salivary gland	6893	83	73	11006	0.8795180722891566	0.0105904540838531	query_1	['HPA:0000000']	['SNX6', 'UBE2I', 'PDK4', 'GCSH', 'PPM1K', 'SNX1', 'LYRM4', 'ADSL', 'CDK5RAP3', 'NBN', 'ATF7IP', 'DLST', 'HSPA9', 'TP53BP1', 'RAD50', 'XRCC6', 'PAXIP1', 'DLAT', 'PDHX', 'SETDB2', 'PDHB', 'H2AX', 'DDRGK1', 'UFL1', 'MDC1', 'PMPCA', 'PHB2', 'MCAT', 'SDHD', 'DBT', 'MCU', 'SIL1', 'BCKDK', 'BCKDHB', 'PDHA1', 'SUMO1', 'RPA1', 'ARL14EP', 'FLYWCH1', 'BLM', 'PIAS1', 'MRE11', 'VDAC1', 'RAD51', 'AFG3L2', 'HDAC6', 'ISCU', 'GPD1', 'PDK1', 'NSUN6', 'SDHB', 'FAF2', 'NFS1', 'CBX5', 'NDUFAB1', 'BRCA1', 'SDHA', 'MICU1', 'DLD', 'PDK2', 'MBD1', 'NDUFV3', 'TRIM28', 'MICU2', 'MFN1', 'PEPD', 'PMPCB', 'UBA5', 'OGDH', 'PHB1', 'UFM1', 'STAT5B', 'BCKDHA']
342	GO:BP	GO:0045786	negative regulation of cell cycle	5.255253877635626e-05	True	"""Any process that stops, prevents or reduces the rate or extent of progression through the cell cycle."" [GOC:dph, GOC:go_curators, GOC:tb]"	387	96	13	21110	0.1354166666666666	0.0335917312661498	query_1	['GO:0007049', 'GO:0048523', 'GO:0051726']	['RBBP8', 'CDK5RAP3', 'NBN', 'TP53BP1', 'RAD50', 'H2AX', 'MDC1', 'BRCA2', 'BLM', 'MRE11', 'RAD51', 'BRCA1', 'BARD1']
343	GO:BP	GO:0007005	mitochondrion organization	5.529491452461252e-05	True	"""A process that is carried out at the cellular level which results in the assembly, arrangement of constituent parts, or disassembly of a mitochondrion; includes mitochondrial morphogenesis and distribution, and replication of the mitochondrial genome as well as synthesis of new mitochondrial components."" [GOC:dph, GOC:jl, GOC:mah, GOC:sgd_curators, PMID:9786946]"	544	96	15	21110	0.15625	0.0275735294117647	query_1	['GO:0006996']	['PPIF', 'SPG7', 'MAIP1', 'HSPA9', 'PMPCA', 'PHB2', 'MCU', 'HSPD1', 'VDAC1', 'AFG3L2', 'HDAC6', 'NDUFAB1', 'MFN1', 'PMPCB', 'PHB1']
344	GO:BP	GO:0006119	oxidative phosphorylation	5.551361395705075e-05	True	"""The phosphorylation of ADP to ATP that accompanies the oxidation of a metabolite through the operation of the respiratory chain. Oxidation of compounds establishes a proton gradient across the membrane, providing the energy for ATP synthesis."" [ISBN:0198506732, ISBN:0471331309]"	147	96	9	21110	0.09375	0.0612244897959183	query_1	['GO:0009060']	['PPIF', 'SDHD', 'ISCU', 'SDHB', 'NDUFAB1', 'SDHA', 'SDHC', 'DLD', 'NDUFV3']
345	GO:BP	GO:0006950	response to stress	5.743051822152772e-05	True	"""Any process that results in a change in state or activity of a cell or an organism (in terms of movement, secretion, enzyme production, gene expression, etc.) as a result of a disturbance in organismal or cellular homeostasis, usually, but not necessarily, exogenous (e.g. temperature, humidity, ionizing radiation)."" [GOC:mah]"	4017	96	42	21110	0.4375	0.0104555638536221	query_1	['GO:0050896']	['PPIF', 'RBBP8', 'PDK4', 'ADSL', 'CDK5RAP3', 'NBN', 'HSPA9', 'TP53BP1', 'RAD50', 'UBAC2', 'XRCC6', 'PAXIP1', 'H2AX', 'DDRGK1', 'UFL1', 'MDC1', 'PHB2', 'SDHD', 'BRCA2', 'SUMO1', 'HSPD1', 'RPA1', 'PDK3', 'FLYWCH1', 'BLM', 'MRE11', 'VDAC1', 'RAD51', 'HDAC6', 'PDK1', 'FAF2', 'CBX5', 'BRCA1', 'MICU1', 'STAT5A', 'PDK2', 'TRIM28', 'BARD1', 'UBA5', 'PHB1', 'UFM1', 'STAT5B']
346	HPA	HPA:0351181	pancreas; pancreatic endocrine cells[≥Low]	5.971395864813401e-05	True	pancreas; pancreatic endocrine cells[≥Low]	5617	83	65	11006	0.7831325301204819	0.0115720135303542	query_1	['HPA:0350000']	['RBBP8', 'UBE2I', 'PDK4', 'GCSH', 'PPM1K', 'LYRM4', 'ADSL', 'CDK5RAP3', 'NBN', 'ATF7IP', 'DLST', 'HSPA9', 'TP53BP1', 'RAD50', 'XRCC6', 'PAXIP1', 'DLAT', 'PDHX', 'SETDB2', 'PDHB', 'H2AX', 'DDRGK1', 'UFL1', 'PMPCA', 'PHB2', 'MCAT', 'SDHD', 'DBT', 'MCU', 'SIL1', 'BCKDK', 'BCKDHB', 'PDHA1', 'SUMO1', 'HSPD1', 'RPA1', 'ARL14EP', 'FLYWCH1', 'BLM', 'PIAS1', 'MRE11', 'VDAC1', 'AFG3L2', 'HDAC6', 'ISCU', 'GPD1', 'PDK1', 'NSUN6', 'SDHB', 'FAF2', 'NFS1', 'CBX5', 'BRCA1', 'SDHA', 'DLD', 'PDK2', 'NDUFV3', 'TRIM28', 'MICU2', 'PEPD', 'PMPCB', 'UBA5', 'OGDH', 'UFM1', 'BCKDHA']
347	HPA	HPA:0320102	nasopharynx; respiratory epithelial cells[≥Medium]	6.154946026368112e-05	True	nasopharynx; respiratory epithelial cells[≥Medium]	4767	83	59	11006	0.7108433734939759	0.0123767568701489	query_1	['HPA:0320101']	['RBBP8', 'PDK4', 'GCSH', 'PPM1K', 'LYRM4', 'ADSL', 'CDK5RAP3', 'NBN', 'DLST', 'HSPA9', 'MCUB', 'TP53BP1', 'XRCC6', 'PAXIP1', 'DLAT', 'PDHX', 'SETDB2', 'H2AX', 'DDRGK1', 'UFL1', 'MDC1', 'PHB2', 'MCAT', 'SDHD', 'SIL1', 'BCKDK', 'BCKDHB', 'PDHA1', 'SUMO1', 'RPA1', 'ARL14EP', 'FLYWCH1', 'BLM', 'MRE11', 'VDAC1', 'AFG3L2', 'HDAC6', 'ISCU', 'GPD1', 'PDK1', 'SDHB', 'FAF2', 'NFS1', 'NDUFAB1', 'SDHA', 'MICU1', 'DLD', 'PDK2', 'MBD1', 'NDUFV3', 'TRIM28', 'BARD1', 'MICU2', 'MFN1', 'PEPD', 'UBA5', 'OGDH', 'UFM1', 'BCKDHA']
348	HPA	HPA:0380522	placenta; trophoblastic cells[≥Medium]	6.273177451610138e-05	True	placenta; trophoblastic cells[≥Medium]	5045	83	61	11006	0.7349397590361446	0.0120911793855302	query_1	['HPA:0380521']	['RBBP8', 'UBE2I', 'PDK4', 'GCSH', 'PPM1K', 'ADSL', 'MAIP1', 'NBN', 'ATF7IP', 'DLST', 'HSPA9', 'TP53BP1', 'RAD50', 'UBAC2', 'XRCC6', 'SETDB2', 'PDHB', 'DDRGK1', 'UFL1', 'MDC1', 'PMPCA', 'PHB2', 'SDHD', 'DBT', 'MCU', 'SIL1', 'BCKDK', 'BCKDHB', 'PDHA1', 'SUMO1', 'HSPD1', 'RPA1', 'PDK3', 'ARL14EP', 'FLYWCH1', 'BLM', 'PIAS1', 'MRE11', 'AFG3L2', 'HDAC6', 'ISCU', 'PDK1', 'NSUN6', 'SDHB', 'FAF2', 'NFS1', 'NDUFAB1', 'BRCA1', 'SDHA', 'MICU1', 'STAT5A', 'DLD', 'MBD1', 'NDUFV3', 'TRIM28', 'MFN1', 'OGDH', 'PHB1', 'UFM1', 'STAT5B', 'BCKDHA']
349	GO:MF	GO:0008177	succinate dehydrogenase (ubiquinone) activity	7.67311102502186e-05	True	"""Catalysis of the reaction: succinate + ubiquinone = fumarate + ubiquinol."" [RHEA:13713]"	3	97	3	20195	0.0309278350515463	1.0	query_1	['GO:0000104', 'GO:0016635']	['SDHD', 'SDHB', 'SDHA']
350	GO:MF	GO:0004739	pyruvate dehydrogenase (acetyl-transferring) activity	7.67311102502186e-05	True	"""Catalysis of the reaction: pyruvate + lipoamide = S-acetyldihydrolipoamide + CO2."" [EC:1.2.4.1]"	3	97	3	20195	0.0309278350515463	1.0	query_1	['GO:0004738', 'GO:0016624']	['PDHA2', 'PDHB', 'PDHA1']
351	HPA	HPA:0500000	soft tissue 1	7.732166175102605e-05	True	soft tissue 1	5354	83	63	11006	0.7590361445783133	0.0117669032499066	query_1	['HPA:0000000']	['RBBP8', 'UBE2I', 'PDK4', 'GCSH', 'PPM1K', 'SNX1', 'LYRM4', 'ADSL', 'CDK5RAP3', 'ATF7IP', 'DLST', 'HSPA9', 'TP53BP1', 'RAD50', 'XRCC6', 'PAXIP1', 'DLAT', 'PDHX', 'SETDB2', 'H2AX', 'UFL1', 'MDC1', 'PMPCA', 'PHB2', 'MCAT', 'SDHD', 'DBT', 'MCU', 'SIL1', 'BCKDHB', 'PDHA1', 'SUMO1', 'HSPD1', 'ARL14EP', 'FLYWCH1', 'BLM', 'PIAS1', 'MRE11', 'VDAC1', 'AFG3L2', 'ISCU', 'GPD1', 'PDK1', 'NSUN6', 'SDHB', 'NFS1', 'BRCA1', 'SDHA', 'MICU1', 'STAT5A', 'DLD', 'MBD1', 'NDUFV3', 'TRIM28', 'BARD1', 'MICU2', 'MFN1', 'PEPD', 'UBA5', 'OGDH', 'PHB1', 'UFM1', 'BCKDHA']
352	WP	WP:WP5220	Metabolic reprogramming in pancreatic cancer	7.814528365908462e-05	True	Metabolic reprogramming in pancreatic cancer	42	60	6	8133	0.1	0.1428571428571428	query_1	['WP:000000']	['DLAT', 'PDHX', 'PDHB', 'PDHA1', 'DLD', 'BCKDHA']
353	HP	HP:0100787	Prostate neoplasm	7.972861970995899e-05	True	Prostate neoplasm	34	54	7	4851	0.1296296296296296	0.2058823529411764	query_1	['HP:0008775', 'HP:0033019']	['NBN', 'RAD50', 'BRCA2', 'MRE11', 'RAD51', 'BRCA1', 'BARD1']
354	HP	HP:0012125	Prostate cancer	7.972861970995899e-05	True	A cancer of the prostate.	34	54	7	4851	0.1296296296296296	0.2058823529411764	query_1	['HP:0100787']	['NBN', 'RAD50', 'BRCA2', 'MRE11', 'RAD51', 'BRCA1', 'BARD1']
355	GO:BP	GO:0000729	DNA double-strand break processing	8.006651917816591e-05	True	"""The 5' to 3' exonucleolytic resection of the DNA at the site of the break to form a 3' single-strand DNA overhang."" [PMID:10357855]"	21	96	5	21110	0.0520833333333333	0.238095238095238	query_1	['GO:0006259', 'GO:0006302']	['RBBP8', 'NBN', 'RAD50', 'BLM', 'MRE11']
356	CORUM	CORUM:433	BASC complex (BRCA1-associated genome surveillance complex)	8.115937488934377e-05	True	BASC complex (BRCA1-associated genome surveillance complex)	12	47	5	3383	0.1063829787234042	0.4166666666666667	query_1	['CORUM:0000000']	['NBN', 'RAD50', 'BLM', 'MRE11', 'BRCA1']
357	GO:CC	GO:0005622	intracellular anatomical structure	8.523003949875234e-05	True	"""A component of a cell contained within (but not including) the plasma membrane. In eukaryotes it includes the nucleus and cytoplasm."" [ISBN:0198506732]"	17883	97	95	22122	0.979381443298969	0.0053123077783369	query_1	['GO:0110165']	['PPIF', 'RBBP8', 'SNX6', 'UBE2I', 'PDK4', 'GCSH', 'SPG7', 'PPM1K', 'SNX1', 'LYRM4', 'ADSL', 'MAIP1', 'CDK5RAP3', 'NBN', 'OTC', 'ATF7IP', 'DLST', 'HSPA9', 'MCUB', 'TP53BP1', 'RAD50', 'ZNF45', 'UBAC2', 'ZNF350', 'XRCC6', 'TALDO1', 'PAXIP1', 'DLAT', 'PDHA2', 'PDHX', 'SETDB2', 'PDHB', 'H2AX', 'DDRGK1', 'UFL1', 'MDC1', 'PMPCA', 'PHB2', 'MCAT', 'METTL21C', 'SDHD', 'DBT', 'BRCA2', 'MCU', 'SIL1', 'SETDB1', 'BCKDK', 'CDNF', 'BCKDHB', 'PDHA1', 'SUMO1', 'HSPD1', 'RPA1', 'PDK3', 'ARL14EP', 'FLYWCH1', 'BLM', 'PIAS1', 'MRE11', 'VDAC1', 'RAD51', 'AFG3L2', 'HDAC6', 'MOCS3', 'ISCU', 'GPD1', 'PDK1', 'NSUN6', 'SDHB', 'FAF2', 'NFS1', 'CBX5', 'NDUFAB1', 'BRCA1', 'SDHA', 'MICU1', 'STAT5A', 'SMDT1', 'SDHC', 'DLD', 'PDK2', 'MBD1', 'NDUFV3', 'TRIM28', 'BARD1', 'MICU2', 'MFN1', 'ABHD6', 'PMPCB', 'UBA5', 'OGDH', 'PHB1', 'UFM1', 'STAT5B', 'BCKDHA']
358	HPA	HPA:0050091	breast; myoepithelial cells[≥Low]	8.558405700067652e-05	True	breast; myoepithelial cells[≥Low]	5660	83	65	11006	0.7831325301204819	0.0114840989399293	query_1	['HPA:0050000']	['SNX6', 'UBE2I', 'PDK4', 'GCSH', 'PPM1K', 'SNX1', 'LYRM4', 'ADSL', 'CDK5RAP3', 'NBN', 'ATF7IP', 'HSPA9', 'MCUB', 'TP53BP1', 'XRCC6', 'PAXIP1', 'DLAT', 'PDHX', 'SETDB2', 'PDHB', 'H2AX', 'DDRGK1', 'MDC1', 'PMPCA', 'PHB2', 'MCAT', 'SDHD', 'DBT', 'MCU', 'BCKDK', 'BCKDHB', 'PDHA1', 'SUMO1', 'RPA1', 'PDK3', 'ARL14EP', 'FLYWCH1', 'BLM', 'PIAS1', 'MRE11', 'VDAC1', 'HDAC6', 'ISCU', 'GPD1', 'PDK1', 'NSUN6', 'SDHB', 'NFS1', 'NDUFAB1', 'BRCA1', 'SDHA', 'MICU1', 'DLD', 'MBD1', 'NDUFV3', 'TRIM28', 'BARD1', 'MICU2', 'MFN1', 'PMPCB', 'UBA5', 'OGDH', 'PHB1', 'UFM1', 'BCKDHA']
359	GO:CC	GO:0099128	mitochondrial iron-sulfur cluster assembly complex	9.257275621760444e-05	True	"""A protein complex consisting of frataxin, cysteine desulfurase, an accessory protein and a Fe-S scaffold protein. In human these genes correspond to FXN, NFS1, ISD11 and ISCU respectively. This complex assembles Fe-S clusters onto the scaffolding protein using the substrates ferrous iron, electrons, and sulfur from l-cysteine."" [PMID:27519411]"	4	97	3	22122	0.0309278350515463	0.75	query_1	['GO:0098798']	['LYRM4', 'ISCU', 'NFS1']
360	GO:BP	GO:0009083	branched-chain amino acid catabolic process	0.0001032435660154	True	"""The chemical reactions and pathways resulting in the breakdown of amino acids containing a branched carbon skeleton, comprising isoleucine, leucine and valine."" [GOC:ai]"	22	96	5	21110	0.0520833333333333	0.2272727272727272	query_1	['GO:0009063', 'GO:0009081']	['DBT', 'BCKDK', 'BCKDHB', 'DLD', 'BCKDHA']
361	HPA	HPA:0180052	epididymis; glandular cells[≥Medium]	0.0001079068964281	True	epididymis; glandular cells[≥Medium]	5688	83	65	11006	0.7831325301204819	0.0114275668073136	query_1	['HPA:0180051']	['UBE2I', 'PDK4', 'GCSH', 'SNX1', 'LYRM4', 'ADSL', 'CDK5RAP3', 'NBN', 'ATF7IP', 'DLST', 'HSPA9', 'TP53BP1', 'RAD50', 'UBAC2', 'XRCC6', 'PAXIP1', 'DLAT', 'PDHX', 'SETDB2', 'PDHB', 'H2AX', 'DDRGK1', 'UFL1', 'MDC1', 'PMPCA', 'MCAT', 'SDHD', 'DBT', 'SIL1', 'BCKDK', 'BCKDHB', 'PDHA1', 'SUMO1', 'HSPD1', 'RPA1', 'ARL14EP', 'FLYWCH1', 'BLM', 'PIAS1', 'MRE11', 'VDAC1', 'AFG3L2', 'HDAC6', 'ISCU', 'GPD1', 'PDK1', 'NSUN6', 'SDHB', 'FAF2', 'NFS1', 'CBX5', 'NDUFAB1', 'BRCA1', 'MICU1', 'DLD', 'PDK2', 'TRIM28', 'BARD1', 'MFN1', 'PMPCB', 'UBA5', 'OGDH', 'PHB1', 'UFM1', 'BCKDHA']
362	GO:BP	GO:0044839	cell cycle G2/M phase transition	0.000109665750165	True	"""The cell cycle process by which a cell in G2 phase commits to M phase."" [GOC:jl, GOC:mtg_cell_cycle]"	159	96	9	21110	0.09375	0.0566037735849056	query_1	['GO:0044770']	['RBBP8', 'CDK5RAP3', 'NBN', 'RAD50', 'PAXIP1', 'BLM', 'MRE11', 'BRCA1', 'BARD1']
363	HP	HP:0007379	Neoplasm of the genitourinary tract	0.0001164986797768	True	A tumor (abnormal growth of tissue) of the genitourinary system.	225	54	14	4851	0.2592592592592592	0.0622222222222222	query_1	['HP:0000119', 'HP:0011793']	['NBN', 'DLST', 'RAD50', 'SDHD', 'BRCA2', 'BLM', 'MRE11', 'RAD51', 'SDHB', 'BRCA1', 'SDHA', 'SDHC', 'TRIM28', 'BARD1']
364	CORUM	CORUM:1094	Frataxin complex	0.0001272904053467	True	Frataxin complex	6	47	4	3383	0.0851063829787234	0.6666666666666666	query_1	['CORUM:0000000']	['LYRM4', 'HSPA9', 'AFG3L2', 'SDHA']
365	CORUM	CORUM:2217	MDC1-MRN-ATM-FANCD2 complex	0.0001272904053467	True	MDC1-MRN-ATM-FANCD2 complex	6	47	4	3383	0.0851063829787234	0.6666666666666666	query_1	['CORUM:0000000']	['NBN', 'RAD50', 'MDC1', 'MRE11']
366	GO:BP	GO:0009063	amino acid catabolic process	0.0001285001503873	True	"""The chemical reactions and pathways resulting in the breakdown of amino acids, organic acids containing one or more amino substituents."" [GOC:ai]"	115	96	8	21110	0.0833333333333333	0.0695652173913043	query_1	['GO:0006520', 'GO:0046395', 'GO:1901565']	['GCSH', 'OTC', 'DLST', 'DBT', 'BCKDK', 'BCKDHB', 'DLD', 'BCKDHA']
367	GO:CC	GO:0000800	lateral element	0.000129782561237	True	"""A proteinaceous core found between sister chromatids during meiotic prophase."" [GOC:elh]"	15	97	4	22122	0.0412371134020618	0.2666666666666666	query_1	['GO:0000795', 'GO:0110165']	['BRCA2', 'BLM', 'RAD51', 'BRCA1']
368	HPA	HPA:0030071	appendix; lymphoid tissue[≥Low]	0.0001389562670911	True	appendix; lymphoid tissue[≥Low]	4726	83	58	11006	0.6987951807228916	0.0122725349132458	query_1	['HPA:0030000']	['RBBP8', 'UBE2I', 'PDK4', 'GCSH', 'PPM1K', 'SNX1', 'LYRM4', 'ADSL', 'NBN', 'ATF7IP', 'DLST', 'HSPA9', 'MCUB', 'XRCC6', 'PAXIP1', 'DLAT', 'PDHX', 'SETDB2', 'PDHB', 'H2AX', 'UFL1', 'MDC1', 'PMPCA', 'SDHD', 'DBT', 'MCU', 'BCKDK', 'SUMO1', 'RPA1', 'ARL14EP', 'FLYWCH1', 'BLM', 'PIAS1', 'MRE11', 'VDAC1', 'RAD51', 'AFG3L2', 'HDAC6', 'ISCU', 'PDK1', 'NSUN6', 'SDHB', 'FAF2', 'NFS1', 'NDUFAB1', 'BRCA1', 'SDHA', 'MICU1', 'STAT5A', 'DLD', 'MBD1', 'NDUFV3', 'PEPD', 'PMPCB', 'OGDH', 'PHB1', 'UFM1', 'STAT5B']
369	HP	HP:0008314	Decreased activity of mitochondrial complex II	0.0001390414984829	True	A reduction in the activity of the mitochondrial respiratory chain complex II, which is part of the electron transport chain in mitochondria.	12	54	5	4851	0.0925925925925925	0.4166666666666667	query_1	['HP:0008972']	['SDHD', 'ISCU', 'SDHB', 'NFS1', 'SDHA']
370	GO:BP	GO:0030518	intracellular steroid hormone receptor signaling pathway	0.0001470528752331	True	"""The series of molecular signals initiated by a steroid binding to an intracellular steroid hormone receptor."" [GOC:mah, GOC:signaling]"	117	96	8	21110	0.0833333333333333	0.0683760683760683	query_1	['GO:0030522', 'GO:0043401']	['DDRGK1', 'UFL1', 'PHB2', 'HDAC6', 'BRCA1', 'UBA5', 'PHB1', 'UFM1']
371	GO:BP	GO:0032508	DNA duplex unwinding	0.0001702640503731	True	"""The process in which interchain hydrogen bonds between two strands of DNA are broken or 'melted', generating a region of unpaired single strands."" [GOC:isa_complete, GOC:mah]"	79	96	7	21110	0.0729166666666666	0.0886075949367088	query_1	['GO:0032392']	['NBN', 'RAD50', 'XRCC6', 'RPA1', 'BLM', 'MRE11', 'RAD51']
372	HPA	HPA:0630221	cervix; squamous epithelial cells[≥Low]	0.0001743647479003	True	cervix; squamous epithelial cells[≥Low]	5452	83	63	11006	0.7590361445783133	0.0115553925165077	query_1	['HPA:0630000']	['SNX6', 'PDK4', 'GCSH', 'PPM1K', 'SNX1', 'LYRM4', 'ADSL', 'CDK5RAP3', 'ATF7IP', 'DLST', 'MCUB', 'TP53BP1', 'RAD50', 'UBAC2', 'XRCC6', 'PAXIP1', 'DLAT', 'PDHX', 'SETDB2', 'H2AX', 'UFL1', 'MDC1', 'PMPCA', 'PHB2', 'MCAT', 'SDHD', 'DBT', 'MCU', 'SIL1', 'BCKDK', 'SUMO1', 'RPA1', 'ARL14EP', 'FLYWCH1', 'PIAS1', 'MRE11', 'VDAC1', 'RAD51', 'AFG3L2', 'ISCU', 'GPD1', 'PDK1', 'NSUN6', 'SDHB', 'FAF2', 'NFS1', 'NDUFAB1', 'BRCA1', 'SDHA', 'MICU1', 'DLD', 'PDK2', 'MBD1', 'NDUFV3', 'TRIM28', 'MICU2', 'MFN1', 'PMPCB', 'OGDH', 'PHB1', 'UFM1', 'STAT5B', 'BCKDHA']
373	GO:CC	GO:0005694	chromosome	0.0001813907480671	True	"""A structure composed of a very long molecule of DNA and associated proteins (e.g. histones) that carries hereditary information."" [ISBN:0198547684]"	1939	97	25	22122	0.2577319587628865	0.0128932439401753	query_1	['GO:0043232']	['RBBP8', 'UBE2I', 'NBN', 'TP53BP1', 'RAD50', 'XRCC6', 'PAXIP1', 'SETDB2', 'H2AX', 'UFL1', 'MDC1', 'BRCA2', 'SETDB1', 'SUMO1', 'RPA1', 'FLYWCH1', 'BLM', 'MRE11', 'RAD51', 'CBX5', 'BRCA1', 'STAT5A', 'MBD1', 'TRIM28', 'STAT5B']
374	HP	HP:0004360	Abnormality of acid-base homeostasis	0.0001821358477132	True	An abnormality of the balance or maintenance of the balance of acids and bases in bodily fluids, resulting in an abnormal pH.	402	54	18	4851	0.3333333333333333	0.044776119402985	query_1	['HP:0012337']	['LYRM4', 'OTC', 'DLAT', 'PDHX', 'PDHB', 'PMPCA', 'SDHD', 'DBT', 'BCKDHB', 'PDHA1', 'ISCU', 'SDHB', 'NFS1', 'SDHA', 'DLD', 'PMPCB', 'OGDH', 'BCKDHA']
375	HPA	HPA:0480052	small intestine; glandular cells[≥Medium]	0.0001822502192719	True	small intestine; glandular cells[≥Medium]	6057	83	67	11006	0.8072289156626506	0.0110615816410764	query_1	['HPA:0480051']	['RBBP8', 'SNX6', 'UBE2I', 'PDK4', 'GCSH', 'PPM1K', 'SNX1', 'LYRM4', 'ADSL', 'MAIP1', 'NBN', 'ATF7IP', 'DLST', 'HSPA9', 'UBAC2', 'XRCC6', 'PAXIP1', 'DLAT', 'PDHX', 'SETDB2', 'PDHB', 'H2AX', 'DDRGK1', 'UFL1', 'MDC1', 'PMPCA', 'MCAT', 'SDHD', 'DBT', 'MCU', 'BCKDK', 'BCKDHB', 'PDHA1', 'SUMO1', 'RPA1', 'ARL14EP', 'FLYWCH1', 'BLM', 'PIAS1', 'MRE11', 'VDAC1', 'AFG3L2', 'HDAC6', 'ISCU', 'PDK1', 'NSUN6', 'SDHB', 'FAF2', 'NFS1', 'CBX5', 'NDUFAB1', 'BRCA1', 'SDHA', 'MICU1', 'DLD', 'PDK2', 'MBD1', 'NDUFV3', 'MICU2', 'MFN1', 'PEPD', 'PMPCB', 'UBA5', 'OGDH', 'PHB1', 'UFM1', 'BCKDHA']
376	HPA	HPA:0060000	bronchus	0.0002013172005433	True	bronchus	7421	83	75	11006	0.9036144578313252	0.0101064546557067	query_1	['HPA:0000000']	['RBBP8', 'UBE2I', 'PDK4', 'GCSH', 'PPM1K', 'SNX1', 'LYRM4', 'ADSL', 'MAIP1', 'CDK5RAP3', 'NBN', 'DLST', 'HSPA9', 'MCUB', 'TP53BP1', 'RAD50', 'UBAC2', 'XRCC6', 'PAXIP1', 'DLAT', 'PDHX', 'SETDB2', 'H2AX', 'DDRGK1', 'UFL1', 'MDC1', 'PMPCA', 'PHB2', 'MCAT', 'SDHD', 'DBT', 'MCU', 'SIL1', 'BCKDK', 'BCKDHB', 'PDHA1', 'SUMO1', 'HSPD1', 'RPA1', 'ARL14EP', 'FLYWCH1', 'BLM', 'PIAS1', 'MRE11', 'VDAC1', 'RAD51', 'AFG3L2', 'HDAC6', 'ISCU', 'GPD1', 'PDK1', 'NSUN6', 'SDHB', 'FAF2', 'NFS1', 'CBX5', 'NDUFAB1', 'SDHA', 'MICU1', 'DLD', 'PDK2', 'MBD1', 'NDUFV3', 'TRIM28', 'BARD1', 'MICU2', 'MFN1', 'PEPD', 'PMPCB', 'UBA5', 'OGDH', 'PHB1', 'UFM1', 'STAT5B', 'BCKDHA']
377	HP	HP:0012103	Abnormality of the mitochondrion	0.0002084529433593	True	An anomaly of the mitochondrion, the membranous cytoplasmic organelle the interior of which is subdivided by cristae. The mitochondrion is a self replicating organelle that is the site of tissue respiration.	199	54	13	4851	0.2407407407407407	0.0653266331658291	query_1	['HP:0011017']	['SPG7', 'LYRM4', 'DLAT', 'PDHX', 'PDHB', 'SDHD', 'PDHA1', 'AFG3L2', 'ISCU', 'SDHB', 'NFS1', 'SDHA', 'DLD']
378	REAC	REAC:R-HSA-6804756	Regulation of TP53 Activity through Phosphorylation	0.0002123313983203	True	Regulation of TP53 Activity through Phosphorylation	92	84	8	10790	0.0952380952380952	0.0869565217391304	query_1	['REAC:R-HSA-5633007']	['RBBP8', 'NBN', 'RAD50', 'RPA1', 'BLM', 'MRE11', 'BRCA1', 'BARD1']
379	GO:CC	GO:0005657	replication fork	0.0002136025375154	True	"""The Y-shaped region of a replicating DNA molecule, resulting from the separation of the DNA strands and in which the synthesis of new strands takes place. Also includes associated protein complexes."" [GOC:mah, ISBN:0198547684]"	72	97	6	22122	0.0618556701030927	0.0833333333333333	query_1	['GO:0005694', 'GO:0110165']	['NBN', 'TP53BP1', 'H2AX', 'RPA1', 'BLM', 'MRE11']
380	GO:BP	GO:0019318	hexose metabolic process	0.0002205053941474	True	"""The chemical reactions and pathways involving a hexose, any monosaccharide with a chain of six carbon atoms in the molecule."" [ISBN:0198506732]"	229	96	10	21110	0.1041666666666666	0.0436681222707423	query_1	['GO:0005996']	['PDK4', 'DLAT', 'PDHA2', 'PDHB', 'BCKDK', 'PDHA1', 'PDK3', 'GPD1', 'PDK1', 'PDK2']
381	HPA	HPA:0310431	lymph node; germinal center cells[≥Low]	0.0002208124372924	True	lymph node; germinal center cells[≥Low]	5055	83	60	11006	0.7228915662650602	0.0118694362017804	query_1	['HPA:0310000']	['UBE2I', 'PDK4', 'SNX1', 'LYRM4', 'ADSL', 'CDK5RAP3', 'NBN', 'ATF7IP', 'DLST', 'HSPA9', 'MCUB', 'TP53BP1', 'RAD50', 'XRCC6', 'PAXIP1', 'DLAT', 'PDHX', 'SETDB2', 'H2AX', 'UFL1', 'MDC1', 'PMPCA', 'PHB2', 'SIL1', 'BCKDK', 'SUMO1', 'RPA1', 'ARL14EP', 'FLYWCH1', 'BLM', 'PIAS1', 'MRE11', 'VDAC1', 'RAD51', 'AFG3L2', 'HDAC6', 'GPD1', 'PDK1', 'NSUN6', 'SDHB', 'FAF2', 'NFS1', 'CBX5', 'BRCA1', 'SDHA', 'MICU1', 'STAT5A', 'DLD', 'PDK2', 'MBD1', 'NDUFV3', 'TRIM28', 'BARD1', 'PEPD', 'PMPCB', 'UBA5', 'OGDH', 'UFM1', 'STAT5B', 'BCKDHA']
382	GO:MF	GO:0005515	protein binding	0.0002317718964054	True	"""Binding to a protein."" [GOC:go_curators]"	14881	97	91	20195	0.9381443298969072	0.0061151804314226	query_1	['GO:0005488']	['PPIF', 'RBBP8', 'SNX6', 'UBE2I', 'PDK4', 'GCSH', 'SPG7', 'PPM1K', 'SNX1', 'LYRM4', 'ADSL', 'MAIP1', 'CDK5RAP3', 'NBN', 'OTC', 'ATF7IP', 'DLST', 'HSPA9', 'TP53BP1', 'RAD50', 'UBAC2', 'ZNF350', 'XRCC6', 'TALDO1', 'PAXIP1', 'DLAT', 'PDHA2', 'PDHX', 'SETDB2', 'PDHB', 'H2AX', 'DDRGK1', 'UFL1', 'MDC1', 'PMPCA', 'PHB2', 'METTL21C', 'SDHD', 'DBT', 'BRCA2', 'MCU', 'SIL1', 'SETDB1', 'BCKDK', 'CDNF', 'BCKDHB', 'PDHA1', 'SUMO1', 'HSPD1', 'RPA1', 'PDK3', 'ARL14EP', 'FLYWCH1', 'BLM', 'PIAS1', 'MRE11', 'VDAC1', 'RAD51', 'AFG3L2', 'HDAC6', 'MOCS3', 'ISCU', 'GPD1', 'PDK1', 'SDHB', 'FAF2', 'NFS1', 'CBX5', 'NDUFAB1', 'BRCA1', 'SDHA', 'MICU1', 'STAT5A', 'SMDT1', 'SDHC', 'DLD', 'PDK2', 'MBD1', 'NDUFV3', 'TRIM28', 'BARD1', 'MICU2', 'MFN1', 'ABHD6', 'PEPD', 'UBA5', 'OGDH', 'PHB1', 'UFM1', 'STAT5B', 'BCKDHA']
383	HPA	HPA:0050053	breast; glandular cells[High]	0.0002368256494015	True	breast; glandular cells[High]	1349	83	27	11006	0.3253012048192771	0.0200148257968865	query_1	['HPA:0050052']	['PDK4', 'GCSH', 'PPM1K', 'HSPA9', 'TP53BP1', 'RAD50', 'XRCC6', 'PAXIP1', 'SETDB2', 'MDC1', 'PMPCA', 'PHB2', 'MCU', 'PDHA1', 'RPA1', 'FLYWCH1', 'BLM', 'PIAS1', 'MRE11', 'HDAC6', 'SDHB', 'DLD', 'NDUFV3', 'TRIM28', 'OGDH', 'PHB1', 'BCKDHA']
384	GO:MF	GO:0044389	ubiquitin-like protein ligase binding	0.0002408957920752	True	"""Binding to a ubiquitin-like protein ligase, such as ubiquitin-ligase."" [GOC:jl]"	315	97	11	20195	0.1134020618556701	0.0349206349206349	query_1	['GO:0019899']	['CDK5RAP3', 'HSPA9', 'DDRGK1', 'DBT', 'SUMO1', 'HSPD1', 'PIAS1', 'HDAC6', 'FAF2', 'BRCA1', 'TRIM28']
385	GO:CC	GO:0000795	synaptonemal complex	0.0002417762132159	True	"""A proteinaceous scaffold found between homologous chromosomes during meiosis. It consists of 2 lateral elements and a central element, all running parallel to each other. Transverse filaments connect the lateral elements to the central element."" [DOI:10.5772/29752, GOC:elh]"	40	97	5	22122	0.0515463917525773	0.125	query_1	['GO:0099086']	['UBE2I', 'BRCA2', 'BLM', 'RAD51', 'BRCA1']
386	GO:CC	GO:0099086	synaptonemal structure	0.0002417762132159	True	"""A proteinaceous scaffold found between homologous chromosomes during meiosis."" [GOC:elh, GOC:vw]"	40	97	5	22122	0.0515463917525773	0.125	query_1	['GO:0000794', 'GO:0110165']	['UBE2I', 'BRCA2', 'BLM', 'RAD51', 'BRCA1']
387	HPA	HPA:0060102	bronchus; respiratory epithelial cells[≥Medium]	0.0002458314992371	True	bronchus; respiratory epithelial cells[≥Medium]	4930	83	59	11006	0.7108433734939759	0.0119675456389452	query_1	['HPA:0060101']	['PDK4', 'GCSH', 'PPM1K', 'LYRM4', 'ADSL', 'CDK5RAP3', 'NBN', 'DLST', 'HSPA9', 'TP53BP1', 'UBAC2', 'XRCC6', 'DLAT', 'PDHX', 'SETDB2', 'H2AX', 'DDRGK1', 'UFL1', 'MDC1', 'PHB2', 'MCAT', 'SDHD', 'SIL1', 'BCKDK', 'BCKDHB', 'PDHA1', 'SUMO1', 'HSPD1', 'RPA1', 'ARL14EP', 'FLYWCH1', 'BLM', 'MRE11', 'VDAC1', 'AFG3L2', 'HDAC6', 'ISCU', 'GPD1', 'PDK1', 'SDHB', 'FAF2', 'NFS1', 'CBX5', 'NDUFAB1', 'SDHA', 'MICU1', 'DLD', 'PDK2', 'MBD1', 'NDUFV3', 'TRIM28', 'MICU2', 'MFN1', 'PEPD', 'UBA5', 'OGDH', 'PHB1', 'UFM1', 'BCKDHA']
388	HPA	HPA:0030051	appendix; glandular cells[≥Low]	0.0002488677643094	True	appendix; glandular cells[≥Low]	6741	83	71	11006	0.8554216867469879	0.010532561934431	query_1	['HPA:0030000']	['RBBP8', 'SNX6', 'UBE2I', 'PDK4', 'GCSH', 'PPM1K', 'SNX1', 'LYRM4', 'ADSL', 'MAIP1', 'NBN', 'ATF7IP', 'DLST', 'HSPA9', 'MCUB', 'UBAC2', 'XRCC6', 'PAXIP1', 'DLAT', 'PDHX', 'SETDB2', 'PDHB', 'H2AX', 'DDRGK1', 'UFL1', 'MDC1', 'PMPCA', 'MCAT', 'SDHD', 'DBT', 'MCU', 'BCKDK', 'BCKDHB', 'PDHA1', 'SUMO1', 'RPA1', 'PDK3', 'ARL14EP', 'FLYWCH1', 'BLM', 'PIAS1', 'MRE11', 'VDAC1', 'RAD51', 'AFG3L2', 'HDAC6', 'ISCU', 'PDK1', 'NSUN6', 'SDHB', 'FAF2', 'NFS1', 'CBX5', 'NDUFAB1', 'BRCA1', 'SDHA', 'MICU1', 'DLD', 'PDK2', 'MBD1', 'NDUFV3', 'MICU2', 'MFN1', 'PEPD', 'PMPCB', 'UBA5', 'OGDH', 'PHB1', 'UFM1', 'STAT5B', 'BCKDHA']
389	GO:BP	GO:0019538	protein metabolic process	0.0002502587511098	True	"""The chemical reactions and pathways involving a protein. Includes protein modification."" [GOC:ma]"	5449	96	49	21110	0.5104166666666666	0.0089924756836116	query_1	['GO:0043170', 'GO:0044238', 'GO:1901564']	['PPIF', 'SNX6', 'UBE2I', 'PDK4', 'GCSH', 'SPG7', 'PPM1K', 'SNX1', 'CDK5RAP3', 'NBN', 'DLST', 'RAD50', 'UBAC2', 'XRCC6', 'PAXIP1', 'SETDB2', 'DDRGK1', 'UFL1', 'PMPCA', 'PHB2', 'METTL21C', 'BRCA2', 'SETDB1', 'BCKDK', 'SUMO1', 'HSPD1', 'PDK3', 'BLM', 'PIAS1', 'MRE11', 'RAD51', 'AFG3L2', 'HDAC6', 'MOCS3', 'PDK1', 'FAF2', 'NFS1', 'NDUFAB1', 'BRCA1', 'DLD', 'PDK2', 'TRIM28', 'BARD1', 'PEPD', 'PMPCB', 'UBA5', 'OGDH', 'PHB1', 'UFM1']
390	GO:BP	GO:0022900	electron transport chain	0.0002627133130102	True	"""A process in which a series of electron carriers operate together to transfer electrons from donors to any of several different terminal electron acceptors."" [GOC:mtg_electron_transport]"	176	96	9	21110	0.09375	0.0511363636363636	query_1	['GO:0006091']	['SDHD', 'ISCU', 'GPD1', 'SDHB', 'NDUFAB1', 'SDHA', 'SDHC', 'DLD', 'NDUFV3']
391	REAC	REAC:R-HSA-3899300	SUMOylation of transcription cofactors	0.0002709023850695	True	SUMOylation of transcription cofactors	41	84	6	10790	0.0714285714285714	0.1463414634146341	query_1	['REAC:R-HSA-3108232']	['UBE2I', 'ZNF350', 'SUMO1', 'PIAS1', 'MBD1', 'TRIM28']
392	GO:BP	GO:0032392	DNA geometric change	0.000283565218285	True	"""The process in which a transformation is induced in the geometry of a DNA double helix, resulting in a change in twist, writhe, or both, but with no change in linking number. Includes the unwinding of double-stranded DNA by helicases."" [GOC:mah]"	85	96	7	21110	0.0729166666666666	0.0823529411764705	query_1	['GO:0071103']	['NBN', 'RAD50', 'XRCC6', 'RPA1', 'BLM', 'MRE11', 'RAD51']
393	GO:MF	GO:0016635	oxidoreductase activity, acting on the CH-CH group of donors, quinone or related compound as acceptor	0.0003058528199088	True	"""Catalysis of an oxidation-reduction (redox) reaction in which a CH-CH group acts as a hydrogen or electron donor and reduces a quinone or related compound."" [GOC:jl]"	4	97	3	20195	0.0309278350515463	0.75	query_1	['GO:0016627']	['SDHD', 'SDHB', 'SDHA']
394	GO:BP	GO:0044571	[2Fe-2S] cluster assembly	0.000307910497207	True	"""The incorporation of two iron atoms and two sulfur atoms into an iron-sulfur cluster."" [GOC:jl, GOC:mengo_curators, GOC:pde, GOC:tt, GOC:vw, PMID:15952888]"	11	96	4	21110	0.0416666666666666	0.3636363636363636	query_1	['GO:0016226']	['LYRM4', 'ISCU', 'NFS1', 'NDUFAB1']
395	HPA	HPA:0290000	liver	0.0003391667967893	True	liver	6292	83	68	11006	0.8192771084337349	0.010807374443738	query_1	['HPA:0000000']	['PDK4', 'GCSH', 'SNX1', 'ADSL', 'MAIP1', 'CDK5RAP3', 'NBN', 'OTC', 'DLST', 'HSPA9', 'TP53BP1', 'RAD50', 'UBAC2', 'XRCC6', 'DLAT', 'PDHX', 'SETDB2', 'H2AX', 'DDRGK1', 'UFL1', 'MDC1', 'PMPCA', 'PHB2', 'MCAT', 'SDHD', 'DBT', 'MCU', 'SIL1', 'BCKDK', 'BCKDHB', 'PDHA1', 'SUMO1', 'HSPD1', 'RPA1', 'PDK3', 'FLYWCH1', 'BLM', 'PIAS1', 'MRE11', 'VDAC1', 'HDAC6', 'ISCU', 'GPD1', 'PDK1', 'NSUN6', 'SDHB', 'FAF2', 'NFS1', 'NDUFAB1', 'BRCA1', 'SDHA', 'MICU1', 'STAT5A', 'DLD', 'PDK2', 'NDUFV3', 'TRIM28', 'BARD1', 'MICU2', 'MFN1', 'PEPD', 'PMPCB', 'UBA5', 'OGDH', 'PHB1', 'UFM1', 'STAT5B', 'BCKDHA']
396	HPA	HPA:0160252	endometrium 1; cells in endometrial stroma[≥Medium]	0.0003422899075964	True	endometrium 1; cells in endometrial stroma[≥Medium]	2232	83	36	11006	0.4337349397590361	0.0161290322580645	query_1	['HPA:0160251']	['UBE2I', 'PDK4', 'GCSH', 'ADSL', 'DLST', 'HSPA9', 'TP53BP1', 'XRCC6', 'PDHX', 'SETDB2', 'H2AX', 'MDC1', 'PHB2', 'MCU', 'SIL1', 'PDHA1', 'SUMO1', 'RPA1', 'ARL14EP', 'FLYWCH1', 'BLM', 'PIAS1', 'MRE11', 'ISCU', 'PDK1', 'SDHB', 'NFS1', 'CBX5', 'MICU1', 'PDK2', 'MBD1', 'NDUFV3', 'TRIM28', 'OGDH', 'PHB1', 'BCKDHA']
397	HPA	HPA:0030072	appendix; lymphoid tissue[≥Medium]	0.0003441651723199	True	appendix; lymphoid tissue[≥Medium]	2983	83	43	11006	0.5180722891566265	0.0144150184378142	query_1	['HPA:0030071']	['RBBP8', 'UBE2I', 'PDK4', 'GCSH', 'SNX1', 'ADSL', 'ATF7IP', 'DLST', 'HSPA9', 'XRCC6', 'PAXIP1', 'PDHX', 'SETDB2', 'PDHB', 'H2AX', 'MDC1', 'PMPCA', 'SDHD', 'RPA1', 'FLYWCH1', 'BLM', 'PIAS1', 'MRE11', 'VDAC1', 'ISCU', 'PDK1', 'NSUN6', 'SDHB', 'FAF2', 'NFS1', 'NDUFAB1', 'BRCA1', 'SDHA', 'MICU1', 'STAT5A', 'DLD', 'MBD1', 'NDUFV3', 'PEPD', 'PMPCB', 'OGDH', 'PHB1', 'UFM1']
398	HP	HP:0001941	Acidosis	0.0003662580330401	True	Abnormal acid accumulation or depletion of base.	374	54	17	4851	0.3148148148148148	0.0454545454545454	query_1	['HP:0004360']	['LYRM4', 'DLAT', 'PDHX', 'PDHB', 'PMPCA', 'SDHD', 'DBT', 'BCKDHB', 'PDHA1', 'ISCU', 'SDHB', 'NFS1', 'SDHA', 'DLD', 'PMPCB', 'OGDH', 'BCKDHA']
399	HP	HP:0008775	Abnormal prostate morphology	0.0003734357332422	True	An abnormality of the prostate.	42	54	7	4851	0.1296296296296296	0.1666666666666666	query_1	['HP:0000022']	['NBN', 'RAD50', 'BRCA2', 'MRE11', 'RAD51', 'BRCA1', 'BARD1']
400	HPA	HPA:0540053	stomach 1; glandular cells[High]	0.0003758275921473	True	stomach 1; glandular cells[High]	2448	83	38	11006	0.4578313253012048	0.0155228758169934	query_1	['HPA:0540052']	['PDK4', 'GCSH', 'MAIP1', 'CDK5RAP3', 'HSPA9', 'TP53BP1', 'RAD50', 'XRCC6', 'PAXIP1', 'SETDB2', 'PDHB', 'H2AX', 'MCAT', 'SDHD', 'DBT', 'BCKDK', 'BCKDHB', 'RPA1', 'FLYWCH1', 'BLM', 'MRE11', 'AFG3L2', 'ISCU', 'SDHB', 'NDUFAB1', 'SDHA', 'MICU1', 'DLD', 'PDK2', 'NDUFV3', 'TRIM28', 'MICU2', 'PMPCB', 'UBA5', 'OGDH', 'PHB1', 'UFM1', 'BCKDHA']
401	GO:BP	GO:0009081	branched-chain amino acid metabolic process	0.0003770883836794	True	"""The chemical reactions and pathways involving amino acids containing a branched carbon skeleton, comprising isoleucine, leucine and valine."" [GOC:ai]"	28	96	5	21110	0.0520833333333333	0.1785714285714285	query_1	['GO:0006520']	['DBT', 'BCKDK', 'BCKDHB', 'DLD', 'BCKDHA']
402	GO:BP	GO:0010564	regulation of cell cycle process	0.0003946938891265	True	"""Any process that modulates a cellular process that is involved in the progression of biochemical and morphological phases and events that occur in a cell during successive cell replication or nuclear replication events."" [GOC:dph, GOC:tb]"	726	96	16	21110	0.1666666666666666	0.0220385674931129	query_1	['GO:0022402', 'GO:0051726']	['RBBP8', 'CDK5RAP3', 'NBN', 'TP53BP1', 'RAD50', 'PAXIP1', 'H2AX', 'DDRGK1', 'MDC1', 'PHB2', 'BRCA2', 'BLM', 'MRE11', 'RAD51', 'BRCA1', 'BARD1']
403	GO:BP	GO:0030520	intracellular estrogen receptor signaling pathway	0.0004354570797794	True	"""The series of molecular signals initiated by estrogen binding to an intracellular receptor, and ending with the regulation of a downstream cellular process, e.g. transcription."" [GOC:mah, GOC:signaling]"	55	96	6	21110	0.0625	0.109090909090909	query_1	['GO:0030518']	['DDRGK1', 'UFL1', 'PHB2', 'BRCA1', 'UBA5', 'UFM1']
404	GO:BP	GO:0008152	metabolic process	0.0004541343040746	True	"""The chemical reactions and pathways, including anabolism and catabolism, by which living organisms transform chemical substances. Metabolic processes typically transform small molecules, but also include macromolecular processes such as DNA repair and replication, and protein synthesis and degradation."" [GOC:go_curators, ISBN:0198547684]"	14409	96	87	21110	0.90625	0.0060378929835519	query_1	['GO:0008150']	['PPIF', 'RBBP8', 'SNX6', 'UBE2I', 'PDK4', 'GCSH', 'SPG7', 'PPM1K', 'SNX1', 'LYRM4', 'ADSL', 'CDK5RAP3', 'NBN', 'OTC', 'ATF7IP', 'DLST', 'HSPA9', 'TP53BP1', 'RAD50', 'ZNF45', 'UBAC2', 'ZNF350', 'XRCC6', 'TALDO1', 'PAXIP1', 'DLAT', 'PDHA2', 'PDHX', 'SETDB2', 'PDHB', 'H2AX', 'DDRGK1', 'UFL1', 'MDC1', 'PMPCA', 'PHB2', 'MCAT', 'METTL21C', 'SDHD', 'DBT', 'BRCA2', 'SETDB1', 'BCKDK', 'BCKDHB', 'PDHA1', 'SUMO1', 'HSPD1', 'RPA1', 'PDK3', 'FLYWCH1', 'BLM', 'PIAS1', 'MRE11', 'VDAC1', 'RAD51', 'AFG3L2', 'HDAC6', 'MOCS3', 'ISCU', 'GPD1', 'PDK1', 'NSUN6', 'SDHB', 'FAF2', 'NFS1', 'CBX5', 'NDUFAB1', 'BRCA1', 'SDHA', 'STAT5A', 'SDHC', 'DLD', 'PDK2', 'MBD1', 'NDUFV3', 'TRIM28', 'BARD1', 'MFN1', 'ABHD6', 'PEPD', 'PMPCB', 'UBA5', 'OGDH', 'PHB1', 'UFM1', 'STAT5B', 'BCKDHA']
405	GO:CC	GO:0045252	oxoglutarate dehydrogenase complex	0.0004599186884764	True	"""A complex of multiple copies of three enzymatic components: oxoglutarate dehydrogenase (lipoamide) (E1), dihydrolipoamide S-succinyltransferase (E2) and dihydrolipoamide dehydrogenase (E3); catalyzes the overall conversion of 2-oxoglutarate to succinyl-CoA and carbon dioxide (CO2)."" [MetaCyc:CPLX66-42, PMID:10848975]"	6	97	3	22122	0.0309278350515463	0.5	query_1	['GO:0045240', 'GO:1990234']	['DLST', 'DLD', 'OGDH']
406	GO:CC	GO:0030870	Mre11 complex	0.0004599186884764	True	"""Trimeric protein complex that possesses endonuclease activity; involved in meiotic recombination, DNA repair and checkpoint signaling. In Saccharomyces cerevisiae, the complex comprises Mre11p, Rad50p, and Xrs2p; complexes identified in other species generally contain proteins orthologous to the Saccharomyces cerevisiae proteins."" [GOC:mah, GOC:vw, PMID:11988766, PMID:17674145]"	6	97	3	22122	0.0309278350515463	0.5	query_1	['GO:0140513']	['NBN', 'RAD50', 'MRE11']
407	GO:BP	GO:0090309	positive regulation of DNA methylation-dependent heterochromatin formation	0.0004602563497081	True	"""Any process that increases the rate, frequency, or extent of DNA methylation-dependent heterochromatin formation."" [GOC:BHF]"	12	96	4	21110	0.0416666666666666	0.3333333333333333	query_1	['GO:0006346', 'GO:0031453', 'GO:0090308']	['ATF7IP', 'SETDB2', 'SETDB1', 'TRIM28']
408	HPA	HPA:0250000	hippocampus	0.0004684275934702	True	hippocampus	6822	83	71	11006	0.8554216867469879	0.0104075051304602	query_1	['HPA:0000000']	['PDK4', 'GCSH', 'PPM1K', 'SNX1', 'LYRM4', 'ADSL', 'MAIP1', 'CDK5RAP3', 'NBN', 'ATF7IP', 'DLST', 'HSPA9', 'TP53BP1', 'RAD50', 'UBAC2', 'XRCC6', 'PAXIP1', 'DLAT', 'PDHX', 'SETDB2', 'PDHB', 'H2AX', 'DDRGK1', 'MDC1', 'PMPCA', 'PHB2', 'MCAT', 'SDHD', 'DBT', 'MCU', 'SIL1', 'BCKDK', 'BCKDHB', 'PDHA1', 'SUMO1', 'HSPD1', 'RPA1', 'PDK3', 'ARL14EP', 'FLYWCH1', 'BLM', 'PIAS1', 'MRE11', 'VDAC1', 'AFG3L2', 'ISCU', 'GPD1', 'PDK1', 'NSUN6', 'SDHB', 'FAF2', 'NFS1', 'CBX5', 'NDUFAB1', 'BRCA1', 'SDHA', 'MICU1', 'DLD', 'PDK2', 'MBD1', 'NDUFV3', 'TRIM28', 'BARD1', 'MICU2', 'MFN1', 'PMPCB', 'UBA5', 'OGDH', 'PHB1', 'UFM1', 'BCKDHA']
409	GO:BP	GO:0061912	selective autophagy	0.0004904565241996	True	"""The macroautophagy process in which specific structures are targeted by the autophagy process."" [PMID:20484971, PMID:21997368, PMID:22966490]"	92	96	7	21110	0.0729166666666666	0.0760869565217391	query_1	['GO:0016236']	['DDRGK1', 'UFL1', 'PHB2', 'VDAC1', 'HDAC6', 'UBA5', 'UFM1']
410	HPA	HPA:0250132	hippocampus; neuronal cells[≥Medium]	0.0004979355546752	True	hippocampus; neuronal cells[≥Medium]	4222	83	53	11006	0.6385542168674698	0.0125532922785409	query_1	['HPA:0250131']	['PDK4', 'GCSH', 'PPM1K', 'LYRM4', 'ADSL', 'CDK5RAP3', 'DLST', 'HSPA9', 'TP53BP1', 'RAD50', 'XRCC6', 'DLAT', 'PDHX', 'SETDB2', 'PDHB', 'H2AX', 'PMPCA', 'PHB2', 'MCAT', 'MCU', 'SIL1', 'BCKDK', 'PDHA1', 'SUMO1', 'RPA1', 'PDK3', 'ARL14EP', 'FLYWCH1', 'BLM', 'PIAS1', 'MRE11', 'VDAC1', 'AFG3L2', 'ISCU', 'PDK1', 'SDHB', 'FAF2', 'NFS1', 'CBX5', 'NDUFAB1', 'SDHA', 'MICU1', 'DLD', 'PDK2', 'NDUFV3', 'TRIM28', 'BARD1', 'MFN1', 'PMPCB', 'OGDH', 'PHB1', 'UFM1', 'BCKDHA']
411	HPA	HPA:0500651	soft tissue 1; fibroblasts[≥Low]	0.0005280008807391	True	soft tissue 1; fibroblasts[≥Low]	4229	83	53	11006	0.6385542168674698	0.0125325135965949	query_1	['HPA:0500000']	['RBBP8', 'UBE2I', 'PDK4', 'GCSH', 'SNX1', 'LYRM4', 'ADSL', 'CDK5RAP3', 'ATF7IP', 'DLST', 'HSPA9', 'TP53BP1', 'RAD50', 'XRCC6', 'PAXIP1', 'DLAT', 'PDHX', 'SETDB2', 'H2AX', 'MDC1', 'PMPCA', 'PHB2', 'MCAT', 'SDHD', 'MCU', 'BCKDHB', 'PDHA1', 'SUMO1', 'HSPD1', 'ARL14EP', 'FLYWCH1', 'BLM', 'PIAS1', 'MRE11', 'VDAC1', 'AFG3L2', 'ISCU', 'PDK1', 'NSUN6', 'SDHB', 'NFS1', 'BRCA1', 'SDHA', 'MICU1', 'NDUFV3', 'TRIM28', 'MFN1', 'PEPD', 'UBA5', 'OGDH', 'PHB1', 'UFM1', 'BCKDHA']
412	GO:BP	GO:0071103	DNA conformation change	0.0005284233020031	True	"""A cellular process that results in a change in the spatial configuration of a DNA molecule. A conformation change can bend DNA, or alter the, twist, writhe, or linking number of a DNA molecule."" [GOC:mah]"	93	96	7	21110	0.0729166666666666	0.075268817204301	query_1	['GO:0051276']	['NBN', 'RAD50', 'XRCC6', 'RPA1', 'BLM', 'MRE11', 'RAD51']
413	GO:BP	GO:0043401	steroid hormone mediated signaling pathway	0.0005292282283139	True	"""The series of molecular signals mediated by a steroid hormone binding to a receptor."" [PMID:12606724]"	138	96	8	21110	0.0833333333333333	0.0579710144927536	query_1	['GO:0009755', 'GO:0071383']	['DDRGK1', 'UFL1', 'PHB2', 'HDAC6', 'BRCA1', 'UBA5', 'PHB1', 'UFM1']
414	REAC	REAC:R-HSA-3108214	SUMOylation of DNA damage response and repair proteins	0.0005310387214116	True	SUMOylation of DNA damage response and repair proteins	72	84	7	10790	0.0833333333333333	0.0972222222222222	query_1	['REAC:R-HSA-3108232']	['UBE2I', 'MDC1', 'SUMO1', 'RPA1', 'BLM', 'PIAS1', 'BRCA1']
415	HPA	HPA:0590052	thyroid gland; glandular cells[≥Medium]	0.0005450815087078	True	thyroid gland; glandular cells[≥Medium]	5595	83	63	11006	0.7590361445783133	0.0112600536193029	query_1	['HPA:0590051']	['UBE2I', 'PDK4', 'GCSH', 'PPM1K', 'SNX1', 'LYRM4', 'ADSL', 'CDK5RAP3', 'NBN', 'ATF7IP', 'DLST', 'HSPA9', 'TP53BP1', 'RAD50', 'XRCC6', 'PAXIP1', 'PDHX', 'SETDB2', 'PDHB', 'H2AX', 'DDRGK1', 'MDC1', 'PMPCA', 'PHB2', 'MCAT', 'DBT', 'MCU', 'SIL1', 'BCKDK', 'BCKDHB', 'PDHA1', 'SUMO1', 'RPA1', 'PDK3', 'ARL14EP', 'FLYWCH1', 'BLM', 'PIAS1', 'MRE11', 'AFG3L2', 'HDAC6', 'ISCU', 'GPD1', 'PDK1', 'SDHB', 'FAF2', 'NFS1', 'CBX5', 'NDUFAB1', 'BRCA1', 'SDHA', 'MICU1', 'DLD', 'PDK2', 'NDUFV3', 'TRIM28', 'MICU2', 'PMPCB', 'UBA5', 'OGDH', 'PHB1', 'UFM1', 'BCKDHA']
416	HPA	HPA:0340461	ovary; ovarian stroma cells[≥Low]	0.0005469606967065	True	ovary; ovarian stroma cells[≥Low]	3981	83	51	11006	0.6144578313253012	0.0128108515448379	query_1	['HPA:0340000']	['RBBP8', 'UBE2I', 'PDK4', 'GCSH', 'ADSL', 'NBN', 'DLST', 'HSPA9', 'TP53BP1', 'RAD50', 'XRCC6', 'PAXIP1', 'PDHX', 'SETDB2', 'H2AX', 'DDRGK1', 'MDC1', 'PHB2', 'MCU', 'SIL1', 'PDHA1', 'SUMO1', 'HSPD1', 'RPA1', 'ARL14EP', 'FLYWCH1', 'BLM', 'PIAS1', 'MRE11', 'VDAC1', 'AFG3L2', 'HDAC6', 'ISCU', 'PDK1', 'SDHB', 'FAF2', 'NFS1', 'CBX5', 'BRCA1', 'SDHA', 'MICU1', 'STAT5A', 'PDK2', 'MBD1', 'NDUFV3', 'TRIM28', 'PEPD', 'OGDH', 'PHB1', 'UFM1', 'BCKDHA']
417	HP	HP:0000526	Aniridia	0.000612260220841	True	Abnormality of the iris characterized by, typically bilateral, complete or partial iris hypoplasia. The phenotype ranges from mild defects of anterior iris stroma only to almost complete absence of the iris.	45	54	7	4851	0.1296296296296296	0.1555555555555555	query_1	['HP:0008053']	['DLST', 'SDHD', 'BRCA2', 'SDHB', 'SDHA', 'SDHC', 'TRIM28']
418	HPA	HPA:0170251	endometrium 2; cells in endometrial stroma[≥Low]	0.0006332372258037	True	endometrium 2; cells in endometrial stroma[≥Low]	3511	83	47	11006	0.5662650602409639	0.0133864995727712	query_1	['HPA:0170000']	['SNX6', 'UBE2I', 'PDK4', 'GCSH', 'SNX1', 'ADSL', 'NBN', 'DLST', 'HSPA9', 'TP53BP1', 'RAD50', 'UBAC2', 'XRCC6', 'PAXIP1', 'DLAT', 'PDHX', 'SETDB2', 'H2AX', 'MDC1', 'PMPCA', 'PHB2', 'MCAT', 'SDHD', 'MCU', 'PDHA1', 'SUMO1', 'RPA1', 'ARL14EP', 'BLM', 'PIAS1', 'MRE11', 'VDAC1', 'AFG3L2', 'ISCU', 'PDK1', 'SDHB', 'NFS1', 'NDUFAB1', 'BRCA1', 'SDHA', 'MICU1', 'NDUFV3', 'TRIM28', 'PMPCB', 'OGDH', 'PHB1', 'BCKDHA']
419	GO:MF	GO:0042162	telomeric DNA binding	0.0006350557780968	True	"""Binding to a telomere, a specific structure at the end of a linear chromosome required for the integrity and maintenance of the end."" [GOC:jl, SO:0000624]"	37	97	5	20195	0.0515463917525773	0.1351351351351351	query_1	['GO:0043565']	['TP53BP1', 'RAD50', 'XRCC6', 'RPA1', 'BLM']
420	GO:BP	GO:0009755	hormone-mediated signaling pathway	0.000656471501674	True	"""The series of molecular signals mediated by the detection of a hormone."" [GOC:sm]"	196	96	9	21110	0.09375	0.0459183673469387	query_1	['GO:0007165', 'GO:0032870']	['DDRGK1', 'UFL1', 'PHB2', 'METTL21C', 'HDAC6', 'BRCA1', 'UBA5', 'PHB1', 'UFM1']
421	HPA	HPA:0210051	fallopian tube; glandular cells[≥Low]	0.000661855677425	True	fallopian tube; glandular cells[≥Low]	5767	83	64	11006	0.7710843373493976	0.0110976244147737	query_1	['HPA:0210000']	['RBBP8', 'PDK4', 'GCSH', 'PPM1K', 'LYRM4', 'ADSL', 'CDK5RAP3', 'NBN', 'DLST', 'HSPA9', 'MCUB', 'TP53BP1', 'XRCC6', 'PAXIP1', 'DLAT', 'PDHX', 'SETDB2', 'H2AX', 'DDRGK1', 'UFL1', 'MDC1', 'PHB2', 'MCAT', 'SDHD', 'SIL1', 'BCKDK', 'BCKDHB', 'PDHA1', 'SUMO1', 'HSPD1', 'RPA1', 'ARL14EP', 'FLYWCH1', 'BLM', 'MRE11', 'VDAC1', 'RAD51', 'AFG3L2', 'HDAC6', 'ISCU', 'GPD1', 'PDK1', 'SDHB', 'FAF2', 'NFS1', 'CBX5', 'NDUFAB1', 'SDHA', 'MICU1', 'STAT5A', 'DLD', 'PDK2', 'NDUFV3', 'TRIM28', 'BARD1', 'MICU2', 'MFN1', 'PEPD', 'UBA5', 'OGDH', 'PHB1', 'UFM1', 'STAT5B', 'BCKDHA']
422	GO:BP	GO:0034982	mitochondrial protein processing	0.0006624983933544	True	"""The peptide cleavage of mitochondrial proteins, including cleavage contributing to their import."" [GOC:curators]"	13	96	4	21110	0.0416666666666666	0.3076923076923077	query_1	['GO:0016485']	['SPG7', 'PMPCA', 'AFG3L2', 'PMPCB']
423	GO:BP	GO:0042762	regulation of sulfur metabolic process	0.0006624983933544	True	"""Any process that modulates the frequency, rate or extent of the chemical reactions and pathways involving sulfur, the nonmetallic element sulfur or compounds that contain sulfur."" [GOC:go_curators]"	13	96	4	21110	0.0416666666666666	0.3076923076923077	query_1	['GO:0006790', 'GO:0031323']	['PDK4', 'PDK3', 'PDK1', 'PDK2']
424	CORUM	CORUM:6946	BARD1–BRCA1–RAD51 complex	0.0006653583810326	True	BARD1–BRCA1–RAD51 complex	3	47	3	3383	0.0638297872340425	1.0	query_1	['CORUM:0000000']	['RAD51', 'BRCA1', 'BARD1']
425	CORUM	CORUM:7050	PIAS1-SUMO1-UBC9 complex	0.0006653583810326	True	PIAS1-SUMO1-UBC9 complex	3	47	3	3383	0.0638297872340425	1.0	query_1	['CORUM:0000000']	['UBE2I', 'SUMO1', 'PIAS1']
426	CORUM	CORUM:2818	BRCA1-BARD1-BRCA2-DNA damage complex III	0.0006653583810326	True	BRCA1-BARD1-BRCA2-DNA damage complex III	3	47	3	3383	0.0638297872340425	1.0	query_1	['CORUM:0000000']	['BRCA2', 'BRCA1', 'BARD1']
427	CORUM	CORUM:2767	RAD50-MRE11-NBN-p200-p350 complex	0.0006653583810326	True	RAD50-MRE11-NBN-p200-p350 complex	3	47	3	3383	0.0638297872340425	1.0	query_1	['CORUM:0000000']	['NBN', 'RAD50', 'MRE11']
428	CORUM	CORUM:2238	MBD1-MCAF1-SETDB1 complex	0.0006653583810326	True	MBD1-MCAF1-SETDB1 complex	3	47	3	3383	0.0638297872340425	1.0	query_1	['CORUM:0000000']	['ATF7IP', 'SETDB1', 'MBD1']
429	CORUM	CORUM:71	MRN complex (MRE11-RAD50-NBN complex)	0.0006653583810326	True	MRN complex (MRE11-RAD50-NBN complex)	3	47	3	3383	0.0638297872340425	1.0	query_1	['CORUM:0000000']	['NBN', 'RAD50', 'MRE11']
430	CORUM	CORUM:173	MRN complex (MRE11-RAD50-NBN complex)	0.0006653583810326	True	MRN complex (MRE11-RAD50-NBN complex)	3	47	3	3383	0.0638297872340425	1.0	query_1	['CORUM:0000000']	['NBN', 'RAD50', 'MRE11']
431	CORUM	CORUM:240	BRCA1-CTIP-ZBRK1 repressor complex	0.0006653583810326	True	BRCA1-CTIP-ZBRK1 repressor complex	3	47	3	3383	0.0638297872340425	1.0	query_1	['CORUM:0000000']	['RBBP8', 'ZNF350', 'BRCA1']
432	CORUM	CORUM:331	MRN complex (MRE11-RAD50-NBN complex)	0.0006653583810326	True	MRN complex (MRE11-RAD50-NBN complex)	3	47	3	3383	0.0638297872340425	1.0	query_1	['CORUM:0000000']	['NBN', 'RAD50', 'MRE11']
433	CORUM	CORUM:618	MRN complex (MRE11-RAD50-NBN complex)	0.0006653583810326	True	MRN complex (MRE11-RAD50-NBN complex)	3	47	3	3383	0.0638297872340425	1.0	query_1	['CORUM:0000000']	['NBN', 'RAD50', 'MRE11']
434	CORUM	CORUM:972	MRN complex (MRE11-RAD50-NBN complex)	0.0006653583810326	True	MRN complex (MRE11-RAD50-NBN complex)	3	47	3	3383	0.0638297872340425	1.0	query_1	['CORUM:0000000']	['NBN', 'RAD50', 'MRE11']
435	CORUM	CORUM:73	MRN complex (MRE11-RAD50-NBN complex)	0.0006653583810326	True	MRN complex (MRE11-RAD50-NBN complex)	3	47	3	3383	0.0638297872340425	1.0	query_1	['CORUM:0000000']	['NBN', 'RAD50', 'MRE11']
436	CORUM	CORUM:1081	MRN complex (MRE11-RAD50-NBN complex)	0.0006653583810326	True	MRN complex (MRE11-RAD50-NBN complex)	3	47	3	3383	0.0638297872340425	1.0	query_1	['CORUM:0000000']	['NBN', 'RAD50', 'MRE11']
437	GO:BP	GO:0005996	monosaccharide metabolic process	0.0006671905806808	True	"""The chemical reactions and pathways involving monosaccharides, the simplest carbohydrates. They are polyhydric alcohols containing either an aldehyde or a keto group and between three to ten or more carbon atoms. They form the constitutional repeating units of oligo- and polysaccharides."" [ISBN:0198506732]"	258	96	10	21110	0.1041666666666666	0.0387596899224806	query_1	['GO:0005975', 'GO:0044281']	['PDK4', 'DLAT', 'PDHA2', 'PDHB', 'BCKDK', 'PDHA1', 'PDK3', 'GPD1', 'PDK1', 'PDK2']
438	HPA	HPA:0100131	cerebral cortex; neuronal cells[≥Low]	0.0006771821098671	True	cerebral cortex; neuronal cells[≥Low]	6704	83	70	11006	0.8433734939759037	0.0104415274463007	query_1	['HPA:0100000']	['UBE2I', 'PDK4', 'GCSH', 'PPM1K', 'LYRM4', 'ADSL', 'MAIP1', 'CDK5RAP3', 'NBN', 'ATF7IP', 'DLST', 'HSPA9', 'TP53BP1', 'RAD50', 'UBAC2', 'XRCC6', 'DLAT', 'PDHX', 'SETDB2', 'PDHB', 'H2AX', 'MDC1', 'PMPCA', 'PHB2', 'MCAT', 'SDHD', 'DBT', 'MCU', 'SIL1', 'BCKDK', 'BCKDHB', 'PDHA1', 'SUMO1', 'HSPD1', 'RPA1', 'PDK3', 'ARL14EP', 'FLYWCH1', 'BLM', 'PIAS1', 'MRE11', 'VDAC1', 'AFG3L2', 'HDAC6', 'ISCU', 'PDK1', 'NSUN6', 'SDHB', 'NFS1', 'CBX5', 'NDUFAB1', 'BRCA1', 'SDHA', 'MICU1', 'DLD', 'PDK2', 'MBD1', 'NDUFV3', 'TRIM28', 'BARD1', 'MICU2', 'MFN1', 'PEPD', 'PMPCB', 'UBA5', 'OGDH', 'PHB1', 'UFM1', 'STAT5B', 'BCKDHA']
439	GO:CC	GO:1990391	DNA repair complex	0.0006793125061825	True	"""A protein complex involved in DNA repair processes including direct reversal, base excision repair, nucleotide excision repair, photoreactivation, bypass, double-strand break repair pathway, and mismatch repair pathway."" [GOC:bhm, PMID:17217467, PMID:20551348, PMID:22749910, PMID:24192350]"	22	97	4	22122	0.0412371134020618	0.1818181818181818	query_1	['GO:1902494']	['TP53BP1', 'XRCC6', 'BRCA2', 'BRCA1']
440	HPA	HPA:0320103	nasopharynx; respiratory epithelial cells[High]	0.0006917713678761	True	nasopharynx; respiratory epithelial cells[High]	1797	83	31	11006	0.3734939759036144	0.0172509738452977	query_1	['HPA:0320102']	['PDK4', 'GCSH', 'LYRM4', 'ADSL', 'CDK5RAP3', 'HSPA9', 'TP53BP1', 'XRCC6', 'PAXIP1', 'PDHX', 'SETDB2', 'MDC1', 'PHB2', 'MCAT', 'BCKDK', 'SUMO1', 'RPA1', 'FLYWCH1', 'BLM', 'MRE11', 'VDAC1', 'AFG3L2', 'ISCU', 'SDHB', 'NFS1', 'MICU1', 'DLD', 'PDK2', 'TRIM28', 'MICU2', 'BCKDHA']
441	GO:BP	GO:0000086	G2/M transition of mitotic cell cycle	0.0006957228164958	True	"""The mitotic cell cycle transition by which a cell in G2 commits to M phase. The process begins when the kinase activity of M cyclin/CDK complex reaches a threshold high enough for the cell cycle to proceed. This is accomplished by activating a positive feedback loop that results in the accumulation of unphosphorylated and active M cyclin/CDK complex."" [GOC:mtg_cell_cycle]"	143	96	8	21110	0.0833333333333333	0.0559440559440559	query_1	['GO:0044772', 'GO:0044839']	['RBBP8', 'CDK5RAP3', 'NBN', 'RAD50', 'BLM', 'MRE11', 'BRCA1', 'BARD1']
442	HPA	HPA:0250121	hippocampus; glial cells[≥Low]	0.0007130033604584	True	hippocampus; glial cells[≥Low]	4138	83	52	11006	0.6265060240963856	0.0125664572257129	query_1	['HPA:0250000']	['PDK4', 'GCSH', 'SNX1', 'LYRM4', 'ADSL', 'MAIP1', 'CDK5RAP3', 'ATF7IP', 'DLST', 'HSPA9', 'TP53BP1', 'RAD50', 'XRCC6', 'PAXIP1', 'DLAT', 'PDHX', 'SETDB2', 'H2AX', 'MDC1', 'PMPCA', 'PHB2', 'MCAT', 'MCU', 'SIL1', 'PDHA1', 'HSPD1', 'RPA1', 'FLYWCH1', 'BLM', 'PIAS1', 'MRE11', 'VDAC1', 'AFG3L2', 'ISCU', 'PDK1', 'SDHB', 'NFS1', 'CBX5', 'BRCA1', 'SDHA', 'MICU1', 'DLD', 'PDK2', 'NDUFV3', 'TRIM28', 'BARD1', 'PMPCB', 'UBA5', 'OGDH', 'PHB1', 'UFM1', 'BCKDHA']
443	GO:MF	GO:0008134	transcription factor binding	0.0007270240494952	True	"""Binding to a transcription factor, a protein required to initiate or regulate transcription."" [ISBN:0198506732]"	599	97	14	20195	0.1443298969072164	0.023372287145242	query_1	['GO:0005515']	['RBBP8', 'UBE2I', 'CDK5RAP3', 'NBN', 'TP53BP1', 'DDRGK1', 'PHB2', 'SUMO1', 'FLYWCH1', 'PIAS1', 'HDAC6', 'CBX5', 'STAT5A', 'STAT5B']
444	HPA	HPA:0060101	bronchus; respiratory epithelial cells[≥Low]	0.00074111385817	True	bronchus; respiratory epithelial cells[≥Low]	5931	83	65	11006	0.7831325301204819	0.0109593660428258	query_1	['HPA:0060000']	['RBBP8', 'PDK4', 'GCSH', 'PPM1K', 'LYRM4', 'ADSL', 'CDK5RAP3', 'NBN', 'DLST', 'HSPA9', 'MCUB', 'TP53BP1', 'UBAC2', 'XRCC6', 'PAXIP1', 'DLAT', 'PDHX', 'SETDB2', 'H2AX', 'DDRGK1', 'UFL1', 'MDC1', 'PHB2', 'MCAT', 'SDHD', 'SIL1', 'BCKDK', 'BCKDHB', 'PDHA1', 'SUMO1', 'HSPD1', 'RPA1', 'ARL14EP', 'FLYWCH1', 'BLM', 'MRE11', 'VDAC1', 'RAD51', 'AFG3L2', 'HDAC6', 'ISCU', 'GPD1', 'PDK1', 'SDHB', 'FAF2', 'NFS1', 'CBX5', 'NDUFAB1', 'SDHA', 'MICU1', 'DLD', 'PDK2', 'MBD1', 'NDUFV3', 'TRIM28', 'BARD1', 'MICU2', 'MFN1', 'PEPD', 'UBA5', 'OGDH', 'PHB1', 'UFM1', 'STAT5B', 'BCKDHA']
445	HP	HP:0009711	Retinal capillary hemangioma	0.0007413284255772	True	A benign vascular tumor of the retina without any neoplastic characteristics.	16	54	5	4851	0.0925925925925925	0.3125	query_1	['HP:0001028', 'HP:0009594', 'HP:0010797']	['DLST', 'SDHD', 'SDHB', 'SDHA', 'SDHC']
446	HP	HP:0012222	Arachnoid hemangiomatosis	0.0007413284255772	True	The presence of multiple hemangiomas in the arachnoid.	16	54	5	4851	0.0925925925925925	0.3125	query_1	['HP:0001028']	['DLST', 'SDHD', 'SDHB', 'SDHA', 'SDHC']
447	GO:BP	GO:0046483	heterocycle metabolic process	0.0007570322318475	True	"""The chemical reactions and pathways involving heterocyclic compounds, those with a cyclic molecular structure and at least two different atoms in the ring (or rings)."" [ISBN:0198506732]"	8221	96	62	21110	0.6458333333333334	0.0075416615983457	query_1	['GO:0044237']	['RBBP8', 'SNX6', 'UBE2I', 'PDK4', 'ADSL', 'CDK5RAP3', 'NBN', 'ATF7IP', 'DLST', 'TP53BP1', 'RAD50', 'ZNF45', 'ZNF350', 'XRCC6', 'TALDO1', 'PAXIP1', 'DLAT', 'PDHA2', 'PDHX', 'SETDB2', 'PDHB', 'H2AX', 'DDRGK1', 'UFL1', 'MDC1', 'PHB2', 'SDHD', 'BRCA2', 'SETDB1', 'PDHA1', 'SUMO1', 'HSPD1', 'RPA1', 'PDK3', 'FLYWCH1', 'BLM', 'PIAS1', 'MRE11', 'RAD51', 'HDAC6', 'MOCS3', 'GPD1', 'PDK1', 'NSUN6', 'SDHB', 'NFS1', 'CBX5', 'NDUFAB1', 'BRCA1', 'SDHA', 'STAT5A', 'SDHC', 'DLD', 'PDK2', 'MBD1', 'NDUFV3', 'TRIM28', 'BARD1', 'MFN1', 'OGDH', 'PHB1', 'STAT5B']
448	GO:BP	GO:0031163	metallo-sulfur cluster assembly	0.0007616269365665	True	"""The incorporation of a metal and exogenous sulfur into a metallo-sulfur cluster."" [GOC:jl, GOC:mah, GOC:pde, GOC:vw]"	32	96	5	21110	0.0520833333333333	0.15625	query_1	['GO:0022607']	['LYRM4', 'HSPA9', 'ISCU', 'NFS1', 'NDUFAB1']
449	GO:BP	GO:0010165	response to X-ray	0.0007616269365665	True	"""Any process that results in a change in state or activity of a cell or an organism (in terms of movement, secretion, enzyme production, gene expression, etc.) as a result of X-ray radiation. An X-ray is a form of electromagnetic radiation with a wavelength in the range of 10 nanometers to 100 picometers (corresponding to frequencies in the range 30 PHz to 3 EHz)."" [GOC:sm, Wikipedia:X-ray]"	32	96	5	21110	0.0520833333333333	0.15625	query_1	['GO:0010212']	['TP53BP1', 'XRCC6', 'BRCA2', 'BLM', 'RAD51']
450	GO:BP	GO:0016226	iron-sulfur cluster assembly	0.0007616269365665	True	"""The incorporation of iron and exogenous sulfur into a metallo-sulfur cluster."" [GOC:jl, GOC:mah, GOC:pde, GOC:vw]"	32	96	5	21110	0.0520833333333333	0.15625	query_1	['GO:0006790', 'GO:0031163']	['LYRM4', 'HSPA9', 'ISCU', 'NFS1', 'NDUFAB1']
451	HPA	HPA:0250122	hippocampus; glial cells[≥Medium]	0.0007714437947798	True	hippocampus; glial cells[≥Medium]	2002	83	33	11006	0.3975903614457831	0.0164835164835164	query_1	['HPA:0250121']	['PDK4', 'GCSH', 'LYRM4', 'ADSL', 'MAIP1', 'CDK5RAP3', 'DLST', 'HSPA9', 'TP53BP1', 'RAD50', 'XRCC6', 'PAXIP1', 'SETDB2', 'H2AX', 'MDC1', 'PHB2', 'MCAT', 'MCU', 'RPA1', 'FLYWCH1', 'BLM', 'PIAS1', 'MRE11', 'ISCU', 'PDK1', 'SDHB', 'CBX5', 'DLD', 'TRIM28', 'BARD1', 'OGDH', 'PHB1', 'BCKDHA']
452	GO:CC	GO:0005757	mitochondrial permeability transition pore complex	0.0008022937417216	True	"""A protein complex that connects the inner and outer membranes of animal mitochondria and acts as a pore that can open transiently to allow free diffusion of solutes between the mitochondrial matrix and the cytosol. The pore complex is formed of the voltage-dependent anion channel (VDAC), the adenine nucleotide translocase (ANT) and cyclophilin-D (CyP-D)."" [PMID:10393078]"	7	97	3	22122	0.0309278350515463	0.4285714285714285	query_1	['GO:0005740', 'GO:0046930', 'GO:0098798']	['PPIF', 'SPG7', 'VDAC1']
453	HPA	HPA:0150052	duodenum; glandular cells[≥Medium]	0.0008328653119457	True	duodenum; glandular cells[≥Medium]	6098	83	66	11006	0.7951807228915663	0.0108232207281075	query_1	['HPA:0150051']	['RBBP8', 'UBE2I', 'PDK4', 'GCSH', 'PPM1K', 'SNX1', 'ADSL', 'MAIP1', 'NBN', 'ATF7IP', 'DLST', 'HSPA9', 'UBAC2', 'XRCC6', 'PAXIP1', 'DLAT', 'PDHX', 'SETDB2', 'PDHB', 'H2AX', 'DDRGK1', 'UFL1', 'MDC1', 'PMPCA', 'MCAT', 'SDHD', 'DBT', 'MCU', 'BCKDK', 'BCKDHB', 'PDHA1', 'SUMO1', 'RPA1', 'PDK3', 'ARL14EP', 'FLYWCH1', 'BLM', 'PIAS1', 'MRE11', 'VDAC1', 'AFG3L2', 'HDAC6', 'ISCU', 'PDK1', 'NSUN6', 'SDHB', 'FAF2', 'NFS1', 'CBX5', 'NDUFAB1', 'BRCA1', 'SDHA', 'MICU1', 'DLD', 'PDK2', 'MBD1', 'NDUFV3', 'MICU2', 'MFN1', 'PEPD', 'PMPCB', 'UBA5', 'OGDH', 'PHB1', 'UFM1', 'BCKDHA']
454	HPA	HPA:0400052	rectum; glandular cells[≥Medium]	0.0008391902089982	True	rectum; glandular cells[≥Medium]	6099	83	66	11006	0.7951807228915663	0.0108214461387112	query_1	['HPA:0400051']	['RBBP8', 'UBE2I', 'PDK4', 'GCSH', 'PPM1K', 'SNX1', 'LYRM4', 'ADSL', 'MAIP1', 'NBN', 'ATF7IP', 'DLST', 'HSPA9', 'UBAC2', 'XRCC6', 'PAXIP1', 'DLAT', 'PDHX', 'SETDB2', 'PDHB', 'H2AX', 'DDRGK1', 'UFL1', 'MDC1', 'PMPCA', 'MCAT', 'SDHD', 'DBT', 'MCU', 'BCKDK', 'BCKDHB', 'PDHA1', 'SUMO1', 'RPA1', 'ARL14EP', 'FLYWCH1', 'BLM', 'PIAS1', 'MRE11', 'VDAC1', 'AFG3L2', 'HDAC6', 'ISCU', 'PDK1', 'NSUN6', 'SDHB', 'FAF2', 'NFS1', 'CBX5', 'NDUFAB1', 'BRCA1', 'SDHA', 'MICU1', 'DLD', 'PDK2', 'MBD1', 'NDUFV3', 'MICU2', 'MFN1', 'PEPD', 'PMPCB', 'UBA5', 'OGDH', 'PHB1', 'UFM1', 'BCKDHA']
455	GO:BP	GO:0045934	negative regulation of nucleobase-containing compound metabolic process	0.0008451126032065	True	"""Any cellular process that stops, prevents, or reduces the frequency, rate or extent of the chemical reactions and pathways involving nucleobases, nucleosides, nucleotides and nucleic acids."" [GOC:go_curators]"	1558	96	23	21110	0.2395833333333333	0.014762516046213	query_1	['GO:0006139', 'GO:0019219', 'GO:0031324', 'GO:0051172']	['RBBP8', 'SNX6', 'UBE2I', 'NBN', 'ATF7IP', 'TP53BP1', 'RAD50', 'ZNF350', 'XRCC6', 'SETDB2', 'PHB2', 'SETDB1', 'SUMO1', 'FLYWCH1', 'BLM', 'PIAS1', 'HDAC6', 'CBX5', 'BRCA1', 'MBD1', 'TRIM28', 'BARD1', 'PHB1']
456	HPA	HPA:0480051	small intestine; glandular cells[≥Low]	0.0008521771881256	True	small intestine; glandular cells[≥Low]	7070	83	72	11006	0.8674698795180723	0.0101838755304101	query_1	['HPA:0480000']	['RBBP8', 'SNX6', 'UBE2I', 'PDK4', 'GCSH', 'PPM1K', 'SNX1', 'LYRM4', 'ADSL', 'MAIP1', 'NBN', 'ATF7IP', 'DLST', 'HSPA9', 'MCUB', 'UBAC2', 'XRCC6', 'PAXIP1', 'DLAT', 'PDHX', 'SETDB2', 'PDHB', 'H2AX', 'DDRGK1', 'UFL1', 'MDC1', 'PMPCA', 'MCAT', 'SDHD', 'DBT', 'MCU', 'BCKDK', 'BCKDHB', 'PDHA1', 'SUMO1', 'RPA1', 'PDK3', 'ARL14EP', 'FLYWCH1', 'BLM', 'PIAS1', 'MRE11', 'VDAC1', 'RAD51', 'AFG3L2', 'HDAC6', 'ISCU', 'PDK1', 'NSUN6', 'SDHB', 'FAF2', 'NFS1', 'CBX5', 'NDUFAB1', 'BRCA1', 'SDHA', 'MICU1', 'DLD', 'PDK2', 'MBD1', 'NDUFV3', 'BARD1', 'MICU2', 'MFN1', 'PEPD', 'PMPCB', 'UBA5', 'OGDH', 'PHB1', 'UFM1', 'STAT5B', 'BCKDHA']
457	GO:BP	GO:0031860	telomeric 3' overhang formation	0.0008651529082233	True	"""The formation of the single stranded telomeric 3' overhang, a conserved feature that ranges in length from 12 nt in budding yeast to approximately 500 nt in humans."" [PMID:16096639]"	4	96	3	21110	0.03125	0.75	query_1	['GO:0016233', 'GO:0022616']	['NBN', 'RAD50', 'MRE11']
458	GO:BP	GO:0106077	histone succinylation	0.0008651529082233	True	"""The modification of a histone by the addition of an succinyl group."" [PMID:29211711]"	4	96	3	21110	0.03125	0.75	query_1	['GO:0018335']	['DLST', 'DLD', 'OGDH']
459	GO:BP	GO:0018335	protein succinylation	0.0008651529082233	True	"""The modification of a protein by the addition of a succinyl group (CO-CH2-CH2-CO) to an amino acid residue."" [GOC:bf]"	4	96	3	21110	0.03125	0.75	query_1	['GO:0043543']	['DLST', 'DLD', 'OGDH']
460	GO:BP	GO:0006139	nucleobase-containing compound metabolic process	0.0009261716723654	True	"""Any cellular metabolic process involving nucleobases, nucleosides, nucleotides and nucleic acids."" [GOC:ai]"	8049	96	61	21110	0.6354166666666666	0.0075785811902099	query_1	['GO:0006725', 'GO:0034641', 'GO:0044238', 'GO:0046483', 'GO:1901360']	['RBBP8', 'SNX6', 'UBE2I', 'PDK4', 'ADSL', 'CDK5RAP3', 'NBN', 'ATF7IP', 'DLST', 'TP53BP1', 'RAD50', 'ZNF45', 'ZNF350', 'XRCC6', 'TALDO1', 'PAXIP1', 'DLAT', 'PDHA2', 'PDHX', 'SETDB2', 'PDHB', 'H2AX', 'DDRGK1', 'UFL1', 'MDC1', 'PHB2', 'SDHD', 'BRCA2', 'SETDB1', 'PDHA1', 'SUMO1', 'HSPD1', 'RPA1', 'PDK3', 'FLYWCH1', 'BLM', 'PIAS1', 'MRE11', 'RAD51', 'HDAC6', 'MOCS3', 'GPD1', 'PDK1', 'NSUN6', 'SDHB', 'CBX5', 'NDUFAB1', 'BRCA1', 'SDHA', 'STAT5A', 'SDHC', 'DLD', 'PDK2', 'MBD1', 'NDUFV3', 'TRIM28', 'BARD1', 'MFN1', 'OGDH', 'PHB1', 'STAT5B']
461	GO:CC	GO:0098803	respiratory chain complex	0.0009677858023332	True	"""Any protein complex that is part of a respiratory chain."" [GOC:dos]"	93	97	6	22122	0.0618556701030927	0.064516129032258	query_1	['GO:0070469', 'GO:0098796']	['SDHD', 'SDHB', 'NDUFAB1', 'SDHA', 'SDHC', 'NDUFV3']
462	HPA	HPA:0210052	fallopian tube; glandular cells[≥Medium]	0.0009705306348266	True	fallopian tube; glandular cells[≥Medium]	4695	83	56	11006	0.6746987951807228	0.0119275825346112	query_1	['HPA:0210051']	['PDK4', 'GCSH', 'PPM1K', 'LYRM4', 'ADSL', 'CDK5RAP3', 'NBN', 'DLST', 'HSPA9', 'TP53BP1', 'XRCC6', 'PAXIP1', 'DLAT', 'PDHX', 'SETDB2', 'H2AX', 'DDRGK1', 'MDC1', 'PHB2', 'MCAT', 'SDHD', 'SIL1', 'BCKDK', 'BCKDHB', 'PDHA1', 'SUMO1', 'HSPD1', 'RPA1', 'ARL14EP', 'FLYWCH1', 'BLM', 'MRE11', 'VDAC1', 'AFG3L2', 'HDAC6', 'ISCU', 'GPD1', 'PDK1', 'SDHB', 'FAF2', 'NFS1', 'NDUFAB1', 'SDHA', 'MICU1', 'DLD', 'PDK2', 'NDUFV3', 'TRIM28', 'MICU2', 'MFN1', 'PEPD', 'UBA5', 'OGDH', 'PHB1', 'UFM1', 'BCKDHA']
463	HPA	HPA:0480053	small intestine; glandular cells[High]	0.0010089425642154	True	small intestine; glandular cells[High]	2544	83	38	11006	0.4578313253012048	0.0149371069182389	query_1	['HPA:0480052']	['PDK4', 'GCSH', 'SNX1', 'ADSL', 'ATF7IP', 'HSPA9', 'XRCC6', 'PAXIP1', 'PDHX', 'SETDB2', 'MDC1', 'PMPCA', 'MCU', 'BCKDK', 'PDHA1', 'SUMO1', 'FLYWCH1', 'BLM', 'PIAS1', 'MRE11', 'AFG3L2', 'ISCU', 'SDHB', 'FAF2', 'NFS1', 'NDUFAB1', 'SDHA', 'MICU1', 'DLD', 'PDK2', 'NDUFV3', 'MICU2', 'PEPD', 'PMPCB', 'OGDH', 'PHB1', 'UFM1', 'BCKDHA']
464	GO:CC	GO:0000793	condensed chromosome	0.0010312282136901	True	"""A highly compacted molecule of DNA and associated proteins resulting in a cytologically distinct structure."" [GOC:elh]"	277	97	9	22122	0.0927835051546391	0.0324909747292418	query_1	['GO:0005694']	['UBE2I', 'TP53BP1', 'RAD50', 'H2AX', 'BRCA2', 'BLM', 'RAD51', 'CBX5', 'BRCA1']
465	HP	HP:0002864	Paraganglioma of head and neck	0.0010413726766768	True	Paraganglioma of head and neck	17	54	5	4851	0.0925925925925925	0.2941176470588235	query_1	['HP:0002668']	['DLST', 'SDHD', 'SDHB', 'SDHA', 'SDHC']
466	HP	HP:0002640	Hypertension associated with pheochromocytoma	0.0010413726766768	True	A type of hypertension associated with pheochromocytoma.	17	54	5	4851	0.0925925925925925	0.2941176470588235	query_1	['HP:0000822']	['DLST', 'SDHD', 'SDHB', 'SDHA', 'SDHC']
467	HP	HP:0008629	Pulsatile tinnitus	0.0010413726766768	True	Pulsatile tinnitus is generally classified a kind of objective tinnitus, meaning that it is not only audible to the patient but also to the examiner on auscultation of the auditory canal and/or of surrounding structures with use of an auscultation tube or stethoscope. Usually, pulsatile tinnitus is heard as a lower pitched thumping or booming, a rougher blowing sound which is coincidental with respiration, or as a clicking, higher pitched rhythmic sensation.	17	54	5	4851	0.0925925925925925	0.2941176470588235	query_1	['HP:0000360']	['DLST', 'SDHD', 'SDHB', 'SDHA', 'SDHC']
468	HP	HP:0006737	Extraadrenal pheochromocytoma	0.0010413726766768	True	Pheochromocytoma not originating from the adrenal medulla but from another source such as from chromaffin cells in or about sympathetic ganglia.	17	54	5	4851	0.0925925925925925	0.2941176470588235	query_1	['HP:0002666']	['DLST', 'SDHD', 'SDHB', 'SDHA', 'SDHC']
469	HP	HP:0003574	Positive regitine blocking test	0.0010413726766768	True	A positive response to the regitine blocking test consisting of a substantial reduction in blood pressure following administration of regitine, indicative of the presence of increased levels of epinephrine and norepinephrine in the circulation, which is seen in pheochromocytoma-associated hypertension.	17	54	5	4851	0.0925925925925925	0.2941176470588235	query_1	['HP:0002640']	['DLST', 'SDHD', 'SDHB', 'SDHA', 'SDHC']
470	HP	HP:0000740	Episodic paroxysmal anxiety	0.0010413726766768	True	Recurrent attacks of severe anxiety, whose occurence is not restricted to any particular situation or set of circumstances and is therefore unpredictable.	17	54	5	4851	0.0925925925925925	0.2941176470588235	query_1	['HP:0000739']	['DLST', 'SDHD', 'SDHB', 'SDHA', 'SDHC']
471	HP	HP:0003639	Elevated urinary epinephrine	0.0010413726766768	True	An increased concentration of adrenaline in the urine.	17	54	5	4851	0.0925925925925925	0.2941176470588235	query_1	['HP:0011976']	['DLST', 'SDHD', 'SDHB', 'SDHA', 'SDHC']
472	HPA	HPA:0150051	duodenum; glandular cells[≥Low]	0.0010604568356043	True	duodenum; glandular cells[≥Low]	7099	83	72	11006	0.8674698795180723	0.0101422735596562	query_1	['HPA:0150000']	['RBBP8', 'SNX6', 'UBE2I', 'PDK4', 'GCSH', 'PPM1K', 'SNX1', 'LYRM4', 'ADSL', 'MAIP1', 'NBN', 'ATF7IP', 'DLST', 'HSPA9', 'MCUB', 'UBAC2', 'XRCC6', 'PAXIP1', 'DLAT', 'PDHX', 'SETDB2', 'PDHB', 'H2AX', 'DDRGK1', 'UFL1', 'MDC1', 'PMPCA', 'MCAT', 'SDHD', 'DBT', 'MCU', 'BCKDK', 'BCKDHB', 'PDHA1', 'SUMO1', 'RPA1', 'PDK3', 'ARL14EP', 'FLYWCH1', 'BLM', 'PIAS1', 'MRE11', 'VDAC1', 'RAD51', 'AFG3L2', 'HDAC6', 'ISCU', 'PDK1', 'NSUN6', 'SDHB', 'FAF2', 'NFS1', 'CBX5', 'NDUFAB1', 'BRCA1', 'SDHA', 'MICU1', 'DLD', 'PDK2', 'MBD1', 'NDUFV3', 'BARD1', 'MICU2', 'MFN1', 'PEPD', 'PMPCB', 'UBA5', 'OGDH', 'PHB1', 'UFM1', 'STAT5B', 'BCKDHA']
473	HPA	HPA:0630051	cervix; glandular cells[≥Low]	0.0011110904832682	True	cervix; glandular cells[≥Low]	5688	83	63	11006	0.7590361445783133	0.0110759493670886	query_1	['HPA:0630000']	['RBBP8', 'UBE2I', 'PPM1K', 'SNX1', 'ADSL', 'CDK5RAP3', 'NBN', 'ATF7IP', 'DLST', 'TP53BP1', 'RAD50', 'XRCC6', 'PAXIP1', 'DLAT', 'PDHX', 'SETDB2', 'PDHB', 'H2AX', 'DDRGK1', 'UFL1', 'PMPCA', 'PHB2', 'DBT', 'SIL1', 'BCKDK', 'BCKDHB', 'PDHA1', 'SUMO1', 'HSPD1', 'RPA1', 'PDK3', 'ARL14EP', 'FLYWCH1', 'BLM', 'PIAS1', 'MRE11', 'VDAC1', 'AFG3L2', 'HDAC6', 'ISCU', 'GPD1', 'PDK1', 'NSUN6', 'SDHB', 'FAF2', 'NFS1', 'CBX5', 'NDUFAB1', 'BRCA1', 'SDHA', 'MICU1', 'DLD', 'MBD1', 'NDUFV3', 'TRIM28', 'MICU2', 'MFN1', 'PMPCB', 'UBA5', 'OGDH', 'PHB1', 'UFM1', 'BCKDHA']
474	GO:BP	GO:0070588	calcium ion transmembrane transport	0.0011205443452953	True	"""A process in which a calcium ion is transported from one side of a membrane to the other by means of some agent such as a transporter or pore."" [GOC:mah]"	344	96	11	21110	0.1145833333333333	0.0319767441860465	query_1	['GO:0006816', 'GO:0098655', 'GO:0098662']	['MAIP1', 'MCUB', 'METTL21C', 'MCU', 'SUMO1', 'VDAC1', 'AFG3L2', 'MICU1', 'SMDT1', 'MICU2', 'PMPCB']
475	HPA	HPA:0100132	cerebral cortex; neuronal cells[≥Medium]	0.0011639880651059	True	cerebral cortex; neuronal cells[≥Medium]	4988	83	58	11006	0.6987951807228916	0.0116279069767441	query_1	['HPA:0100131']	['UBE2I', 'PDK4', 'GCSH', 'PPM1K', 'LYRM4', 'ADSL', 'MAIP1', 'CDK5RAP3', 'ATF7IP', 'DLST', 'HSPA9', 'TP53BP1', 'RAD50', 'XRCC6', 'DLAT', 'PDHX', 'SETDB2', 'PDHB', 'H2AX', 'MDC1', 'PMPCA', 'PHB2', 'MCAT', 'MCU', 'SIL1', 'BCKDK', 'PDHA1', 'SUMO1', 'RPA1', 'PDK3', 'ARL14EP', 'FLYWCH1', 'BLM', 'PIAS1', 'MRE11', 'VDAC1', 'AFG3L2', 'HDAC6', 'ISCU', 'PDK1', 'SDHB', 'NFS1', 'CBX5', 'NDUFAB1', 'BRCA1', 'MICU1', 'DLD', 'PDK2', 'MBD1', 'NDUFV3', 'TRIM28', 'BARD1', 'MICU2', 'PMPCB', 'OGDH', 'PHB1', 'UFM1', 'BCKDHA']
476	GO:CC	GO:0005746	mitochondrial respirasome	0.0011646582748853	True	"""The protein complexes that form the mitochondrial electron transport system (the respiratory chain), associated with the inner mitochondrial membrane. The respiratory chain complexes transfer electrons from an electron donor to an electron acceptor and are associated with a proton pump to create a transmembrane electrochemical gradient."" [GOC:curators, GOC:ecd, ISBN:0198547684]"	96	97	6	22122	0.0618556701030927	0.0625	query_1	['GO:0005743', 'GO:0070469']	['SDHD', 'SDHB', 'NDUFAB1', 'SDHA', 'SDHC', 'NDUFV3']
477	GO:BP	GO:0007095	mitotic G2 DNA damage checkpoint signaling	0.0012146311466813	True	"""A mitotic cell cycle checkpoint that detects and negatively regulates progression through the G2/M transition of the cell cycle in response to DNA damage."" [GOC:mtg_cell_cycle, PMID:16299494]"	35	96	5	21110	0.0520833333333333	0.1428571428571428	query_1	['GO:0044773', 'GO:0044818']	['CDK5RAP3', 'NBN', 'BLM', 'MRE11', 'BRCA1']
478	HPA	HPA:0160053	endometrium 1; glandular cells[High]	0.0012437756033187	True	endometrium 1; glandular cells[High]	1469	83	27	11006	0.3253012048192771	0.0183798502382573	query_1	['HPA:0160052']	['PDK4', 'GCSH', 'HSPA9', 'TP53BP1', 'RAD50', 'XRCC6', 'PDHX', 'SETDB2', 'MDC1', 'PHB2', 'BCKDK', 'RPA1', 'FLYWCH1', 'BLM', 'PIAS1', 'MRE11', 'AFG3L2', 'ISCU', 'SDHB', 'NDUFAB1', 'DLD', 'PDK2', 'NDUFV3', 'TRIM28', 'OGDH', 'PHB1', 'BCKDHA']
479	GO:MF	GO:0042802	identical protein binding	0.0012545944328269	True	"""Binding to an identical protein or proteins."" [GOC:jl]"	2136	97	27	20195	0.2783505154639175	0.0126404494382022	query_1	['GO:0005515']	['RBBP8', 'SNX6', 'SNX1', 'LYRM4', 'ADSL', 'OTC', 'RAD50', 'DLAT', 'PHB2', 'BRCA2', 'MCU', 'SIL1', 'BLM', 'MRE11', 'VDAC1', 'RAD51', 'ISCU', 'GPD1', 'NFS1', 'CBX5', 'BRCA1', 'MICU1', 'PDK2', 'BARD1', 'MFN1', 'UBA5', 'STAT5B']
480	GO:BP	GO:0120263	positive regulation of heterochromatin organization	0.0012559730613575	True	"""Any process that activates or increases the frequency, rate or extent of heterochromatin organization."" [GOC:krc]"	15	96	4	21110	0.0416666666666666	0.2666666666666666	query_1	['GO:0070828', 'GO:0120261', 'GO:1905269']	['ATF7IP', 'SETDB2', 'SETDB1', 'TRIM28']
481	GO:BP	GO:0031453	positive regulation of heterochromatin formation	0.0012559730613575	True	"""Any process that activates or increases the frequency, rate or extent of heterochromatin formation."" [GOC:mah]"	15	96	4	21110	0.0416666666666666	0.2666666666666666	query_1	['GO:0031445', 'GO:0031507', 'GO:0044089', 'GO:0120263']	['ATF7IP', 'SETDB2', 'SETDB1', 'TRIM28']
482	HPA	HPA:0430053	seminal vesicle; glandular cells[High]	0.0012600228882383	True	seminal vesicle; glandular cells[High]	1470	83	27	11006	0.3253012048192771	0.0183673469387755	query_1	['HPA:0430052']	['PDK4', 'GCSH', 'SNX1', 'CDK5RAP3', 'DLST', 'HSPA9', 'TP53BP1', 'XRCC6', 'PAXIP1', 'SETDB2', 'PDHB', 'PMPCA', 'PHB2', 'MCU', 'FLYWCH1', 'PIAS1', 'MRE11', 'AFG3L2', 'ISCU', 'GPD1', 'DLD', 'NDUFV3', 'TRIM28', 'OGDH', 'PHB1', 'UFM1', 'BCKDHA']
483	GO:BP	GO:0071383	cellular response to steroid hormone stimulus	0.0013225571648254	True	"""Any process that results in a change in state or activity of a cell (in terms of movement, secretion, enzyme production, gene expression, etc.) as a result of a steroid hormone stimulus."" [GOC:mah]"	213	96	9	21110	0.09375	0.0422535211267605	query_1	['GO:0032870', 'GO:0048545', 'GO:0071396', 'GO:0071407']	['DDRGK1', 'UFL1', 'PHB2', 'METTL21C', 'HDAC6', 'BRCA1', 'UBA5', 'PHB1', 'UFM1']
484	HP	HP:0010797	Hemangioblastoma	0.0014297610094113	True	A hemangioblastoma is a benign vascular neoplasm that arises almost exclusively in the central nervous system. Hemangioblastomas consist of a tightly packed cluster of small blood vessels forming a mass of up to 1 or 2 cm in diameter.	18	54	5	4851	0.0925925925925925	0.2777777777777778	query_1	['HP:0100835']	['DLST', 'SDHD', 'SDHB', 'SDHA', 'SDHC']
485	HP	HP:0003345	Elevated urinary norepinephrine	0.0014297610094113	True	An increased concentration of noradrenaline in the urine.	18	54	5	4851	0.0925925925925925	0.2777777777777778	query_1	['HP:0011976']	['DLST', 'SDHD', 'SDHB', 'SDHA', 'SDHC']
486	HP	HP:0006748	Adrenal pheochromocytoma	0.0014297610094113	True	Pheochromocytoma originating from the adrenal medulla.	18	54	5	4851	0.0925925925925925	0.2777777777777778	query_1	['HP:0002666', 'HP:0100642']	['DLST', 'SDHD', 'SDHB', 'SDHA', 'SDHC']
487	HP	HP:0011979	Elevated urinary dopamine	0.0014297610094113	True	An increased concentration of dopamine in the urine.	18	54	5	4851	0.0925925925925925	0.2777777777777778	query_1	['HP:0011976']	['DLST', 'SDHD', 'SDHB', 'SDHA', 'SDHC']
488	HP	HP:0100642	Neoplasm of the adrenal medulla	0.0014297610094113	True	The presence of a neoplasm of the adrenal medulla.	18	54	5	4851	0.0925925925925925	0.2777777777777778	query_1	['HP:0100631']	['DLST', 'SDHD', 'SDHB', 'SDHA', 'SDHC']
489	HPA	HPA:0570733	testis; Leydig cells[High]	0.0015007202562413	True	testis; Leydig cells[High]	1766	83	30	11006	0.3614457831325301	0.0169875424688561	query_1	['HPA:0570732']	['PDK4', 'LYRM4', 'DLST', 'HSPA9', 'TP53BP1', 'RAD50', 'XRCC6', 'SETDB2', 'PMPCA', 'PHB2', 'MCU', 'BCKDK', 'HSPD1', 'FLYWCH1', 'BLM', 'MRE11', 'ISCU', 'SDHB', 'FAF2', 'NFS1', 'SDHA', 'MICU1', 'DLD', 'TRIM28', 'PEPD', 'PMPCB', 'OGDH', 'PHB1', 'STAT5B', 'BCKDHA']
490	WP	WP:WP707	DNA damage response	0.0015307668488312	True	DNA damage response	69	60	6	8133	0.1	0.0869565217391304	query_1	['WP:000000']	['NBN', 'RAD50', 'H2AX', 'MRE11', 'RAD51', 'BRCA1']
491	GO:BP	GO:0042776	proton motive force-driven mitochondrial ATP synthesis	0.0015678249781274	True	"""The transport of protons across a mitochondrial membrane to generate an electrochemical gradient (proton-motive force) that powers ATP synthesis."" [GOC:mtg_sensu, ISBN:0716731363]"	68	96	6	21110	0.0625	0.088235294117647	query_1	['GO:0006119', 'GO:0015986']	['SDHD', 'SDHB', 'NDUFAB1', 'SDHA', 'SDHC', 'NDUFV3']
492	GO:BP	GO:0006260	DNA replication	0.0016081086070985	True	"""The cellular metabolic process in which a cell duplicates one or more molecules of DNA. DNA replication begins when specific sequences, known as origins of replication, are recognized and bound by the origin recognition complex, and ends when the original DNA molecule has been completely duplicated and the copies topologically separated. The unit of replication usually corresponds to the genome of the cell, an organelle, or a virus. The template for replication can either be an existing DNA molecule or RNA."" [GOC:mah]"	284	96	10	21110	0.1041666666666666	0.0352112676056338	query_1	['GO:0006259']	['RBBP8', 'NBN', 'RAD50', 'BRCA2', 'RPA1', 'BLM', 'MRE11', 'RAD51', 'BRCA1', 'BARD1']
493	HPA	HPA:0130051	colon; glandular cells[≥Low]	0.0016384003364391	True	colon; glandular cells[≥Low]	6988	83	71	11006	0.8554216867469879	0.0101602747567258	query_1	['HPA:0130000']	['RBBP8', 'SNX6', 'UBE2I', 'PDK4', 'GCSH', 'PPM1K', 'SNX1', 'LYRM4', 'ADSL', 'MAIP1', 'NBN', 'ATF7IP', 'DLST', 'HSPA9', 'MCUB', 'UBAC2', 'XRCC6', 'PAXIP1', 'DLAT', 'PDHX', 'SETDB2', 'PDHB', 'H2AX', 'DDRGK1', 'UFL1', 'MDC1', 'PMPCA', 'MCAT', 'SDHD', 'DBT', 'MCU', 'BCKDK', 'BCKDHB', 'PDHA1', 'SUMO1', 'RPA1', 'ARL14EP', 'FLYWCH1', 'BLM', 'PIAS1', 'MRE11', 'VDAC1', 'RAD51', 'AFG3L2', 'HDAC6', 'ISCU', 'PDK1', 'NSUN6', 'SDHB', 'FAF2', 'NFS1', 'CBX5', 'NDUFAB1', 'BRCA1', 'SDHA', 'MICU1', 'DLD', 'PDK2', 'MBD1', 'NDUFV3', 'BARD1', 'MICU2', 'MFN1', 'PEPD', 'PMPCB', 'UBA5', 'OGDH', 'PHB1', 'UFM1', 'STAT5B', 'BCKDHA']
494	GO:BP	GO:0000723	telomere maintenance	0.0016393072165735	True	"""Any process that contributes to the maintenance of proper telomeric length and structure by affecting and monitoring the activity of telomeric proteins, the length of telomeric DNA and the replication and repair of the DNA. These processes includes those that shorten, lengthen, replicate and repair the telomeric DNA sequences."" [GOC:BHF, GOC:BHF_telomere, GOC:elh, GOC:rl, PMID:11092831]"	160	96	8	21110	0.0833333333333333	0.05	query_1	['GO:0006259', 'GO:0032200']	['NBN', 'RAD50', 'XRCC6', 'BRCA2', 'RPA1', 'BLM', 'MRE11', 'RAD51']
495	GO:BP	GO:1905269	positive regulation of chromatin organization	0.0016687979186712	True	"""Any process that activates or increases the frequency, rate or extent of chromatin organization."" [GO_REF:0000058, GOC:pr, GOC:TermGenie, GOC:vw, PMID:654321]"	16	96	4	21110	0.0416666666666666	0.25	query_1	['GO:0006325', 'GO:1902275', 'GO:2001252']	['ATF7IP', 'SETDB2', 'SETDB1', 'TRIM28']
496	HPA	HPA:0290401	liver; hepatocytes[≥Low]	0.0016751930098888	True	liver; hepatocytes[≥Low]	5743	83	63	11006	0.7590361445783133	0.0109698763712345	query_1	['HPA:0290000']	['PDK4', 'GCSH', 'SNX1', 'ADSL', 'MAIP1', 'CDK5RAP3', 'OTC', 'DLST', 'HSPA9', 'TP53BP1', 'UBAC2', 'XRCC6', 'DLAT', 'PDHX', 'SETDB2', 'H2AX', 'DDRGK1', 'UFL1', 'MDC1', 'PMPCA', 'PHB2', 'MCAT', 'SDHD', 'DBT', 'MCU', 'SIL1', 'BCKDK', 'BCKDHB', 'PDHA1', 'HSPD1', 'RPA1', 'PDK3', 'FLYWCH1', 'PIAS1', 'MRE11', 'VDAC1', 'HDAC6', 'ISCU', 'GPD1', 'PDK1', 'NSUN6', 'SDHB', 'FAF2', 'NFS1', 'NDUFAB1', 'BRCA1', 'SDHA', 'MICU1', 'DLD', 'PDK2', 'NDUFV3', 'TRIM28', 'BARD1', 'MICU2', 'MFN1', 'PEPD', 'PMPCB', 'UBA5', 'OGDH', 'PHB1', 'UFM1', 'STAT5B', 'BCKDHA']
497	HPA	HPA:0130241	colon; peripheral nerve/ganglion[≥Low]	0.0016927001566265	True	colon; peripheral nerve/ganglion[≥Low]	5037	83	58	11006	0.6987951807228916	0.0115147905499305	query_1	['HPA:0130000']	['RBBP8', 'SNX6', 'GCSH', 'PPM1K', 'LYRM4', 'ADSL', 'CDK5RAP3', 'NBN', 'ATF7IP', 'DLST', 'HSPA9', 'MCUB', 'XRCC6', 'DLAT', 'PDHX', 'SETDB2', 'PDHB', 'H2AX', 'DDRGK1', 'UFL1', 'MDC1', 'PMPCA', 'MCAT', 'SDHD', 'DBT', 'MCU', 'SIL1', 'BCKDK', 'BCKDHB', 'PDHA1', 'SUMO1', 'HSPD1', 'RPA1', 'BLM', 'PIAS1', 'MRE11', 'HDAC6', 'ISCU', 'GPD1', 'PDK1', 'NSUN6', 'SDHB', 'NFS1', 'CBX5', 'BRCA1', 'SDHA', 'MICU1', 'STAT5A', 'NDUFV3', 'TRIM28', 'MICU2', 'MFN1', 'PEPD', 'UBA5', 'OGDH', 'UFM1', 'STAT5B', 'BCKDHA']
498	GO:MF	GO:0003697	single-stranded DNA binding	0.0016999833620932	True	"""Binding to single-stranded DNA."" [GOC:elh, GOC:vw, PMID:22976174]"	125	97	7	20195	0.0721649484536082	0.056	query_1	['GO:0003677']	['RBBP8', 'RAD50', 'BRCA2', 'HSPD1', 'RPA1', 'BLM', 'RAD51']
499	HP	HP:0033155	Elevated circulating L-alloisoleucine concentration	0.0017164619613501	True	Abnormally increased concentration of L-alloisoleucine in the blood circulation.	3	54	3	4851	0.0555555555555555	1.0	query_1	['HP:0033108']	['DBT', 'BCKDHB', 'BCKDHA']
500	WP	WP:WP4206	Hereditary leiomyomatosis and renal cell carcinoma pathway	0.0017408818749999	True	Hereditary leiomyomatosis and renal cell carcinoma pathway	20	60	4	8133	0.0666666666666666	0.2	query_1	['WP:000000']	['PDHA2', 'PDHB', 'PDHA1', 'PDK1']
501	GO:CC	GO:0070469	respirasome	0.0017525885285223	True	"""The protein complexes that form the electron transport system (the respiratory chain), associated with a cell membrane, usually the plasma membrane (in prokaryotes) or the inner mitochondrial membrane (on eukaryotes). The respiratory chain complexes transfer electrons from an electron donor to an electron acceptor and are associated with a proton pump to create a transmembrane electrochemical gradient."" [GOC:ecd, GOC:mah, ISBN:0198547684, Wikipedia:Respirasome]"	103	97	6	22122	0.0618556701030927	0.058252427184466	query_1	['GO:0016020', 'GO:0110165']	['SDHD', 'SDHB', 'NDUFAB1', 'SDHA', 'SDHC', 'NDUFV3']
502	HPA	HPA:0600433	tonsil; germinal center cells[High]	0.0018071503901408	True	tonsil; germinal center cells[High]	1229	83	24	11006	0.2891566265060241	0.0195280716029292	query_1	['HPA:0600432']	['GCSH', 'ADSL', 'HSPA9', 'XRCC6', 'PAXIP1', 'SETDB2', 'PMPCA', 'PHB2', 'SUMO1', 'RPA1', 'FLYWCH1', 'PIAS1', 'MRE11', 'VDAC1', 'AFG3L2', 'SDHB', 'MICU1', 'DLD', 'NDUFV3', 'PMPCB', 'OGDH', 'PHB1', 'UFM1', 'BCKDHA']
503	WP	WP:WP4290	Metabolic reprogramming in colon cancer	0.0018662932227166	True	Metabolic reprogramming in colon cancer	42	60	5	8133	0.0833333333333333	0.119047619047619	query_1	['WP:000000']	['DLST', 'TALDO1', 'PDHB', 'PDHA1', 'SDHB']
504	GO:BP	GO:2001252	positive regulation of chromosome organization	0.0018838980582265	True	"""Any process that activates or increases the frequency, rate or extent of chromosome organization."" [GOC:obol]"	112	96	7	21110	0.0729166666666666	0.0625	query_1	['GO:0010638', 'GO:0033044', 'GO:0051276']	['NBN', 'ATF7IP', 'RAD50', 'SETDB2', 'SETDB1', 'MRE11', 'TRIM28']
505	WP	WP:WP2942	DDX1 as a regulatory component of the Drosha microprocessor	0.0019185256951643	True	DDX1 as a regulatory component of the Drosha microprocessor	7	60	3	8133	0.05	0.4285714285714285	query_1	['WP:000000']	['NBN', 'RAD50', 'MRE11']
506	HP	HP:0010532	Paroxysmal vertigo	0.0019240546470282	True	Paroxysmal episodes of vertigo.	19	54	5	4851	0.0925925925925925	0.2631578947368421	query_1	['HP:0002321']	['DLST', 'SDHD', 'SDHB', 'SDHA', 'SDHC']
507	HP	HP:0001095	Hypertensive retinopathy	0.0019240546470282	True	Hypertensive retinopathy	19	54	5	4851	0.0925925925925925	0.2631578947368421	query_1	['HP:0008046']	['DLST', 'SDHD', 'SDHB', 'SDHA', 'SDHC']
508	GO:BP	GO:0009056	catabolic process	0.0019250546816022	True	"""The chemical reactions and pathways resulting in the breakdown of substances, including the breakdown of carbon compounds with the liberation of energy for use by the cell or organism."" [ISBN:0198547684]"	2601	96	30	21110	0.3125	0.0115340253748558	query_1	['GO:0008152']	['SNX6', 'UBE2I', 'GCSH', 'SNX1', 'CDK5RAP3', 'OTC', 'DLST', 'UBAC2', 'DDRGK1', 'UFL1', 'PHB2', 'MCAT', 'DBT', 'BCKDK', 'BCKDHB', 'SUMO1', 'PIAS1', 'VDAC1', 'HDAC6', 'GPD1', 'FAF2', 'DLD', 'BARD1', 'ABHD6', 'PEPD', 'UBA5', 'OGDH', 'PHB1', 'UFM1', 'BCKDHA']
509	HPA	HPA:0100121	cerebral cortex; glial cells[≥Low]	0.0019421032995376	True	cerebral cortex; glial cells[≥Low]	4919	83	57	11006	0.6867469879518072	0.0115877210815206	query_1	['HPA:0100000']	['RBBP8', 'PDK4', 'GCSH', 'PPM1K', 'LYRM4', 'ADSL', 'MAIP1', 'CDK5RAP3', 'ATF7IP', 'DLST', 'HSPA9', 'TP53BP1', 'RAD50', 'XRCC6', 'PAXIP1', 'DLAT', 'PDHX', 'SETDB2', 'PDHB', 'H2AX', 'MDC1', 'PMPCA', 'PHB2', 'MCAT', 'SDHD', 'MCU', 'SIL1', 'PDHA1', 'SUMO1', 'HSPD1', 'RPA1', 'ARL14EP', 'FLYWCH1', 'BLM', 'PIAS1', 'MRE11', 'VDAC1', 'AFG3L2', 'ISCU', 'GPD1', 'PDK1', 'SDHB', 'NFS1', 'CBX5', 'BRCA1', 'SDHA', 'MICU1', 'DLD', 'MBD1', 'NDUFV3', 'TRIM28', 'BARD1', 'UBA5', 'OGDH', 'PHB1', 'UFM1', 'BCKDHA']
510	GO:MF	GO:0016491	oxidoreductase activity	0.0020283246699983	True	"""Catalysis of an oxidation-reduction (redox) reaction, a reversible chemical reaction in which the oxidation state of an atom or atoms within a molecule is altered. One substrate acts as a hydrogen or electron donor and becomes oxidized, while the other acts as hydrogen or electron acceptor and becomes reduced."" [GOC:go_curators]"	751	97	15	20195	0.1546391752577319	0.0199733688415446	query_1	['GO:0003824']	['DLAT', 'PDHA2', 'PDHX', 'PDHB', 'SDHD', 'BCKDHB', 'PDHA1', 'GPD1', 'SDHB', 'SDHA', 'SDHC', 'DLD', 'NDUFV3', 'OGDH', 'BCKDHA']
511	GO:BP	GO:0044572	[4Fe-4S] cluster assembly	0.0021557361387308	True	"""The incorporation of four iron atoms and four sulfur atoms into an iron-sulfur cluster."" [GOC:jl, GOC:mengo_curators, GOC:pde, GOC:tt, GOC:vw, PMID:15952888]"	5	96	3	21110	0.03125	0.6	query_1	['GO:0016226']	['LYRM4', 'ISCU', 'NFS1']
512	HPA	HPA:0170252	endometrium 2; cells in endometrial stroma[≥Medium]	0.0021697666713653	True	endometrium 2; cells in endometrial stroma[≥Medium]	1798	83	30	11006	0.3614457831325301	0.0166852057842046	query_1	['HPA:0170251']	['UBE2I', 'GCSH', 'SNX1', 'HSPA9', 'TP53BP1', 'RAD50', 'XRCC6', 'PAXIP1', 'SETDB2', 'H2AX', 'MDC1', 'PMPCA', 'PHB2', 'SUMO1', 'RPA1', 'ARL14EP', 'BLM', 'PIAS1', 'MRE11', 'ISCU', 'PDK1', 'SDHB', 'NFS1', 'MICU1', 'NDUFV3', 'TRIM28', 'PMPCB', 'OGDH', 'PHB1', 'BCKDHA']
513	GO:BP	GO:0061709	reticulophagy	0.0021746740425884	True	"""The selective autohagy process in which parts of the endoplasmic reticulum are loaded into autophagosomes, delivered to the vacuole, and degraded in response to changing cellular conditions."" [GOC:autophagy, GOC:dph, PMID:22481944, PMID:24060720, PMID:26040717]"	17	96	4	21110	0.0416666666666666	0.2352941176470588	query_1	['GO:0061912', 'GO:1903008']	['DDRGK1', 'UFL1', 'UBA5', 'UFM1']
514	KEGG	KEGG:00620	Pyruvate metabolism	0.0022897048978913	True	Pyruvate metabolism	47	63	5	8161	0.0793650793650793	0.1063829787234042	query_1	['KEGG:00000']	['DLAT', 'PDHA2', 'PDHB', 'PDHA1', 'DLD']
515	HPA	HPA:0320101	nasopharynx; respiratory epithelial cells[≥Low]	0.0023135913825614	True	nasopharynx; respiratory epithelial cells[≥Low]	5787	83	63	11006	0.7590361445783133	0.0108864696734059	query_1	['HPA:0320000']	['RBBP8', 'PDK4', 'GCSH', 'PPM1K', 'LYRM4', 'ADSL', 'CDK5RAP3', 'NBN', 'DLST', 'HSPA9', 'MCUB', 'TP53BP1', 'UBAC2', 'XRCC6', 'PAXIP1', 'DLAT', 'PDHX', 'SETDB2', 'H2AX', 'DDRGK1', 'UFL1', 'MDC1', 'PHB2', 'MCAT', 'SDHD', 'SIL1', 'BCKDK', 'BCKDHB', 'PDHA1', 'SUMO1', 'RPA1', 'ARL14EP', 'FLYWCH1', 'BLM', 'MRE11', 'VDAC1', 'RAD51', 'AFG3L2', 'HDAC6', 'ISCU', 'GPD1', 'PDK1', 'SDHB', 'FAF2', 'NFS1', 'CBX5', 'NDUFAB1', 'SDHA', 'MICU1', 'DLD', 'PDK2', 'MBD1', 'NDUFV3', 'TRIM28', 'BARD1', 'MICU2', 'MFN1', 'PEPD', 'UBA5', 'OGDH', 'UFM1', 'STAT5B', 'BCKDHA']
516	GO:BP	GO:0031324	negative regulation of cellular metabolic process	0.0023901994397574	True	"""Any process that stops, prevents, or reduces the frequency, rate or extent of the chemical reactions and pathways by which individual cells transform chemical substances."" [GOC:mah]"	2194	96	27	21110	0.28125	0.0123062898814949	query_1	['GO:0009892', 'GO:0031323', 'GO:0044237', 'GO:0048523']	['PPIF', 'RBBP8', 'SNX6', 'UBE2I', 'CDK5RAP3', 'NBN', 'ATF7IP', 'TP53BP1', 'RAD50', 'ZNF350', 'XRCC6', 'SETDB2', 'PHB2', 'SETDB1', 'BCKDK', 'SUMO1', 'FLYWCH1', 'BLM', 'PIAS1', 'VDAC1', 'HDAC6', 'CBX5', 'BRCA1', 'MBD1', 'TRIM28', 'BARD1', 'PHB1']
517	GO:CC	GO:0000228	nuclear chromosome	0.0024631664213756	True	"""A chromosome that encodes the nuclear genome and is found in the nucleus of a eukaryotic cell during the cell cycle phases when the nucleus is intact."" [GOC:dph, GOC:mah]"	233	97	8	22122	0.0824742268041237	0.0343347639484978	query_1	['GO:0005694', 'GO:0031981']	['UBE2I', 'RAD50', 'H2AX', 'BRCA2', 'RPA1', 'BLM', 'RAD51', 'BRCA1']
518	HPA	HPA:0570000	testis	0.0025136106242761	True	testis	9008	83	81	11006	0.9759036144578314	0.0089920071047957	query_1	['HPA:0000000']	['RBBP8', 'SNX6', 'UBE2I', 'PDK4', 'GCSH', 'PPM1K', 'SNX1', 'LYRM4', 'ADSL', 'MAIP1', 'CDK5RAP3', 'NBN', 'ATF7IP', 'DLST', 'HSPA9', 'TP53BP1', 'RAD50', 'UBAC2', 'XRCC6', 'PAXIP1', 'DLAT', 'PDHA2', 'PDHX', 'SETDB2', 'PDHB', 'H2AX', 'DDRGK1', 'UFL1', 'MDC1', 'PMPCA', 'PHB2', 'MCAT', 'SDHD', 'DBT', 'MCU', 'SIL1', 'BCKDK', 'BCKDHB', 'PDHA1', 'SUMO1', 'HSPD1', 'RPA1', 'PDK3', 'ARL14EP', 'FLYWCH1', 'BLM', 'PIAS1', 'MRE11', 'VDAC1', 'RAD51', 'AFG3L2', 'HDAC6', 'ISCU', 'GPD1', 'PDK1', 'NSUN6', 'SDHB', 'FAF2', 'NFS1', 'CBX5', 'NDUFAB1', 'BRCA1', 'SDHA', 'MICU1', 'STAT5A', 'DLD', 'PDK2', 'MBD1', 'NDUFV3', 'TRIM28', 'BARD1', 'MICU2', 'MFN1', 'PEPD', 'PMPCB', 'UBA5', 'OGDH', 'PHB1', 'UFM1', 'STAT5B', 'BCKDHA']
519	GO:BP	GO:0048523	negative regulation of cellular process	0.00252194458966	True	"""Any process that stops, prevents, or reduces the frequency, rate or extent of a cellular process, any of those that are carried out at the cellular level, but are not necessarily restricted to a single cell. For example, cell communication occurs among more than one cell, but occurs at the cellular level."" [GOC:jid]"	4753	96	43	21110	0.4479166666666667	0.0090469177361666	query_1	['GO:0009987', 'GO:0048519', 'GO:0050794']	['PPIF', 'RBBP8', 'SNX6', 'UBE2I', 'PDK4', 'CDK5RAP3', 'NBN', 'ATF7IP', 'HSPA9', 'TP53BP1', 'RAD50', 'UBAC2', 'ZNF350', 'XRCC6', 'SETDB2', 'H2AX', 'DDRGK1', 'UFL1', 'MDC1', 'PHB2', 'METTL21C', 'BRCA2', 'SETDB1', 'BCKDK', 'SUMO1', 'HSPD1', 'FLYWCH1', 'BLM', 'PIAS1', 'MRE11', 'VDAC1', 'RAD51', 'HDAC6', 'ISCU', 'CBX5', 'BRCA1', 'MBD1', 'TRIM28', 'BARD1', 'ABHD6', 'PHB1', 'UFM1', 'STAT5B']
520	HP	HP:0002668	Paraganglioma	0.0025438107577581	True	A carotid body tumor (also called paraganglionoma or chemodectoma) is a tumor found in the upper neck at the branching of the carotid artery. They arise from the chemoreceptor organ (paraganglion) located in the adventitia of the carotid artery bifurcation.	20	54	5	4851	0.0925925925925925	0.25	query_1	['HP:0100634']	['DLST', 'SDHD', 'SDHB', 'SDHA', 'SDHC']
521	GO:BP	GO:0045930	negative regulation of mitotic cell cycle	0.0026019483892192	True	"""Any process that stops, prevents or reduces the rate or extent of progression through the mitotic cell cycle."" [GOC:dph, GOC:go_curators, GOC:tb]"	231	96	9	21110	0.09375	0.0389610389610389	query_1	['GO:0000278', 'GO:0007346', 'GO:0045786']	['RBBP8', 'CDK5RAP3', 'NBN', 'RAD50', 'MDC1', 'BLM', 'MRE11', 'BRCA1', 'BARD1']
522	KEGG	KEGG:05012	Parkinson disease	0.0026076608332527	True	Parkinson disease	266	63	10	8161	0.1587301587301587	0.037593984962406	query_1	['KEGG:00000']	['PPIF', 'SDHD', 'MCU', 'VDAC1', 'SDHB', 'NDUFAB1', 'SDHA', 'SDHC', 'NDUFV3', 'MFN1']
523	CORUM	CORUM:7267	KAT2A-Oxoglutarate dehydrogenase complex	0.0026354491139835	True	KAT2A-Oxoglutarate dehydrogenase complex	4	47	3	3383	0.0638297872340425	0.75	query_1	['CORUM:0000000']	['DLST', 'DLD', 'OGDH']
524	CORUM	CORUM:2787	BRCA1 C complex	0.0026354491139835	True	BRCA1 C complex	4	47	3	3383	0.0638297872340425	0.75	query_1	['CORUM:0000000']	['RBBP8', 'BRCA1', 'BARD1']
525	CORUM	CORUM:619	MRE11A-RAD50-NBN-TRF2 complex	0.0026354491139835	True	MRE11A-RAD50-NBN-TRF2 complex	4	47	3	3383	0.0638297872340425	0.75	query_1	['CORUM:0000000']	['NBN', 'RAD50', 'MRE11']
526	CORUM	CORUM:627	MRN-TRRAP complex (MRE11A-RAD50-NBN-TRRAP complex)	0.0026354491139835	True	MRN-TRRAP complex (MRE11A-RAD50-NBN-TRRAP complex)	4	47	3	3383	0.0638297872340425	0.75	query_1	['CORUM:0000000']	['NBN', 'RAD50', 'MRE11']
527	HPA	HPA:0400051	rectum; glandular cells[≥Low]	0.0027098190541342	True	rectum; glandular cells[≥Low]	7057	83	71	11006	0.8554216867469879	0.0100609324075386	query_1	['HPA:0400000']	['RBBP8', 'SNX6', 'UBE2I', 'PDK4', 'GCSH', 'PPM1K', 'SNX1', 'LYRM4', 'ADSL', 'MAIP1', 'NBN', 'ATF7IP', 'DLST', 'HSPA9', 'MCUB', 'UBAC2', 'XRCC6', 'PAXIP1', 'DLAT', 'PDHX', 'SETDB2', 'PDHB', 'H2AX', 'DDRGK1', 'UFL1', 'MDC1', 'PMPCA', 'MCAT', 'SDHD', 'DBT', 'MCU', 'BCKDK', 'BCKDHB', 'PDHA1', 'SUMO1', 'RPA1', 'PDK3', 'ARL14EP', 'FLYWCH1', 'BLM', 'PIAS1', 'MRE11', 'VDAC1', 'RAD51', 'AFG3L2', 'HDAC6', 'ISCU', 'PDK1', 'NSUN6', 'SDHB', 'FAF2', 'NFS1', 'CBX5', 'NDUFAB1', 'BRCA1', 'SDHA', 'MICU1', 'DLD', 'PDK2', 'MBD1', 'NDUFV3', 'MICU2', 'MFN1', 'PEPD', 'PMPCB', 'UBA5', 'OGDH', 'PHB1', 'UFM1', 'STAT5B', 'BCKDHA']
528	GO:BP	GO:0006725	cellular aromatic compound metabolic process	0.002775141831264	True	"""The chemical reactions and pathways involving aromatic compounds, any organic compound characterized by one or more planar rings, each of which contains conjugated double bonds and delocalized pi electrons, as carried out by individual cells."" [GOC:ai, ISBN:0198506732]"	8273	96	61	21110	0.6354166666666666	0.0073733832950562	query_1	['GO:0044237']	['RBBP8', 'SNX6', 'UBE2I', 'PDK4', 'ADSL', 'CDK5RAP3', 'NBN', 'ATF7IP', 'DLST', 'TP53BP1', 'RAD50', 'ZNF45', 'ZNF350', 'XRCC6', 'TALDO1', 'PAXIP1', 'DLAT', 'PDHA2', 'PDHX', 'SETDB2', 'PDHB', 'H2AX', 'DDRGK1', 'UFL1', 'MDC1', 'PHB2', 'SDHD', 'BRCA2', 'SETDB1', 'PDHA1', 'SUMO1', 'HSPD1', 'RPA1', 'PDK3', 'FLYWCH1', 'BLM', 'PIAS1', 'MRE11', 'RAD51', 'HDAC6', 'MOCS3', 'GPD1', 'PDK1', 'NSUN6', 'SDHB', 'CBX5', 'NDUFAB1', 'BRCA1', 'SDHA', 'STAT5A', 'SDHC', 'DLD', 'PDK2', 'MBD1', 'NDUFV3', 'TRIM28', 'BARD1', 'MFN1', 'OGDH', 'PHB1', 'STAT5B']
529	HPA	HPA:0340453	ovary; follicle cells[High]	0.0028405408504655	True	ovary; follicle cells[High]	617	83	16	11006	0.1927710843373494	0.0259319286871961	query_1	['HPA:0340452']	['PDK4', 'GCSH', 'PPM1K', 'LYRM4', 'ADSL', 'HSPA9', 'SETDB2', 'PMPCA', 'MCU', 'MRE11', 'ISCU', 'NFS1', 'DLD', 'TRIM28', 'OGDH', 'PHB1']
530	HPA	HPA:0270362	kidney; cells in tubules[≥Medium]	0.0028751683533364	True	kidney; cells in tubules[≥Medium]	5817	83	63	11006	0.7590361445783133	0.0108303249097472	query_1	['HPA:0270361']	['RBBP8', 'SNX6', 'UBE2I', 'PDK4', 'GCSH', 'PPM1K', 'SNX1', 'LYRM4', 'ADSL', 'MAIP1', 'CDK5RAP3', 'NBN', 'ATF7IP', 'HSPA9', 'MCUB', 'TP53BP1', 'RAD50', 'XRCC6', 'PDHX', 'SETDB2', 'DDRGK1', 'UFL1', 'MDC1', 'PMPCA', 'PHB2', 'MCAT', 'SDHD', 'MCU', 'SIL1', 'BCKDK', 'BCKDHB', 'PDHA1', 'SUMO1', 'RPA1', 'ARL14EP', 'FLYWCH1', 'BLM', 'PIAS1', 'MRE11', 'AFG3L2', 'HDAC6', 'ISCU', 'PDK1', 'NSUN6', 'FAF2', 'NFS1', 'CBX5', 'NDUFAB1', 'BRCA1', 'MICU1', 'DLD', 'MBD1', 'TRIM28', 'BARD1', 'MICU2', 'MFN1', 'PEPD', 'PMPCB', 'UBA5', 'OGDH', 'UFM1', 'STAT5B', 'BCKDHA']
531	HPA	HPA:0530723	spleen; cells in white pulp[High]	0.0029843027938169	True	spleen; cells in white pulp[High]	846	83	19	11006	0.2289156626506024	0.0224586288416075	query_1	['HPA:0530722']	['PDK4', 'ADSL', 'HSPA9', 'XRCC6', 'PAXIP1', 'SETDB2', 'MDC1', 'PHB2', 'MCU', 'RPA1', 'FLYWCH1', 'PIAS1', 'MRE11', 'AFG3L2', 'SDHB', 'MICU1', 'OGDH', 'PHB1', 'BCKDHA']
532	GO:BP	GO:0051054	positive regulation of DNA metabolic process	0.003069210194892	True	"""Any process that activates or increases the frequency, rate or extent of the chemical reactions and pathways involving DNA."" [GOC:ai]"	305	96	10	21110	0.1041666666666666	0.0327868852459016	query_1	['GO:0006259', 'GO:0010604', 'GO:0045935', 'GO:0051052']	['RBBP8', 'NBN', 'TP53BP1', 'RAD50', 'PAXIP1', 'H2AX', 'MRE11', 'RAD51', 'BRCA1', 'TRIM28']
533	GO:CC	GO:0031090	organelle membrane	0.0031330234890104	True	"""A membrane that is one of the two lipid bilayers of an organelle envelope or the outermost membrane of single membrane bound organelle."" [GOC:dos, GOC:mah]"	3728	97	34	22122	0.3505154639175257	0.0091201716738197	query_1	['GO:0016020', 'GO:0043227']	['PPIF', 'SNX6', 'SPG7', 'SNX1', 'MAIP1', 'OTC', 'HSPA9', 'MCUB', 'UBAC2', 'DDRGK1', 'UFL1', 'PMPCA', 'PHB2', 'SDHD', 'MCU', 'SUMO1', 'HSPD1', 'VDAC1', 'AFG3L2', 'SDHB', 'FAF2', 'NDUFAB1', 'SDHA', 'MICU1', 'SMDT1', 'SDHC', 'NDUFV3', 'MICU2', 'MFN1', 'ABHD6', 'PMPCB', 'UBA5', 'OGDH', 'PHB1']
534	GO:BP	GO:1901360	organic cyclic compound metabolic process	0.0031509918665102	True	"""The chemical reactions and pathways involving organic cyclic compound."" [GOC:TermGenie]"	8514	96	62	21110	0.6458333333333334	0.0072821235611933	query_1	['GO:0071704']	['RBBP8', 'SNX6', 'UBE2I', 'PDK4', 'ADSL', 'CDK5RAP3', 'NBN', 'ATF7IP', 'DLST', 'TP53BP1', 'RAD50', 'ZNF45', 'ZNF350', 'XRCC6', 'TALDO1', 'PAXIP1', 'DLAT', 'PDHA2', 'PDHX', 'SETDB2', 'PDHB', 'H2AX', 'DDRGK1', 'UFL1', 'MDC1', 'PHB2', 'SDHD', 'BRCA2', 'SETDB1', 'PDHA1', 'SUMO1', 'HSPD1', 'RPA1', 'PDK3', 'FLYWCH1', 'BLM', 'PIAS1', 'MRE11', 'RAD51', 'HDAC6', 'MOCS3', 'GPD1', 'PDK1', 'NSUN6', 'SDHB', 'NFS1', 'CBX5', 'NDUFAB1', 'BRCA1', 'SDHA', 'STAT5A', 'SDHC', 'DLD', 'PDK2', 'MBD1', 'NDUFV3', 'TRIM28', 'BARD1', 'MFN1', 'OGDH', 'PHB1', 'STAT5B']
535	HPA	HPA:0570732	testis; Leydig cells[≥Medium]	0.0033945276408766	True	testis; Leydig cells[≥Medium]	5409	83	60	11006	0.7228915662650602	0.0110926234054353	query_1	['HPA:0570731']	['PDK4', 'PPM1K', 'LYRM4', 'CDK5RAP3', 'ATF7IP', 'DLST', 'HSPA9', 'TP53BP1', 'RAD50', 'UBAC2', 'XRCC6', 'DLAT', 'PDHX', 'SETDB2', 'PDHB', 'MDC1', 'PMPCA', 'PHB2', 'MCAT', 'SDHD', 'DBT', 'MCU', 'SIL1', 'BCKDK', 'BCKDHB', 'HSPD1', 'ARL14EP', 'FLYWCH1', 'BLM', 'MRE11', 'VDAC1', 'RAD51', 'AFG3L2', 'ISCU', 'GPD1', 'PDK1', 'NSUN6', 'SDHB', 'FAF2', 'NFS1', 'NDUFAB1', 'BRCA1', 'SDHA', 'MICU1', 'STAT5A', 'DLD', 'PDK2', 'MBD1', 'NDUFV3', 'TRIM28', 'MICU2', 'MFN1', 'PEPD', 'PMPCB', 'UBA5', 'OGDH', 'PHB1', 'UFM1', 'STAT5B', 'BCKDHA']
536	HP	HP:0003287	Abnormality of mitochondrial metabolism	0.0033953313013563	True	A functional anomaly of mitochondria.	176	54	11	4851	0.2037037037037037	0.0625	query_1	['HP:0012103']	['DLAT', 'PDHX', 'PDHB', 'SDHD', 'PDHA1', 'AFG3L2', 'ISCU', 'SDHB', 'NFS1', 'SDHA', 'DLD']
537	GO:BP	GO:0071704	organic substance metabolic process	0.0034033863964705	True	"""The chemical reactions and pathways involving an organic substance, any molecular entity containing carbon."" [GOC:mah]"	13946	96	84	21110	0.875	0.0060232324680912	query_1	['GO:0008152']	['PPIF', 'RBBP8', 'SNX6', 'UBE2I', 'PDK4', 'GCSH', 'SPG7', 'PPM1K', 'SNX1', 'ADSL', 'CDK5RAP3', 'NBN', 'OTC', 'ATF7IP', 'DLST', 'TP53BP1', 'RAD50', 'ZNF45', 'UBAC2', 'ZNF350', 'XRCC6', 'TALDO1', 'PAXIP1', 'DLAT', 'PDHA2', 'PDHX', 'SETDB2', 'PDHB', 'H2AX', 'DDRGK1', 'UFL1', 'MDC1', 'PMPCA', 'PHB2', 'MCAT', 'METTL21C', 'SDHD', 'DBT', 'BRCA2', 'SETDB1', 'BCKDK', 'BCKDHB', 'PDHA1', 'SUMO1', 'HSPD1', 'RPA1', 'PDK3', 'FLYWCH1', 'BLM', 'PIAS1', 'MRE11', 'VDAC1', 'RAD51', 'AFG3L2', 'HDAC6', 'MOCS3', 'GPD1', 'PDK1', 'NSUN6', 'SDHB', 'FAF2', 'NFS1', 'CBX5', 'NDUFAB1', 'BRCA1', 'SDHA', 'STAT5A', 'SDHC', 'DLD', 'PDK2', 'MBD1', 'NDUFV3', 'TRIM28', 'BARD1', 'MFN1', 'ABHD6', 'PEPD', 'PMPCB', 'UBA5', 'OGDH', 'PHB1', 'UFM1', 'STAT5B', 'BCKDHA']
538	HPA	HPA:0620221	vagina; squamous epithelial cells[≥Low]	0.0034983771904307	True	vagina; squamous epithelial cells[≥Low]	5992	83	64	11006	0.7710843373493976	0.0106809078771695	query_1	['HPA:0620000']	['RBBP8', 'UBE2I', 'PDK4', 'GCSH', 'PPM1K', 'SNX1', 'LYRM4', 'ADSL', 'ATF7IP', 'DLST', 'HSPA9', 'TP53BP1', 'RAD50', 'XRCC6', 'PAXIP1', 'DLAT', 'PDHX', 'SETDB2', 'H2AX', 'MDC1', 'PMPCA', 'PHB2', 'SDHD', 'DBT', 'MCU', 'SIL1', 'BCKDK', 'BCKDHB', 'PDHA1', 'SUMO1', 'RPA1', 'ARL14EP', 'FLYWCH1', 'BLM', 'PIAS1', 'MRE11', 'VDAC1', 'RAD51', 'AFG3L2', 'HDAC6', 'ISCU', 'GPD1', 'PDK1', 'NSUN6', 'SDHB', 'NFS1', 'NDUFAB1', 'BRCA1', 'SDHA', 'MICU1', 'DLD', 'MBD1', 'NDUFV3', 'TRIM28', 'BARD1', 'MICU2', 'MFN1', 'PEPD', 'PMPCB', 'OGDH', 'PHB1', 'UFM1', 'STAT5B', 'BCKDHA']
539	HPA	HPA:0620000	vagina	0.0034983771904307	True	vagina	5992	83	64	11006	0.7710843373493976	0.0106809078771695	query_1	['HPA:0000000']	['RBBP8', 'UBE2I', 'PDK4', 'GCSH', 'PPM1K', 'SNX1', 'LYRM4', 'ADSL', 'ATF7IP', 'DLST', 'HSPA9', 'TP53BP1', 'RAD50', 'XRCC6', 'PAXIP1', 'DLAT', 'PDHX', 'SETDB2', 'H2AX', 'MDC1', 'PMPCA', 'PHB2', 'SDHD', 'DBT', 'MCU', 'SIL1', 'BCKDK', 'BCKDHB', 'PDHA1', 'SUMO1', 'RPA1', 'ARL14EP', 'FLYWCH1', 'BLM', 'PIAS1', 'MRE11', 'VDAC1', 'RAD51', 'AFG3L2', 'HDAC6', 'ISCU', 'GPD1', 'PDK1', 'NSUN6', 'SDHB', 'NFS1', 'NDUFAB1', 'BRCA1', 'SDHA', 'MICU1', 'DLD', 'MBD1', 'NDUFV3', 'TRIM28', 'BARD1', 'MICU2', 'MFN1', 'PEPD', 'PMPCB', 'OGDH', 'PHB1', 'UFM1', 'STAT5B', 'BCKDHA']
540	GO:BP	GO:0035518	histone H2A monoubiquitination	0.0035169903676594	True	"""The modification of histone H2A by addition of a single ubiquitin group."" [PMID:18206970]"	19	96	4	21110	0.0416666666666666	0.2105263157894736	query_1	['GO:0010390', 'GO:0033522']	['BRCA2', 'RAD51', 'BRCA1', 'BARD1']
541	GO:BP	GO:0090308	regulation of DNA methylation-dependent heterochromatin formation	0.0035169903676594	True	"""Any process that modulates the rate, frequency, or extent of DNA methylation-dependent heterochromatin formation."" [GOC:BHF]"	19	96	4	21110	0.0416666666666666	0.2105263157894736	query_1	['GO:0006346', 'GO:0031445']	['ATF7IP', 'SETDB2', 'SETDB1', 'TRIM28']
542	GO:BP	GO:0015986	proton motive force-driven ATP synthesis	0.0035472031821403	True	"""The transport of protons across a membrane to generate an electrochemical gradient (proton-motive force) that powers ATP synthesis."" [ISBN:0716731363]"	78	96	6	21110	0.0625	0.0769230769230769	query_1	['GO:0006754']	['SDHD', 'SDHB', 'NDUFAB1', 'SDHA', 'SDHC', 'NDUFV3']
543	REAC	REAC:R-HSA-5693548	Sensing of DNA Double Strand Breaks	0.0036095238871137	True	Sensing of DNA Double Strand Breaks	6	84	3	10790	0.0357142857142857	0.5	query_1	['REAC:R-HSA-5693606']	['NBN', 'RAD50', 'MRE11']
544	WP	WP:WP1971	Integrated cancer pathway	0.0036316271882161	True	Integrated cancer pathway	48	60	5	8133	0.0833333333333333	0.1041666666666666	query_1	['WP:000000']	['RAD50', 'BLM', 'MRE11', 'BRCA1', 'BARD1']
545	WP	WP:WP4686	Leucine, isoleucine and valine metabolism	0.0037347988303196	True	Leucine, isoleucine and valine metabolism	24	60	4	8133	0.0666666666666666	0.1666666666666666	query_1	['WP:000000']	['DBT', 'BCKDHB', 'DLD', 'BCKDHA']
546	HPA	HPA:0400053	rectum; glandular cells[High]	0.0037639983912352	True	rectum; glandular cells[High]	2573	83	37	11006	0.4457831325301205	0.0143801010493587	query_1	['HPA:0400052']	['PDK4', 'GCSH', 'ADSL', 'MAIP1', 'DLST', 'HSPA9', 'XRCC6', 'PAXIP1', 'PDHX', 'SETDB2', 'MDC1', 'PMPCA', 'MCU', 'PDHA1', 'SUMO1', 'FLYWCH1', 'BLM', 'PIAS1', 'MRE11', 'AFG3L2', 'ISCU', 'SDHB', 'FAF2', 'NFS1', 'NDUFAB1', 'SDHA', 'MICU1', 'DLD', 'PDK2', 'NDUFV3', 'PEPD', 'PMPCB', 'UBA5', 'OGDH', 'PHB1', 'UFM1', 'BCKDHA']
547	HPA	HPA:0080131	caudate; neuronal cells[≥Low]	0.003815721615857	True	caudate; neuronal cells[≥Low]	6154	83	65	11006	0.7831325301204819	0.0105622359441013	query_1	['HPA:0080000']	['UBE2I', 'PDK4', 'GCSH', 'PPM1K', 'SNX1', 'LYRM4', 'ADSL', 'MAIP1', 'CDK5RAP3', 'HSPA9', 'TP53BP1', 'RAD50', 'UBAC2', 'XRCC6', 'DLAT', 'PDHX', 'SETDB2', 'PDHB', 'H2AX', 'UFL1', 'MDC1', 'PMPCA', 'PHB2', 'MCAT', 'SDHD', 'DBT', 'MCU', 'SIL1', 'BCKDK', 'BCKDHB', 'PDHA1', 'HSPD1', 'PDK3', 'ARL14EP', 'FLYWCH1', 'PIAS1', 'MRE11', 'VDAC1', 'RAD51', 'AFG3L2', 'ISCU', 'PDK1', 'NSUN6', 'SDHB', 'FAF2', 'NFS1', 'CBX5', 'NDUFAB1', 'BRCA1', 'SDHA', 'MICU1', 'DLD', 'PDK2', 'MBD1', 'NDUFV3', 'TRIM28', 'BARD1', 'MICU2', 'MFN1', 'PMPCB', 'UBA5', 'OGDH', 'PHB1', 'UFM1', 'BCKDHA']
548	REAC	REAC:R-HSA-3232118	SUMOylation of transcription factors	0.0038809496761865	True	SUMOylation of transcription factors	18	84	4	10790	0.0476190476190476	0.2222222222222222	query_1	['REAC:R-HSA-3108232']	['UBE2I', 'TP53BP1', 'SUMO1', 'PIAS1']
549	HPA	HPA:0330222	oral mucosa; squamous epithelial cells[≥Medium]	0.0039257020583421	True	oral mucosa; squamous epithelial cells[≥Medium]	4353	83	52	11006	0.6265060240963856	0.0119457845164254	query_1	['HPA:0330221']	['RBBP8', 'UBE2I', 'PDK4', 'GCSH', 'PPM1K', 'SNX1', 'ADSL', 'CDK5RAP3', 'NBN', 'ATF7IP', 'DLST', 'HSPA9', 'TP53BP1', 'RAD50', 'XRCC6', 'PAXIP1', 'PDHX', 'SETDB2', 'H2AX', 'MDC1', 'PMPCA', 'PHB2', 'SDHD', 'SIL1', 'BCKDHB', 'SUMO1', 'RPA1', 'ARL14EP', 'FLYWCH1', 'BLM', 'PIAS1', 'MRE11', 'VDAC1', 'AFG3L2', 'ISCU', 'GPD1', 'SDHB', 'NFS1', 'BRCA1', 'SDHA', 'MICU1', 'DLD', 'PDK2', 'MBD1', 'NDUFV3', 'TRIM28', 'MFN1', 'PMPCB', 'OGDH', 'PHB1', 'UFM1', 'BCKDHA']
550	KEGG	KEGG:03460	Fanconi anemia pathway	0.0041339675199119	True	Fanconi anemia pathway	53	63	5	8161	0.0793650793650793	0.0943396226415094	query_1	['KEGG:00000']	['BRCA2', 'RPA1', 'BLM', 'RAD51', 'BRCA1']
551	GO:BP	GO:1901991	negative regulation of mitotic cell cycle phase transition	0.0041531993260809	True	"""Any process that stops, prevents or reduces the frequency, rate or extent of mitotic cell cycle phase transition."" [GOC:mtg_cell_cycle, GOC:TermGenie, PMID:22841721]"	181	96	8	21110	0.0833333333333333	0.0441988950276243	query_1	['GO:0044772', 'GO:0045930', 'GO:1901988', 'GO:1901990']	['RBBP8', 'CDK5RAP3', 'NBN', 'RAD50', 'BLM', 'MRE11', 'BRCA1', 'BARD1']
552	HP	HP:0009594	Retinal hamartoma	0.0042483082138222	True	A hamartoma (a benign, focal malformation consisting of a disorganized mixture of cells and tissues) of the retina.	22	54	5	4851	0.0925925925925925	0.2272727272727272	query_1	['HP:0000479', 'HP:0010568']	['DLST', 'SDHD', 'SDHB', 'SDHA', 'SDHC']
553	REAC	REAC:R-HSA-1268020	Mitochondrial protein import	0.0042880946176931	True	Mitochondrial protein import	65	84	6	10790	0.0714285714285714	0.0923076923076923	query_1	['REAC:R-HSA-9609507']	['OTC', 'HSPA9', 'PMPCA', 'HSPD1', 'VDAC1', 'PMPCB']
554	HPA	HPA:0490691	smooth muscle; smooth muscle cells[≥Low]	0.0044267188524354	True	smooth muscle; smooth muscle cells[≥Low]	5446	83	60	11006	0.7228915662650602	0.0110172603745868	query_1	['HPA:0490000']	['RBBP8', 'GCSH', 'PPM1K', 'SNX1', 'LYRM4', 'ADSL', 'CDK5RAP3', 'NBN', 'DLST', 'HSPA9', 'MCUB', 'TP53BP1', 'RAD50', 'XRCC6', 'PAXIP1', 'DLAT', 'PDHX', 'SETDB2', 'PDHB', 'H2AX', 'DDRGK1', 'MDC1', 'PMPCA', 'PHB2', 'MCAT', 'DBT', 'MCU', 'BCKDHB', 'PDHA1', 'SUMO1', 'HSPD1', 'RPA1', 'ARL14EP', 'FLYWCH1', 'BLM', 'PIAS1', 'MRE11', 'VDAC1', 'AFG3L2', 'ISCU', 'PDK1', 'SDHB', 'FAF2', 'NFS1', 'BRCA1', 'SDHA', 'MICU1', 'DLD', 'PDK2', 'NDUFV3', 'TRIM28', 'BARD1', 'MICU2', 'MFN1', 'UBA5', 'OGDH', 'PHB1', 'UFM1', 'STAT5B', 'BCKDHA']
555	HPA	HPA:0490000	smooth muscle	0.0044267188524354	True	smooth muscle	5446	83	60	11006	0.7228915662650602	0.0110172603745868	query_1	['HPA:0000000']	['RBBP8', 'GCSH', 'PPM1K', 'SNX1', 'LYRM4', 'ADSL', 'CDK5RAP3', 'NBN', 'DLST', 'HSPA9', 'MCUB', 'TP53BP1', 'RAD50', 'XRCC6', 'PAXIP1', 'DLAT', 'PDHX', 'SETDB2', 'PDHB', 'H2AX', 'DDRGK1', 'MDC1', 'PMPCA', 'PHB2', 'MCAT', 'DBT', 'MCU', 'BCKDHB', 'PDHA1', 'SUMO1', 'HSPD1', 'RPA1', 'ARL14EP', 'FLYWCH1', 'BLM', 'PIAS1', 'MRE11', 'VDAC1', 'AFG3L2', 'ISCU', 'PDK1', 'SDHB', 'FAF2', 'NFS1', 'BRCA1', 'SDHA', 'MICU1', 'DLD', 'PDK2', 'NDUFV3', 'TRIM28', 'BARD1', 'MICU2', 'MFN1', 'UBA5', 'OGDH', 'PHB1', 'UFM1', 'STAT5B', 'BCKDHA']
556	HPA	HPA:0310443	lymph node; non-germinal center cells[High]	0.0045724195320179	True	lymph node; non-germinal center cells[High]	1209	83	23	11006	0.2771084337349397	0.0190239867659222	query_1	['HPA:0310442']	['UBE2I', 'ADSL', 'CDK5RAP3', 'HSPA9', 'TP53BP1', 'XRCC6', 'PAXIP1', 'SETDB2', 'PMPCA', 'RPA1', 'FLYWCH1', 'PIAS1', 'MRE11', 'AFG3L2', 'SDHB', 'MICU1', 'STAT5A', 'DLD', 'NDUFV3', 'OGDH', 'PHB1', 'UFM1', 'BCKDHA']
557	HPA	HPA:0271133	kidney; distal tubules[High]	0.0046311358477473	True	kidney; distal tubules[High]	310	83	11	11006	0.1325301204819277	0.0354838709677419	query_1	['HPA:0271132']	['DLST', 'DLAT', 'PDHB', 'H2AX', 'DBT', 'HSPD1', 'VDAC1', 'SDHB', 'SDHA', 'NDUFV3', 'PHB1']
558	GO:MF	GO:0036094	small molecule binding	0.0050372299869267	True	"""Binding to a small molecule, any low molecular weight, monomeric, non-encoded molecule."" [GOC:curators, GOC:pde, GOC:pm]"	2584	97	29	20195	0.2989690721649484	0.0112229102167182	query_1	['GO:0005488']	['UBE2I', 'PDK4', 'SPG7', 'OTC', 'HSPA9', 'RAD50', 'XRCC6', 'TALDO1', 'DBT', 'SIL1', 'BCKDK', 'HSPD1', 'PDK3', 'BLM', 'VDAC1', 'RAD51', 'AFG3L2', 'MOCS3', 'GPD1', 'PDK1', 'NFS1', 'NDUFAB1', 'SDHA', 'DLD', 'PDK2', 'MBD1', 'MFN1', 'UBA5', 'OGDH']
559	HPA	HPA:0430051	seminal vesicle; glandular cells[≥Low]	0.0052083552731609	True	seminal vesicle; glandular cells[≥Low]	6821	83	69	11006	0.8313253012048193	0.0101158187948981	query_1	['HPA:0430000']	['SNX6', 'PDK4', 'GCSH', 'PPM1K', 'SNX1', 'LYRM4', 'ADSL', 'MAIP1', 'CDK5RAP3', 'NBN', 'ATF7IP', 'DLST', 'HSPA9', 'TP53BP1', 'RAD50', 'XRCC6', 'PAXIP1', 'PDHX', 'SETDB2', 'PDHB', 'H2AX', 'DDRGK1', 'UFL1', 'MDC1', 'PMPCA', 'PHB2', 'MCAT', 'SDHD', 'DBT', 'MCU', 'SIL1', 'BCKDK', 'BCKDHB', 'PDHA1', 'SUMO1', 'RPA1', 'ARL14EP', 'FLYWCH1', 'PIAS1', 'MRE11', 'VDAC1', 'AFG3L2', 'HDAC6', 'ISCU', 'GPD1', 'PDK1', 'NSUN6', 'SDHB', 'FAF2', 'NFS1', 'CBX5', 'BRCA1', 'SDHA', 'MICU1', 'DLD', 'PDK2', 'NDUFV3', 'TRIM28', 'BARD1', 'MICU2', 'MFN1', 'PEPD', 'PMPCB', 'UBA5', 'OGDH', 'PHB1', 'UFM1', 'STAT5B', 'BCKDHA']
560	HPA	HPA:0430000	seminal vesicle	0.0052083552731609	True	seminal vesicle	6821	83	69	11006	0.8313253012048193	0.0101158187948981	query_1	['HPA:0000000']	['SNX6', 'PDK4', 'GCSH', 'PPM1K', 'SNX1', 'LYRM4', 'ADSL', 'MAIP1', 'CDK5RAP3', 'NBN', 'ATF7IP', 'DLST', 'HSPA9', 'TP53BP1', 'RAD50', 'XRCC6', 'PAXIP1', 'PDHX', 'SETDB2', 'PDHB', 'H2AX', 'DDRGK1', 'UFL1', 'MDC1', 'PMPCA', 'PHB2', 'MCAT', 'SDHD', 'DBT', 'MCU', 'SIL1', 'BCKDK', 'BCKDHB', 'PDHA1', 'SUMO1', 'RPA1', 'ARL14EP', 'FLYWCH1', 'PIAS1', 'MRE11', 'VDAC1', 'AFG3L2', 'HDAC6', 'ISCU', 'GPD1', 'PDK1', 'NSUN6', 'SDHB', 'FAF2', 'NFS1', 'CBX5', 'BRCA1', 'SDHA', 'MICU1', 'DLD', 'PDK2', 'NDUFV3', 'TRIM28', 'BARD1', 'MICU2', 'MFN1', 'PEPD', 'PMPCB', 'UBA5', 'OGDH', 'PHB1', 'UFM1', 'STAT5B', 'BCKDHA']
561	GO:CC	GO:0034704	calcium channel complex	0.0052618334446427	True	"""An ion channel complex through which calcium ions pass."" [GOC:mah]"	74	97	5	22122	0.0515463917525773	0.0675675675675675	query_1	['GO:0034703']	['MCUB', 'MCU', 'MICU1', 'SMDT1', 'MICU2']
562	HP	HP:0003528	Elevated calcitonin	0.0053827082144796	True	Elevated calcitonin	23	54	5	4851	0.0925925925925925	0.217391304347826	query_1	['HP:0100530']	['DLST', 'SDHD', 'SDHB', 'SDHA', 'SDHC']
563	GO:CC	GO:0035632	mitochondrial prohibitin complex	0.0054059392392693	True	"""A complex composed of two proteins, prohibitin 1 and prohibitin 2 (PHB1/PHB-1 and PHB2/PHB-2) that is highly conserved amongst eukaryotes and associated with the inner mitochondrial membrane. The mitochondrial prohibitin complex is a macromolecular supercomplex composed of repeating heterodimeric subunits of PHB1 and PHB2. The mitochondrial prohibitin complex plays a role in a number of biological processes, including mitochondrial biogenesis and function, development, replicative senescence, and cell death."" [GOC:kmv, PMID:12237468, PMID:21164222]"	2	97	2	22122	0.0206185567010309	1.0	query_1	['GO:0098800']	['PHB2', 'PHB1']
564	GO:CC	GO:0017087	mitochondrial processing peptidase complex	0.0054059392392693	True	"""A protein complex consisting of a regulatory subunit (alpha-MPP) and a catalytic subunit (beta-MPP) that catalyzes the release of N-terminal targeting peptides from precursor proteins imported into the mitochondrion."" [GOC:mah]"	2	97	2	22122	0.0206185567010309	1.0	query_1	['GO:0005759', 'GO:0098798', 'GO:1902494']	['PMPCA', 'PMPCB']
565	GO:CC	GO:0005745	m-AAA complex	0.0054059392392693	True	"""Protease complex of the mitochondrial inner membrane that is involved in mitochondrial protein turnover and in processing of proteins imported into mitochondria."" [GOC:mcc, PMID:12417197, PMID:21147776]"	2	97	2	22122	0.0206185567010309	1.0	query_1	['GO:0098800', 'GO:1905368']	['SPG7', 'AFG3L2']
566	GO:BP	GO:0000018	regulation of DNA recombination	0.0054105767575281	True	"""Any process that modulates the frequency, rate or extent of DNA recombination, a DNA metabolic process in which a new genotype is formed by reassortment of genes resulting in gene combinations different from those that were present in the parents."" [GOC:go_curators, ISBN:0198506732]"	131	96	7	21110	0.0729166666666666	0.0534351145038167	query_1	['GO:0006310', 'GO:0051052']	['RBBP8', 'TP53BP1', 'RAD50', 'PAXIP1', 'BLM', 'MRE11', 'RAD51']
567	WP	WP:WP5316	Primary ovarian insufficiency	0.0054290954115069	True	Primary ovarian insufficiency	174	60	8	8133	0.1333333333333333	0.0459770114942528	query_1	['WP:000000']	['NBN', 'XRCC6', 'BRCA2', 'SIL1', 'BCKDHB', 'BLM', 'RAD51', 'BRCA1']
568	HPA	HPA:0590053	thyroid gland; glandular cells[High]	0.0054463495027553	True	thyroid gland; glandular cells[High]	1882	83	30	11006	0.3614457831325301	0.0159404888416578	query_1	['HPA:0590052']	['GCSH', 'LYRM4', 'ADSL', 'HSPA9', 'TP53BP1', 'RAD50', 'XRCC6', 'PAXIP1', 'SETDB2', 'H2AX', 'MDC1', 'PMPCA', 'PHB2', 'MCAT', 'PDHA1', 'RPA1', 'FLYWCH1', 'BLM', 'PIAS1', 'MRE11', 'ISCU', 'NFS1', 'MICU1', 'DLD', 'TRIM28', 'UBA5', 'OGDH', 'PHB1', 'UFM1', 'BCKDHA']
569	REAC	REAC:R-HSA-69620	Cell Cycle Checkpoints	0.0055444333029686	True	Cell Cycle Checkpoints	289	84	11	10790	0.1309523809523809	0.0380622837370242	query_1	['REAC:R-HSA-1640170']	['RBBP8', 'NBN', 'TP53BP1', 'RAD50', 'H2AX', 'MDC1', 'RPA1', 'BLM', 'MRE11', 'BRCA1', 'BARD1']
570	GO:BP	GO:0046395	carboxylic acid catabolic process	0.0058803949633285	True	"""The chemical reactions and pathways resulting in the breakdown of carboxylic acids, any organic acid containing one or more carboxyl (-COOH) groups."" [ISBN:0198506732]"	255	96	9	21110	0.09375	0.0352941176470588	query_1	['GO:0016054', 'GO:0019752']	['GCSH', 'OTC', 'DLST', 'MCAT', 'DBT', 'BCKDK', 'BCKDHB', 'DLD', 'BCKDHA']
571	GO:BP	GO:0016054	organic acid catabolic process	0.0058803949633285	True	"""The chemical reactions and pathways resulting in the breakdown of organic acids, any acidic compound containing carbon in covalent linkage."" [ISBN:0198506732]"	255	96	9	21110	0.09375	0.0352941176470588	query_1	['GO:0006082', 'GO:0044248', 'GO:0044282', 'GO:1901575']	['GCSH', 'OTC', 'DLST', 'MCAT', 'DBT', 'BCKDK', 'BCKDHB', 'DLD', 'BCKDHA']
572	GO:BP	GO:0044773	mitotic DNA damage checkpoint signaling	0.005887554044663	True	"""A signal transduction process involved in mitotic DNA damage checkpoint."" [GOC:mtg_cell_cycle, GOC:TermGenie]"	85	96	6	21110	0.0625	0.0705882352941176	query_1	['GO:0000077', 'GO:0044774']	['CDK5RAP3', 'NBN', 'MDC1', 'BLM', 'MRE11', 'BRCA1']
573	REAC	REAC:R-HSA-9006931	Signaling by Nuclear Receptors	0.0059145787377288	True	Signaling by Nuclear Receptors	291	84	11	10790	0.1309523809523809	0.0378006872852233	query_1	['REAC:R-HSA-162582']	['PDK4', 'DLAT', 'PDHA2', 'PDHX', 'PDHB', 'H2AX', 'PDHA1', 'PDK3', 'PDK1', 'DLD', 'PDK2']
574	REAC	REAC:R-HSA-1430728	Metabolism	0.0059441089552149	True	Metabolism	2072	84	33	10790	0.3928571428571428	0.0159266409266409	query_1	['REAC:0000000']	['UBE2I', 'PDK4', 'GCSH', 'PPM1K', 'LYRM4', 'ADSL', 'OTC', 'DLST', 'TALDO1', 'DLAT', 'PDHA2', 'PDHX', 'PDHB', 'MCAT', 'SDHD', 'DBT', 'BCKDK', 'BCKDHB', 'PDHA1', 'PDK3', 'VDAC1', 'MOCS3', 'GPD1', 'PDK1', 'SDHB', 'NDUFAB1', 'SDHA', 'SDHC', 'DLD', 'PDK2', 'NDUFV3', 'OGDH', 'BCKDHA']
575	GO:BP	GO:0007346	regulation of mitotic cell cycle	0.0060358665223815	True	"""Any process that modulates the rate or extent of progress through the mitotic cell cycle."" [GOC:dph, GOC:go_curators, GOC:tb]"	495	96	12	21110	0.125	0.0242424242424242	query_1	['GO:0000278', 'GO:0051726']	['RBBP8', 'CDK5RAP3', 'NBN', 'RAD50', 'MDC1', 'PHB2', 'BRCA2', 'BLM', 'MRE11', 'BRCA1', 'BARD1', 'STAT5B']
576	GO:BP	GO:0071478	cellular response to radiation	0.0062048020584196	True	"""Any process that results in a change in state or activity of a cell (in terms of movement, secretion, enzyme production, gene expression, etc.) as a result of an electromagnetic radiation stimulus. Electromagnetic radiation is a propagating wave in space with electric and magnetic components. These components oscillate at right angles to each other and to the direction of propagation."" [GOC:mah]"	191	96	8	21110	0.0833333333333333	0.0418848167539267	query_1	['GO:0009314', 'GO:0071214']	['TP53BP1', 'XRCC6', 'H2AX', 'BRCA2', 'BLM', 'RAD51', 'BRCA1', 'BARD1']
577	GO:BP	GO:0032200	telomere organization	0.0062048020584196	True	"""A process that is carried out at the cellular level which results in the assembly, arrangement of constituent parts, or disassembly of telomeres, terminal regions of a linear chromosome that include the telomeric DNA repeats and associated proteins."" [GOC:dph, GOC:jl, GOC:mah]"	191	96	8	21110	0.0833333333333333	0.0418848167539267	query_1	['GO:0051276']	['NBN', 'RAD50', 'XRCC6', 'BRCA2', 'RPA1', 'BLM', 'MRE11', 'RAD51']
578	CORUM	CORUM:5400	BRCC complex	0.0065243230970504	True	BRCC complex	5	47	3	3383	0.0638297872340425	0.6	query_1	['CORUM:0000000']	['BRCA2', 'RAD51', 'BRCA1']
579	CORUM	CORUM:1189	DNA double-strand break end-joining complex	0.0065243230970504	True	DNA double-strand break end-joining complex	5	47	3	3383	0.0638297872340425	0.6	query_1	['CORUM:0000000']	['NBN', 'RAD50', 'MRE11']
580	GO:MF	GO:0003678	DNA helicase activity	0.0067097876957777	True	"""Unwinding of a DNA helix, driven by ATP hydrolysis."" [GOC:jl]"	59	97	5	20195	0.0515463917525773	0.0847457627118644	query_1	['GO:0004386', 'GO:0008094']	['RAD50', 'XRCC6', 'BLM', 'MRE11', 'RAD51']
581	HPA	HPA:0301373	lung; alveolar cells type II[High]	0.0067853310855953	True	lung; alveolar cells type II[High]	662	83	16	11006	0.1927710843373494	0.0241691842900302	query_1	['HPA:0301372']	['CDK5RAP3', 'NBN', 'TP53BP1', 'XRCC6', 'PAXIP1', 'H2AX', 'SUMO1', 'RPA1', 'PIAS1', 'MRE11', 'GPD1', 'NFS1', 'NDUFV3', 'TRIM28', 'PEPD', 'OGDH']
582	GO:BP	GO:0034641	cellular nitrogen compound metabolic process	0.0067891843120038	True	"""The chemical reactions and pathways involving various organic and inorganic nitrogenous compounds, as carried out by individual cells."" [GOC:mah]"	8680	96	62	21110	0.6458333333333334	0.0071428571428571	query_1	['GO:0006807', 'GO:0044237']	['RBBP8', 'SNX6', 'UBE2I', 'PDK4', 'ADSL', 'CDK5RAP3', 'NBN', 'OTC', 'ATF7IP', 'DLST', 'TP53BP1', 'RAD50', 'ZNF45', 'ZNF350', 'XRCC6', 'TALDO1', 'PAXIP1', 'DLAT', 'PDHA2', 'PDHX', 'SETDB2', 'PDHB', 'H2AX', 'DDRGK1', 'UFL1', 'MDC1', 'PHB2', 'SDHD', 'BRCA2', 'SETDB1', 'PDHA1', 'SUMO1', 'HSPD1', 'RPA1', 'PDK3', 'FLYWCH1', 'BLM', 'PIAS1', 'MRE11', 'RAD51', 'HDAC6', 'MOCS3', 'GPD1', 'PDK1', 'NSUN6', 'SDHB', 'CBX5', 'NDUFAB1', 'BRCA1', 'SDHA', 'STAT5A', 'SDHC', 'DLD', 'PDK2', 'MBD1', 'NDUFV3', 'TRIM28', 'BARD1', 'MFN1', 'OGDH', 'PHB1', 'STAT5B']
583	HP	HP:0030074	Chemodectoma	0.0068116773255808	True	A usually benign neoplasm originating in the chemoreceptor tissue of the carotid body, glomus jugulare, glomus tympanicum, aortic bodies, or the female genital tract.	4	54	3	4851	0.0555555555555555	0.75	query_1	['HP:0002668']	['SDHD', 'SDHB', 'SDHC']
584	HP	HP:0010787	Genital neoplasm	0.0069308729767107	True	A tumor (abnormal growth of tissue) of the genital system.	153	54	10	4851	0.1851851851851851	0.065359477124183	query_1	['HP:0000078', 'HP:0007379']	['NBN', 'RAD50', 'SDHD', 'BRCA2', 'MRE11', 'RAD51', 'SDHB', 'BRCA1', 'SDHC', 'BARD1']
585	KEGG	KEGG:01100	Metabolic pathways	0.007113889630149	True	Metabolic pathways	1532	63	25	8161	0.3968253968253968	0.0163185378590078	query_1	['KEGG:00000']	['GCSH', 'ADSL', 'OTC', 'DLST', 'TALDO1', 'DLAT', 'PDHA2', 'PDHX', 'SETDB2', 'PDHB', 'MCAT', 'SDHD', 'DBT', 'SETDB1', 'BCKDHB', 'PDHA1', 'SDHB', 'NFS1', 'NDUFAB1', 'SDHA', 'SDHC', 'DLD', 'NDUFV3', 'OGDH', 'BCKDHA']
586	GO:BP	GO:0032446	protein modification by small protein conjugation	0.0071995059854487	True	"""A protein modification process in which one or more groups of a small protein, such as ubiquitin or a ubiquitin-like protein, are covalently attached to a target protein."" [GOC:mah]"	905	96	16	21110	0.1666666666666666	0.0176795580110497	query_1	['GO:0070647']	['UBE2I', 'CDK5RAP3', 'PAXIP1', 'DDRGK1', 'UFL1', 'BRCA2', 'SUMO1', 'PIAS1', 'RAD51', 'HDAC6', 'MOCS3', 'BRCA1', 'TRIM28', 'BARD1', 'UBA5', 'UFM1']
587	GO:BP	GO:0019219	regulation of nucleobase-containing compound metabolic process	0.0072293490819567	True	"""Any cellular process that modulates the frequency, rate or extent of the chemical reactions and pathways involving nucleobases, nucleosides, nucleotides and nucleic acids."" [GOC:go_curators]"	4061	96	38	21110	0.3958333333333333	0.0093573011573504	query_1	['GO:0006139', 'GO:0031323', 'GO:0051171', 'GO:0080090']	['RBBP8', 'SNX6', 'UBE2I', 'PDK4', 'CDK5RAP3', 'NBN', 'ATF7IP', 'TP53BP1', 'RAD50', 'ZNF45', 'ZNF350', 'XRCC6', 'PAXIP1', 'SETDB2', 'H2AX', 'DDRGK1', 'UFL1', 'PHB2', 'BRCA2', 'SETDB1', 'SUMO1', 'PDK3', 'FLYWCH1', 'BLM', 'PIAS1', 'MRE11', 'RAD51', 'HDAC6', 'PDK1', 'CBX5', 'BRCA1', 'STAT5A', 'PDK2', 'MBD1', 'TRIM28', 'BARD1', 'PHB1', 'STAT5B']
588	HPA	HPA:0460673	skin 1; melanocytes[High]	0.0074671605414257	True	skin 1; melanocytes[High]	986	83	20	11006	0.2409638554216867	0.0202839756592292	query_1	['HPA:0460672']	['GCSH', 'ADSL', 'HSPA9', 'RAD50', 'XRCC6', 'PAXIP1', 'H2AX', 'MDC1', 'SDHD', 'SUMO1', 'RPA1', 'FLYWCH1', 'PIAS1', 'MRE11', 'HDAC6', 'NFS1', 'NDUFAB1', 'TRIM28', 'PMPCB', 'BCKDHA']
589	HPA	HPA:0220053	gallbladder; glandular cells[High]	0.0075412265287404	True	gallbladder; glandular cells[High]	2872	83	39	11006	0.4698795180722891	0.0135793871866295	query_1	['HPA:0220052']	['PDK4', 'CDK5RAP3', 'HSPA9', 'TP53BP1', 'RAD50', 'XRCC6', 'PAXIP1', 'SETDB2', 'PDHB', 'MDC1', 'PMPCA', 'MCAT', 'MCU', 'SIL1', 'PDHA1', 'SUMO1', 'RPA1', 'FLYWCH1', 'BLM', 'PIAS1', 'MRE11', 'VDAC1', 'AFG3L2', 'ISCU', 'SDHB', 'NFS1', 'CBX5', 'NDUFAB1', 'SDHA', 'MICU1', 'DLD', 'PDK2', 'NDUFV3', 'TRIM28', 'PEPD', 'OGDH', 'PHB1', 'UFM1', 'BCKDHA']
590	GO:MF	GO:0140096	catalytic activity, acting on a protein	0.0075533760975687	True	"""Catalytic activity that acts to modify a protein."" [GOC:molecular_function_refactoring, GOC:pdt]"	2349	97	27	20195	0.2783505154639175	0.0114942528735632	query_1	['GO:0003824']	['PPIF', 'UBE2I', 'PDK4', 'SPG7', 'PPM1K', 'DLST', 'DLAT', 'SETDB2', 'UFL1', 'PMPCA', 'METTL21C', 'BRCA2', 'SETDB1', 'BCKDK', 'PDK3', 'PIAS1', 'AFG3L2', 'HDAC6', 'MOCS3', 'PDK1', 'BRCA1', 'PDK2', 'TRIM28', 'BARD1', 'PEPD', 'PMPCB', 'UBA5']
591	GO:BP	GO:0044774	mitotic DNA integrity checkpoint signaling	0.0077093187184691	True	"""A signaling process that controls cell cycle progression in response to changes in DNA structure by monitoring the integrity of the DNA during mitosis. The DNA integrity checkpoint begins with detection of DNA damage, defects in DNA structure or DNA replication, and ends with signal transduction."" [GOC:mtg_cell_cycle]"	89	96	6	21110	0.0625	0.0674157303370786	query_1	['GO:0007093', 'GO:0031570']	['CDK5RAP3', 'NBN', 'MDC1', 'BLM', 'MRE11', 'BRCA1']
592	GO:BP	GO:1901565	organonitrogen compound catabolic process	0.0078674271022186	True	"""The chemical reactions and pathways resulting in the breakdown of organonitrogen compound."" [GOC:pr, GOC:TermGenie]"	1383	96	20	21110	0.2083333333333333	0.0144613159797541	query_1	['GO:1901564', 'GO:1901575']	['UBE2I', 'GCSH', 'SNX1', 'CDK5RAP3', 'OTC', 'DLST', 'UBAC2', 'DDRGK1', 'UFL1', 'DBT', 'BCKDK', 'BCKDHB', 'SUMO1', 'PIAS1', 'HDAC6', 'FAF2', 'DLD', 'BARD1', 'PHB1', 'BCKDHA']
593	KEGG	KEGG:00640	Propanoate metabolism	0.0080965548844592	True	Propanoate metabolism	32	63	4	8161	0.0634920634920634	0.125	query_1	['KEGG:00000']	['DBT', 'BCKDHB', 'DLD', 'BCKDHA']
594	HP	HP:0002331	Recurrent paroxysmal headache	0.0083565750436096	True	Repeated episodes of headache with rapid onset, reaching a peak within minutes and of short duration (less than one hour) with pain that is throbbing, pulsating, or bursting in quality.	25	54	5	4851	0.0925925925925925	0.2	query_1	['HP:0002315']	['DLST', 'SDHD', 'SDHB', 'SDHA', 'SDHC']
595	HP	HP:0007272	Progressive psychomotor deterioration	0.0083651486119863	True	Progressive psychomotor deterioration	12	54	4	4851	0.074074074074074	0.3333333333333333	query_1	['HP:0002344']	['PMPCA', 'SDHD', 'SDHB', 'SDHA']
596	GO:BP	GO:0009628	response to abiotic stimulus	0.0085029826978725	True	"""Any process that results in a change in state or activity of a cell or an organism (in terms of movement, secretion, enzyme production, gene expression, etc.) as a result of an abiotic (not derived from living organisms) stimulus."" [GOC:hb]"	1146	96	18	21110	0.1875	0.0157068062827225	query_1	['GO:0050896']	['ADSL', 'TP53BP1', 'XRCC6', 'PAXIP1', 'H2AX', 'PHB2', 'SDHD', 'BRCA2', 'SUMO1', 'HSPD1', 'PDK3', 'BLM', 'RAD51', 'PDK1', 'BRCA1', 'MICU1', 'BARD1', 'GJA10']
597	GO:BP	GO:0048545	response to steroid hormone	0.0085416298110371	True	"""Any process that results in a change in state or activity of a cell or an organism (in terms of movement, secretion, enzyme production, gene expression, etc.) as a result of a steroid hormone stimulus."" [GOC:go_curators]"	342	96	10	21110	0.1041666666666666	0.0292397660818713	query_1	['GO:0009725', 'GO:0014070', 'GO:0033993']	['DDRGK1', 'UFL1', 'PHB2', 'METTL21C', 'BCKDHB', 'HDAC6', 'BRCA1', 'UBA5', 'PHB1', 'UFM1']
598	GO:BP	GO:0032870	cellular response to hormone stimulus	0.0085653963908653	True	"""Any process that results in a change in state or activity of a cell (in terms of movement, secretion, enzyme production, gene expression, etc.) as a result of a hormone stimulus."" [GOC:mah]"	606	96	13	21110	0.1354166666666666	0.0214521452145214	query_1	['GO:0009725', 'GO:0071310', 'GO:0071495']	['PDK4', 'DDRGK1', 'UFL1', 'PHB2', 'METTL21C', 'HDAC6', 'BRCA1', 'STAT5A', 'PDK2', 'UBA5', 'PHB1', 'UFM1', 'STAT5B']
599	HP	HP:0033019	Male reproductive system neoplasm	0.0087817824105257	True	A neoplasm that affects the male reproductive system.	66	54	7	4851	0.1296296296296296	0.106060606060606	query_1	['HP:0010787']	['NBN', 'RAD50', 'BRCA2', 'MRE11', 'RAD51', 'BRCA1', 'BARD1']
600	GO:BP	GO:1903008	organelle disassembly	0.0088300684017552	True	"""The disaggregation of an organelle into its constituent components."" [GO_REF:0000079, GOC:TermGenie]"	141	96	7	21110	0.0729166666666666	0.0496453900709219	query_1	['GO:0006996', 'GO:0022411']	['DDRGK1', 'UFL1', 'PHB2', 'VDAC1', 'HDAC6', 'UBA5', 'UFM1']
601	HPA	HPA:0271123	kidney; collecting ducts[High]	0.0089719602423036	True	kidney; collecting ducts[High]	274	83	10	11006	0.1204819277108433	0.0364963503649635	query_1	['HPA:0271122']	['DLST', 'PDHB', 'H2AX', 'DBT', 'HSPD1', 'VDAC1', 'SDHB', 'SDHA', 'NDUFV3', 'PHB1']
602	GO:MF	GO:0000014	single-stranded DNA endodeoxyribonuclease activity	0.0089851648110674	True	"""Catalysis of the hydrolysis of ester linkages within a single-stranded deoxyribonucleic acid molecule by creating internal breaks."" [GOC:mah]"	10	97	3	20195	0.0309278350515463	0.3	query_1	['GO:0004520']	['RBBP8', 'RAD50', 'MRE11']
603	HP	HP:0000957	Cafe-au-lait spot	0.009237612868072	True	Cafe-au-lait spots are hyperpigmented lesions that can vary in color from light brown to dark brown with smooth borders and having a size of 1.5 cm or more in adults and 0.5 cm or more in children.	124	54	9	4851	0.1666666666666666	0.0725806451612903	query_1	['HP:0001034']	['RBBP8', 'NBN', 'SDHD', 'BRCA2', 'BLM', 'RAD51', 'SDHB', 'BRCA1', 'SDHC']
604	GO:MF	GO:0031625	ubiquitin protein ligase binding	0.009382505593732	True	"""Binding to a ubiquitin protein ligase enzyme, any of the E3 proteins."" [GOC:vp]"	297	97	9	20195	0.0927835051546391	0.0303030303030303	query_1	['GO:0044389']	['HSPA9', 'DBT', 'SUMO1', 'HSPD1', 'PIAS1', 'HDAC6', 'FAF2', 'BRCA1', 'TRIM28']
605	HPA	HPA:0090192	cerebellum; cells in molecular layer[≥Medium]	0.0094912783822698	True	cerebellum; cells in molecular layer[≥Medium]	2787	83	38	11006	0.4578313253012048	0.0136347326874775	query_1	['HPA:0090191']	['PDK4', 'GCSH', 'PPM1K', 'ADSL', 'MAIP1', 'CDK5RAP3', 'DLST', 'HSPA9', 'RAD50', 'XRCC6', 'PAXIP1', 'DLAT', 'SETDB2', 'H2AX', 'MDC1', 'PMPCA', 'MCU', 'PDHA1', 'RPA1', 'ARL14EP', 'FLYWCH1', 'BLM', 'PIAS1', 'MRE11', 'HDAC6', 'ISCU', 'GPD1', 'PDK1', 'SDHB', 'CBX5', 'NDUFAB1', 'SDHA', 'MICU1', 'DLD', 'PDK2', 'TRIM28', 'OGDH', 'PHB1']
606	KEGG	KEGG:03450	Non-homologous end-joining	0.0097435619160413	True	Non-homologous end-joining	13	63	3	8161	0.0476190476190476	0.2307692307692307	query_1	['KEGG:00000']	['RAD50', 'XRCC6', 'MRE11']
607	GO:BP	GO:0006996	organelle organization	0.0098207410080541	True	"""A process that is carried out at the cellular level which results in the assembly, arrangement of constituent parts, or disassembly of an organelle within a cell. An organelle is an organized structure of distinctive morphology and function. Includes the nucleus, mitochondria, plastids, vacuoles, vesicles, ribosomes and the cytoskeleton. Excludes the plasma membrane."" [GOC:mah]"	3608	96	35	21110	0.3645833333333333	0.00970066518847	query_1	['GO:0016043']	['PPIF', 'UBE2I', 'SPG7', 'MAIP1', 'NBN', 'ATF7IP', 'HSPA9', 'RAD50', 'XRCC6', 'SETDB2', 'DDRGK1', 'UFL1', 'PMPCA', 'PHB2', 'BRCA2', 'MCU', 'SETDB1', 'SUMO1', 'HSPD1', 'RPA1', 'BLM', 'MRE11', 'VDAC1', 'RAD51', 'AFG3L2', 'HDAC6', 'FAF2', 'NDUFAB1', 'BRCA1', 'TRIM28', 'MFN1', 'PMPCB', 'UBA5', 'PHB1', 'UFM1']
608	HPA	HPA:0570761	testis; pachytene spermatocytes[≥Low]	0.0098983619235938	True	testis; pachytene spermatocytes[≥Low]	2145	83	32	11006	0.3855421686746988	0.0149184149184149	query_1	['HPA:0570000']	['GCSH', 'ADSL', 'CDK5RAP3', 'ATF7IP', 'DLST', 'HSPA9', 'TP53BP1', 'UBAC2', 'XRCC6', 'DLAT', 'PDHX', 'H2AX', 'MDC1', 'SIL1', 'BCKDK', 'SUMO1', 'HSPD1', 'PIAS1', 'MRE11', 'RAD51', 'AFG3L2', 'HDAC6', 'NSUN6', 'SDHB', 'NFS1', 'SDHA', 'DLD', 'PDK2', 'TRIM28', 'BARD1', 'MFN1', 'BCKDHA']
609	GO:CC	GO:0001741	XY body	0.0101671690831238	True	"""A structure found in a male mammalian spermatocyte containing an unpaired X chromosome that has become densely heterochromatic, silenced and localized at the nuclear periphery."" [GOC:hjd, GOC:mr, PMID:20622855, Wikipedia:XY_sex-determination_system]"	15	97	3	22122	0.0309278350515463	0.2	query_1	['GO:0000803']	['H2AX', 'SUMO1', 'BRCA1']
610	GO:BP	GO:0051172	negative regulation of nitrogen compound metabolic process	0.0108846091419683	True	"""Any process that stops, prevents, or reduces the frequency, rate or extent of the chemical reactions and pathways involving nitrogen or nitrogenous compounds."" [GOC:ai, GOC:tb]"	2374	96	27	21110	0.28125	0.0113732097725358	query_1	['GO:0006807', 'GO:0009892', 'GO:0051171']	['RBBP8', 'SNX6', 'UBE2I', 'CDK5RAP3', 'NBN', 'ATF7IP', 'TP53BP1', 'RAD50', 'ZNF350', 'XRCC6', 'SETDB2', 'DDRGK1', 'UFL1', 'PHB2', 'SETDB1', 'BCKDK', 'SUMO1', 'FLYWCH1', 'BLM', 'PIAS1', 'HDAC6', 'CBX5', 'BRCA1', 'MBD1', 'TRIM28', 'BARD1', 'PHB1']
611	HPA	HPA:0270351	kidney; cells in glomeruli[≥Low]	0.0108921475408644	True	kidney; cells in glomeruli[≥Low]	5158	83	57	11006	0.6867469879518072	0.0110507948817371	query_1	['HPA:0270000']	['RBBP8', 'SNX6', 'PDK4', 'GCSH', 'SNX1', 'ADSL', 'CDK5RAP3', 'NBN', 'ATF7IP', 'DLST', 'HSPA9', 'TP53BP1', 'RAD50', 'XRCC6', 'PAXIP1', 'DLAT', 'PDHX', 'SETDB2', 'H2AX', 'DDRGK1', 'MDC1', 'PMPCA', 'PHB2', 'SDHD', 'MCU', 'SIL1', 'BCKDK', 'BCKDHB', 'PDHA1', 'SUMO1', 'HSPD1', 'RPA1', 'ARL14EP', 'FLYWCH1', 'BLM', 'PIAS1', 'MRE11', 'AFG3L2', 'HDAC6', 'ISCU', 'PDK1', 'NSUN6', 'SDHB', 'NFS1', 'CBX5', 'NDUFAB1', 'BRCA1', 'MICU1', 'DLD', 'MBD1', 'NDUFV3', 'TRIM28', 'PEPD', 'OGDH', 'PHB1', 'UFM1', 'BCKDHA']
612	HPA	HPA:0190223	esophagus; squamous epithelial cells[High]	0.0109104262723404	True	esophagus; squamous epithelial cells[High]	1652	83	27	11006	0.3253012048192771	0.0163438256658595	query_1	['HPA:0190222']	['GCSH', 'LYRM4', 'ADSL', 'ATF7IP', 'HSPA9', 'TP53BP1', 'XRCC6', 'PAXIP1', 'SETDB2', 'MDC1', 'PMPCA', 'MCU', 'RPA1', 'FLYWCH1', 'PIAS1', 'MRE11', 'AFG3L2', 'ISCU', 'SDHB', 'NFS1', 'MICU1', 'DLD', 'NDUFV3', 'TRIM28', 'OGDH', 'PHB1', 'BCKDHA']
613	HPA	HPA:0241102	heart muscle; cardiomyocytes[≥Medium]	0.0111881093625644	True	heart muscle; cardiomyocytes[≥Medium]	4367	83	51	11006	0.6144578313253012	0.0116784978245935	query_1	['HPA:0241101']	['PDK4', 'GCSH', 'PPM1K', 'LYRM4', 'ADSL', 'CDK5RAP3', 'DLST', 'HSPA9', 'TP53BP1', 'RAD50', 'UBAC2', 'XRCC6', 'PAXIP1', 'DLAT', 'PDHX', 'PDHB', 'H2AX', 'PMPCA', 'PHB2', 'MCAT', 'SDHD', 'DBT', 'MCU', 'PDHA1', 'SUMO1', 'RPA1', 'ARL14EP', 'FLYWCH1', 'BLM', 'PIAS1', 'MRE11', 'VDAC1', 'ISCU', 'GPD1', 'PDK1', 'SDHB', 'NFS1', 'NDUFAB1', 'SDHA', 'MICU1', 'DLD', 'PDK2', 'MBD1', 'NDUFV3', 'TRIM28', 'MICU2', 'PMPCB', 'OGDH', 'PHB1', 'UFM1', 'BCKDHA']
614	GO:BP	GO:0120261	regulation of heterochromatin organization	0.0112406773509113	True	"""Any process that modulates the frequency, rate, extent or location of heterochromatin organization."" [GOC:krc]"	25	96	4	21110	0.0416666666666666	0.16	query_1	['GO:0070828', 'GO:1902275']	['ATF7IP', 'SETDB2', 'SETDB1', 'TRIM28']
615	GO:BP	GO:0006312	mitotic recombination	0.0112406773509113	True	"""The exchange, reciprocal or nonreciprocal, of genetic material between one DNA molecule and a homologous DNA region that occurs during mitotic cell cycles."" [GOC:elh]"	25	96	4	21110	0.0416666666666666	0.16	query_1	['GO:0006310']	['RAD50', 'BRCA2', 'MRE11', 'RAD51']
616	GO:BP	GO:0031445	regulation of heterochromatin formation	0.0112406773509113	True	"""Any process that modulates the frequency, rate, extent or location of heterochromatin formation."" [GOC:mah]"	25	96	4	21110	0.0416666666666666	0.16	query_1	['GO:0010468', 'GO:0031507', 'GO:0120261']	['ATF7IP', 'SETDB2', 'SETDB1', 'TRIM28']
617	HPA	HPA:0080132	caudate; neuronal cells[≥Medium]	0.0112716835799445	True	caudate; neuronal cells[≥Medium]	4114	83	49	11006	0.5903614457831325	0.0119105493437044	query_1	['HPA:0080131']	['PDK4', 'GCSH', 'PPM1K', 'LYRM4', 'ADSL', 'MAIP1', 'HSPA9', 'TP53BP1', 'RAD50', 'XRCC6', 'DLAT', 'PDHX', 'SETDB2', 'PDHB', 'H2AX', 'PHB2', 'MCAT', 'MCU', 'SIL1', 'BCKDHB', 'PDHA1', 'ARL14EP', 'FLYWCH1', 'PIAS1', 'MRE11', 'VDAC1', 'AFG3L2', 'ISCU', 'PDK1', 'NSUN6', 'SDHB', 'NFS1', 'CBX5', 'NDUFAB1', 'BRCA1', 'SDHA', 'MICU1', 'DLD', 'PDK2', 'NDUFV3', 'TRIM28', 'BARD1', 'MICU2', 'MFN1', 'UBA5', 'OGDH', 'PHB1', 'UFM1', 'BCKDHA']
618	WP	WP:WP1530	miRNA regulation of DNA damage response	0.0113922967935698	True	miRNA regulation of DNA damage response	98	60	6	8133	0.1	0.0612244897959183	query_1	['WP:000000']	['NBN', 'RAD50', 'H2AX', 'MRE11', 'RAD51', 'BRCA1']
619	GO:BP	GO:0051052	regulation of DNA metabolic process	0.0114584893351362	True	"""Any process that modulates the frequency, rate or extent of the chemical reactions and pathways involving DNA."" [GOC:ai]"	527	96	12	21110	0.125	0.0227703984819734	query_1	['GO:0006259', 'GO:0019219', 'GO:0060255']	['RBBP8', 'NBN', 'TP53BP1', 'RAD50', 'PAXIP1', 'H2AX', 'BLM', 'MRE11', 'RAD51', 'BRCA1', 'TRIM28', 'BARD1']
620	HPA	HPA:0350473	pancreas; exocrine glandular cells[High]	0.0119660586150979	True	pancreas; exocrine glandular cells[High]	1959	83	30	11006	0.3614457831325301	0.0153139356814701	query_1	['HPA:0350472']	['GCSH', 'HSPA9', 'TP53BP1', 'RAD50', 'XRCC6', 'PAXIP1', 'SETDB2', 'H2AX', 'MDC1', 'SDHD', 'DBT', 'SIL1', 'BCKDK', 'FLYWCH1', 'BLM', 'PIAS1', 'MRE11', 'SDHB', 'FAF2', 'NDUFAB1', 'SDHA', 'MICU1', 'DLD', 'NDUFV3', 'TRIM28', 'PMPCB', 'UBA5', 'PHB1', 'UFM1', 'BCKDHA']
621	HPA	HPA:0510651	soft tissue 2; fibroblasts[≥Low]	0.0120327977246812	True	soft tissue 2; fibroblasts[≥Low]	4123	83	49	11006	0.5903614457831325	0.0118845500848896	query_1	['HPA:0510000']	['RBBP8', 'PDK4', 'GCSH', 'SNX1', 'LYRM4', 'ADSL', 'ATF7IP', 'DLST', 'HSPA9', 'TP53BP1', 'RAD50', 'UBAC2', 'XRCC6', 'PAXIP1', 'SETDB2', 'H2AX', 'MDC1', 'PMPCA', 'PHB2', 'MCAT', 'SDHD', 'MCU', 'BCKDK', 'BCKDHB', 'PDHA1', 'SUMO1', 'RPA1', 'ARL14EP', 'FLYWCH1', 'PIAS1', 'MRE11', 'VDAC1', 'AFG3L2', 'ISCU', 'PDK1', 'NSUN6', 'SDHB', 'BRCA1', 'SDHA', 'MICU1', 'DLD', 'NDUFV3', 'TRIM28', 'MFN1', 'PEPD', 'UBA5', 'PHB1', 'UFM1', 'BCKDHA']
622	GO:BP	GO:0006816	calcium ion transport	0.0121783131145206	True	"""The directed movement of calcium (Ca) ions into, out of or within a cell, or between cells, by means of some agent such as a transporter or pore."" [GOC:ai]"	440	96	11	21110	0.1145833333333333	0.025	query_1	['GO:0030001', 'GO:0071702']	['MAIP1', 'MCUB', 'METTL21C', 'MCU', 'SUMO1', 'VDAC1', 'AFG3L2', 'MICU1', 'SMDT1', 'MICU2', 'PMPCB']
623	HP	HP:0011703	Sinus tachycardia	0.0124848814112608	True	Heart rate of greater than 100 beats per minute.	27	54	5	4851	0.0925925925925925	0.1851851851851851	query_1	['HP:0011702']	['DLST', 'SDHD', 'SDHB', 'SDHA', 'SDHC']
624	HP	HP:0011281	Abnormality of urine catecholamine level	0.0124848814112608	True	An abnormal amount of urinary catecholamine concentration.	27	54	5	4851	0.0925925925925925	0.1851851851851851	query_1	['HP:0033354']	['DLST', 'SDHD', 'SDHB', 'SDHA', 'SDHC']
625	HP	HP:0011976	Elevated urinary catecholamines	0.0124848814112608	True	An increased concentration of catecholamine in the urine.	27	54	5	4851	0.0925925925925925	0.1851851851851851	query_1	['HP:0011281']	['DLST', 'SDHD', 'SDHB', 'SDHA', 'SDHC']
626	HP	HP:0001069	Episodic hyperhidrosis	0.0124848814112608	True	Intermittent episodes of abnormally increased perspiration.	27	54	5	4851	0.0925925925925925	0.1851851851851851	query_1	['HP:0000975']	['DLST', 'SDHD', 'SDHB', 'SDHA', 'SDHC']
627	HP	HP:0008055	Aplasia/Hypoplasia affecting the uvea	0.012786403626774	True	Absence or underdevelopment of the uvea, the pigmented middle layer of the eye consisting of the iris and ciliary body together with the choroid.	129	54	9	4851	0.1666666666666666	0.0697674418604651	query_1	['HP:0000553', 'HP:0008056']	['DLST', 'SDHD', 'BRCA2', 'RAD51', 'SDHB', 'BRCA1', 'SDHA', 'SDHC', 'TRIM28']
628	HP	HP:0008053	Aplasia/Hypoplasia of the iris	0.012786403626774	True	Absence or underdevelopment of the iris.	129	54	9	4851	0.1666666666666666	0.0697674418604651	query_1	['HP:0000525', 'HP:0008055', 'HP:0008062']	['DLST', 'SDHD', 'BRCA2', 'RAD51', 'SDHB', 'BRCA1', 'SDHA', 'SDHC', 'TRIM28']
629	KEGG	KEGG:00010	Glycolysis / Gluconeogenesis	0.0128058865664612	True	Glycolysis / Gluconeogenesis	67	63	5	8161	0.0793650793650793	0.0746268656716417	query_1	['KEGG:00000']	['DLAT', 'PDHA2', 'PDHB', 'PDHA1', 'DLD']
630	HPA	HPA:0150053	duodenum; glandular cells[High]	0.0128426379219089	True	duodenum; glandular cells[High]	2601	83	36	11006	0.4337349397590361	0.0138408304498269	query_1	['HPA:0150052']	['PDK4', 'GCSH', 'SNX1', 'ADSL', 'HSPA9', 'XRCC6', 'PAXIP1', 'PDHX', 'SETDB2', 'H2AX', 'PMPCA', 'MCU', 'BCKDK', 'PDHA1', 'SUMO1', 'FLYWCH1', 'BLM', 'PIAS1', 'MRE11', 'AFG3L2', 'ISCU', 'SDHB', 'FAF2', 'NFS1', 'NDUFAB1', 'SDHA', 'MICU1', 'DLD', 'NDUFV3', 'MFN1', 'PEPD', 'PMPCB', 'OGDH', 'PHB1', 'UFM1', 'BCKDHA']
631	GO:BP	GO:0006346	DNA methylation-dependent heterochromatin formation	0.0132382167030294	True	"""Repression of transcription by methylation of DNA, leading to the formation of heterochromatin."" [GOC:mah]"	26	96	4	21110	0.0416666666666666	0.1538461538461538	query_1	['GO:0140718']	['ATF7IP', 'SETDB2', 'SETDB1', 'TRIM28']
632	REAC	REAC:R-HSA-5633007	Regulation of TP53 Activity	0.0132677978108628	True	Regulation of TP53 Activity	160	84	8	10790	0.0952380952380952	0.05	query_1	['REAC:R-HSA-3700989']	['RBBP8', 'NBN', 'RAD50', 'RPA1', 'BLM', 'MRE11', 'BRCA1', 'BARD1']
633	HPA	HPA:0440341	skeletal muscle; myocytes[≥Low]	0.0138457059105732	True	skeletal muscle; myocytes[≥Low]	5898	83	62	11006	0.7469879518072289	0.0105120379789759	query_1	['HPA:0440000']	['SNX6', 'PDK4', 'GCSH', 'PPM1K', 'SNX1', 'LYRM4', 'ADSL', 'MAIP1', 'DLST', 'MCUB', 'TP53BP1', 'RAD50', 'XRCC6', 'PAXIP1', 'DLAT', 'PDHX', 'SETDB2', 'PDHB', 'H2AX', 'DDRGK1', 'MDC1', 'PMPCA', 'PHB2', 'MCAT', 'SDHD', 'DBT', 'MCU', 'SIL1', 'BCKDHB', 'PDHA1', 'SUMO1', 'RPA1', 'FLYWCH1', 'BLM', 'PIAS1', 'MRE11', 'VDAC1', 'AFG3L2', 'ISCU', 'GPD1', 'PDK1', 'NSUN6', 'SDHB', 'NFS1', 'NDUFAB1', 'BRCA1', 'SDHA', 'MICU1', 'DLD', 'PDK2', 'MBD1', 'NDUFV3', 'TRIM28', 'BARD1', 'MICU2', 'MFN1', 'PEPD', 'PMPCB', 'UBA5', 'OGDH', 'PHB1', 'BCKDHA']
634	HPA	HPA:0440000	skeletal muscle	0.0138457059105732	True	skeletal muscle	5898	83	62	11006	0.7469879518072289	0.0105120379789759	query_1	['HPA:0000000']	['SNX6', 'PDK4', 'GCSH', 'PPM1K', 'SNX1', 'LYRM4', 'ADSL', 'MAIP1', 'DLST', 'MCUB', 'TP53BP1', 'RAD50', 'XRCC6', 'PAXIP1', 'DLAT', 'PDHX', 'SETDB2', 'PDHB', 'H2AX', 'DDRGK1', 'MDC1', 'PMPCA', 'PHB2', 'MCAT', 'SDHD', 'DBT', 'MCU', 'SIL1', 'BCKDHB', 'PDHA1', 'SUMO1', 'RPA1', 'FLYWCH1', 'BLM', 'PIAS1', 'MRE11', 'VDAC1', 'AFG3L2', 'ISCU', 'GPD1', 'PDK1', 'NSUN6', 'SDHB', 'NFS1', 'NDUFAB1', 'BRCA1', 'SDHA', 'MICU1', 'DLD', 'PDK2', 'MBD1', 'NDUFV3', 'TRIM28', 'BARD1', 'MICU2', 'MFN1', 'PEPD', 'PMPCB', 'UBA5', 'OGDH', 'PHB1', 'BCKDHA']
635	GO:BP	GO:0051276	chromosome organization	0.0139688648355089	True	"""A process that is carried out at the cellular level that results in the assembly, arrangement of constituent parts, or disassembly of chromosomes, structures composed of a very long molecule of DNA and associated proteins that carries hereditary information. This term covers covalent modifications at the molecular level as well as spatial relationships among the major components of a chromosome."" [GOC:ai, GOC:dph, GOC:jl, GOC:mah]"	634	96	13	21110	0.1354166666666666	0.0205047318611987	query_1	['GO:0006996']	['NBN', 'ATF7IP', 'RAD50', 'XRCC6', 'SETDB2', 'PHB2', 'BRCA2', 'SETDB1', 'RPA1', 'BLM', 'MRE11', 'RAD51', 'TRIM28']
636	GO:MF	GO:0140657	ATP-dependent activity	0.0142383051756991	True	"""A molecular function characterized by the coupling of ATP hydrolysis to other steps of a reaction mechanism to make the reaction energetically favorable, for example to catalyze a reaction or drive transport against a concentration gradient."" [PMID:24878343, PMID:25750732, PMID:32933017, PMID:33818025, PMID:33873056, PMID:33988324]"	575	97	12	20195	0.1237113402061855	0.0208695652173913	query_1	['GO:0003674']	['SPG7', 'ATF7IP', 'HSPA9', 'RAD50', 'XRCC6', 'HSPD1', 'BLM', 'MRE11', 'RAD51', 'AFG3L2', 'MOCS3', 'UBA5']
637	HPA	HPA:0510000	soft tissue 2	0.014305260577957	True	soft tissue 2	5198	83	57	11006	0.6867469879518072	0.010965756060023	query_1	['HPA:0000000']	['RBBP8', 'PDK4', 'GCSH', 'SNX1', 'LYRM4', 'ADSL', 'CDK5RAP3', 'ATF7IP', 'DLST', 'HSPA9', 'TP53BP1', 'RAD50', 'UBAC2', 'XRCC6', 'PAXIP1', 'SETDB2', 'H2AX', 'MDC1', 'PMPCA', 'PHB2', 'MCAT', 'SDHD', 'DBT', 'MCU', 'SIL1', 'BCKDK', 'BCKDHB', 'PDHA1', 'SUMO1', 'HSPD1', 'RPA1', 'ARL14EP', 'FLYWCH1', 'PIAS1', 'MRE11', 'VDAC1', 'AFG3L2', 'ISCU', 'GPD1', 'PDK1', 'NSUN6', 'SDHB', 'NFS1', 'BRCA1', 'SDHA', 'MICU1', 'STAT5A', 'DLD', 'NDUFV3', 'TRIM28', 'MFN1', 'PEPD', 'UBA5', 'OGDH', 'PHB1', 'UFM1', 'BCKDHA']
638	WP	WP:WP111	Electron transport chain: OXPHOS system in mitochondria	0.0150400375149347	True	Electron transport chain: OXPHOS system in mitochondria	103	60	6	8133	0.1	0.058252427184466	query_1	['WP:000000']	['SDHD', 'SDHB', 'NDUFAB1', 'SDHA', 'SDHC', 'NDUFV3']
639	HP	HP:0002666	Pheochromocytoma	0.0150711202240353	True	Pheochromocytomas (also known as chromaffin tumors) produce, store, and secrete catecholamines. Pheochromocytomas usually originate from the adrenal medulla but may also develop from chromaffin cells in or about sympathetic ganglia. A common symptom of pheochromocytoma is hypertension owing to release of catecholamines.	28	54	5	4851	0.0925925925925925	0.1785714285714285	query_1	['HP:0100634']	['DLST', 'SDHD', 'SDHB', 'SDHA', 'SDHC']
640	HPA	HPA:0440342	skeletal muscle; myocytes[≥Medium]	0.0153291126357154	True	skeletal muscle; myocytes[≥Medium]	3784	83	46	11006	0.5542168674698795	0.0121564482029598	query_1	['HPA:0440341']	['SNX6', 'PDK4', 'GCSH', 'PPM1K', 'LYRM4', 'ADSL', 'MAIP1', 'DLST', 'TP53BP1', 'RAD50', 'XRCC6', 'PAXIP1', 'PDHX', 'SETDB2', 'PDHB', 'H2AX', 'MDC1', 'PMPCA', 'PHB2', 'SDHD', 'MCU', 'SIL1', 'BCKDHB', 'PDHA1', 'SUMO1', 'RPA1', 'FLYWCH1', 'BLM', 'PIAS1', 'MRE11', 'VDAC1', 'ISCU', 'GPD1', 'SDHB', 'NFS1', 'SDHA', 'MICU1', 'PDK2', 'NDUFV3', 'TRIM28', 'BARD1', 'MICU2', 'MFN1', 'OGDH', 'PHB1', 'BCKDHA']
641	GO:BP	GO:0042180	cellular ketone metabolic process	0.0153951482422013	True	"""The chemical reactions and pathways involving any of a class of organic compounds that contain the carbonyl group, CO, and in which the carbonyl group is bonded only to carbon atoms, as carried out by individual cells. The general formula for a ketone is RCOR, where R and R are alkyl or aryl groups."" [GOC:jl, ISBN:0787650153]"	216	96	8	21110	0.0833333333333333	0.037037037037037	query_1	['GO:0044237', 'GO:0044281', 'GO:0071704']	['PDK4', 'BCKDK', 'PDK3', 'GPD1', 'PDK1', 'BRCA1', 'PDK2', 'STAT5B']
642	GO:BP	GO:2000001	regulation of DNA damage checkpoint	0.0154864515031069	True	"""Any process that modulates the frequency, rate or extent of a DNA damage checkpoint."" [GOC:obol]"	27	96	4	21110	0.0416666666666666	0.1481481481481481	query_1	['GO:0000077', 'GO:0080135', 'GO:1901976']	['BRCA2', 'RAD51', 'BRCA1', 'BARD1']
643	HPA	HPA:0151303	duodenum; enterocytes[High]	0.015530492387239	True	duodenum; enterocytes[High]	235	83	9	11006	0.108433734939759	0.0382978723404255	query_1	['HPA:0151302']	['CDK5RAP3', 'OTC', 'TP53BP1', 'RAD50', 'PHB2', 'SIL1', 'HSPD1', 'GPD1', 'TRIM28']
644	HPA	HPA:0090181	cerebellum; cells in granular layer[≥Low]	0.0157745471522182	True	cerebellum; cells in granular layer[≥Low]	4545	83	52	11006	0.6265060240963856	0.0114411441144114	query_1	['HPA:0090000']	['UBE2I', 'PDK4', 'GCSH', 'PPM1K', 'SNX1', 'LYRM4', 'ADSL', 'MAIP1', 'CDK5RAP3', 'DLST', 'HSPA9', 'RAD50', 'XRCC6', 'PAXIP1', 'DLAT', 'SETDB2', 'H2AX', 'MDC1', 'PMPCA', 'PHB2', 'SDHD', 'DBT', 'MCU', 'BCKDK', 'BCKDHB', 'PDHA1', 'RPA1', 'ARL14EP', 'FLYWCH1', 'BLM', 'PIAS1', 'MRE11', 'ISCU', 'GPD1', 'PDK1', 'SDHB', 'FAF2', 'CBX5', 'BRCA1', 'SDHA', 'MICU1', 'DLD', 'PDK2', 'MBD1', 'NDUFV3', 'TRIM28', 'MFN1', 'OGDH', 'PHB1', 'UFM1', 'STAT5B', 'BCKDHA']
645	HP	HP:0100615	Ovarian neoplasm	0.015780737130548	True	A tumor (abnormal growth of tissue) of the ovary.	72	54	7	4851	0.1296296296296296	0.0972222222222222	query_1	['HP:0000137', 'HP:0010785']	['NBN', 'RAD50', 'BRCA2', 'MRE11', 'RAD51', 'BRCA1', 'BARD1']
646	GO:MF	GO:0102040	fumarate reductase (menaquinone)	0.016309803255607	True	"""Catalysis of the reaction: fumarate + a menaquinol = succinate + a menaquinone."" [GOC:pz, PMID:11850430, RHEA:27834]"	2	97	2	20195	0.0206185567010309	1.0	query_1	['GO:0016635']	['SDHB', 'SDHA']
647	HPA	HPA:0461471	skin 1; lymphocytes[≥Low]	0.0163301851348937	True	skin 1; lymphocytes[≥Low]	712	83	16	11006	0.1927710843373494	0.0224719101123595	query_1	['HPA:0460000']	['GCSH', 'ADSL', 'RAD50', 'XRCC6', 'H2AX', 'PHB2', 'SUMO1', 'RPA1', 'VDAC1', 'SDHB', 'CBX5', 'SDHA', 'PDK2', 'NDUFV3', 'BARD1', 'PHB1']
648	HP	HP:0011443	Abnormality of coordination	0.0165161543354536	True	Abnormality of coordination	1118	54	27	4851	0.5	0.0241502683363148	query_1	['HP:0011442']	['SPG7', 'ADSL', 'OTC', 'RAD50', 'UBAC2', 'DLAT', 'PDHX', 'PDHB', 'PMPCA', 'SDHD', 'DBT', 'SIL1', 'BCKDHB', 'PDHA1', 'MRE11', 'RAD51', 'AFG3L2', 'ISCU', 'SDHB', 'SDHA', 'MICU1', 'SDHC', 'DLD', 'PMPCB', 'UBA5', 'OGDH', 'BCKDHA']
649	GO:CC	GO:0000152	nuclear ubiquitin ligase complex	0.0165588001424646	True	"""A ubiquitin ligase complex found in the nucleus."" [GOC:mah]"	48	97	4	22122	0.0412371134020618	0.0833333333333333	query_1	['GO:0000151', 'GO:0140513']	['BRCA2', 'RAD51', 'BRCA1', 'BARD1']
650	HP	HP:0500184	Abnormal CSF amino acid concentration	0.0166385586877969	True	Any deviation from the normal concentration of amino acids in the cerebrospinal fluid.	14	54	4	4851	0.074074074074074	0.2857142857142857	query_1	['HP:0500183']	['DLAT', 'PDHX', 'PDHA1', 'DLD']
651	HP	HP:0003001	Glomus jugular tumor	0.0168948846236417	True	Glomus jugular tumor	5	54	3	4851	0.0555555555555555	0.6	query_1	['HP:0002864']	['SDHD', 'SDHB', 'SDHC']
652	HPA	HPA:0130053	colon; glandular cells[High]	0.0170331609547367	True	colon; glandular cells[High]	2416	83	34	11006	0.4096385542168674	0.0140728476821192	query_1	['HPA:0130052']	['PDK4', 'GCSH', 'SNX1', 'ADSL', 'MAIP1', 'HSPA9', 'XRCC6', 'PAXIP1', 'PDHX', 'SETDB2', 'PDHB', 'MDC1', 'PMPCA', 'MCU', 'BCKDK', 'FLYWCH1', 'BLM', 'PIAS1', 'MRE11', 'AFG3L2', 'ISCU', 'SDHB', 'FAF2', 'NDUFAB1', 'MICU1', 'DLD', 'NDUFV3', 'MFN1', 'PEPD', 'UBA5', 'OGDH', 'PHB1', 'UFM1', 'BCKDHA']
653	GO:MF	GO:0043167	ion binding	0.01713106553858	True	"""Binding to an ion, a charged atoms or groups of atoms."" [GOC:jl]"	6120	97	49	20195	0.5051546391752577	0.0080065359477124	query_1	['GO:0005488']	['UBE2I', 'PDK4', 'SPG7', 'PPM1K', 'OTC', 'HSPA9', 'RAD50', 'ZNF45', 'ZNF350', 'XRCC6', 'SETDB2', 'PMPCA', 'SDHD', 'DBT', 'SETDB1', 'BCKDK', 'HSPD1', 'RPA1', 'PDK3', 'FLYWCH1', 'BLM', 'PIAS1', 'MRE11', 'VDAC1', 'RAD51', 'AFG3L2', 'HDAC6', 'MOCS3', 'ISCU', 'PDK1', 'SDHB', 'NFS1', 'NDUFAB1', 'BRCA1', 'SDHA', 'MICU1', 'SDHC', 'DLD', 'PDK2', 'MBD1', 'TRIM28', 'BARD1', 'MICU2', 'MFN1', 'PEPD', 'PMPCB', 'UBA5', 'OGDH', 'BCKDHA']
654	HP	HP:0002395	Lower limb hyperreflexia	0.017305896108852	True	Lower limb hyperreflexia	73	54	7	4851	0.1296296296296296	0.0958904109589041	query_1	['HP:0001347']	['SPG7', 'LYRM4', 'DLAT', 'SDHD', 'AFG3L2', 'SDHB', 'SDHA']
655	HPA	HPA:0461461	skin 1; langerhans cells[≥Low]	0.0174545249296528	True	skin 1; langerhans cells[≥Low]	716	83	16	11006	0.1927710843373494	0.0223463687150838	query_1	['HPA:0460000']	['ADSL', 'RAD50', 'XRCC6', 'H2AX', 'PHB2', 'SUMO1', 'HSPD1', 'RPA1', 'VDAC1', 'RAD51', 'SDHB', 'CBX5', 'PDK2', 'NDUFV3', 'BARD1', 'PHB1']
656	HPA	HPA:0170253	endometrium 2; cells in endometrial stroma[High]	0.0176990125523545	True	endometrium 2; cells in endometrial stroma[High]	359	83	11	11006	0.1325301204819277	0.0306406685236768	query_1	['HPA:0170252']	['GCSH', 'HSPA9', 'TP53BP1', 'PAXIP1', 'SETDB2', 'BLM', 'PIAS1', 'MRE11', 'TRIM28', 'PHB1', 'BCKDHA']
657	KEGG	KEGG:05020	Prion disease	0.0178158132123493	True	Prion disease	272	63	9	8161	0.1428571428571428	0.0330882352941176	query_1	['KEGG:00000']	['PPIF', 'SDHD', 'MCU', 'VDAC1', 'SDHB', 'NDUFAB1', 'SDHA', 'SDHC', 'NDUFV3']
658	HPA	HPA:0471391	skin 2; cells in basal layer[≥Low]	0.0179752048636916	True	skin 2; cells in basal layer[≥Low]	963	83	19	11006	0.2289156626506024	0.0197300103842159	query_1	['HPA:0470000']	['GCSH', 'ADSL', 'RAD50', 'XRCC6', 'PDHB', 'H2AX', 'PHB2', 'SUMO1', 'HSPD1', 'RPA1', 'VDAC1', 'RAD51', 'SDHB', 'CBX5', 'SDHA', 'PDK2', 'NDUFV3', 'BARD1', 'PHB1']
659	GO:BP	GO:0033522	histone H2A ubiquitination	0.0180046786896782	True	"""The modification of histone H2A by addition of one or more ubiquitin groups."" [GOC:bf, GOC:mah, PMID:15509584, PMID:16473935, PMID:18430235]"	28	96	4	21110	0.0416666666666666	0.1428571428571428	query_1	['GO:0016574']	['BRCA2', 'RAD51', 'BRCA1', 'BARD1']
660	HP	HP:0001251	Ataxia	0.0180364392144391	True	Cerebellar ataxia refers to ataxia due to dysfunction of the cerebellum. This causes a variety of elementary neurological deficits including asynergy (lack of coordination between muscles, limbs and joints), dysmetria (lack of ability to judge distances that can lead to under- or overshoot in grasping movements), and dysdiadochokinesia (inability to perform rapid movements requiring antagonizing muscle groups to be switched on and off repeatedly).	984	54	25	4851	0.4629629629629629	0.0254065040650406	query_1	['HP:0011443']	['SPG7', 'ADSL', 'OTC', 'RAD50', 'UBAC2', 'DLAT', 'PDHX', 'PDHB', 'PMPCA', 'SDHD', 'DBT', 'SIL1', 'BCKDHB', 'PDHA1', 'MRE11', 'AFG3L2', 'SDHB', 'SDHA', 'MICU1', 'SDHC', 'DLD', 'PMPCB', 'UBA5', 'OGDH', 'BCKDHA']
661	HP	HP:0030670	Hamartoma of the orbital region	0.018057744339223	True	A hamartoma (disordered proliferation of mature tissues) which can originate from any tissue of the orbital region.	29	54	5	4851	0.0925925925925925	0.1724137931034483	query_1	['HP:0000315', 'HP:0010566']	['DLST', 'SDHD', 'SDHB', 'SDHA', 'SDHC']
662	HP	HP:0010568	Hamartoma of the eye	0.018057744339223	True	A hamartoma (disordered proliferation of mature tissues) which can originate from any tissue of the eye.	29	54	5	4851	0.0925925925925925	0.1724137931034483	query_1	['HP:0030670', 'HP:0100012']	['DLST', 'SDHD', 'SDHB', 'SDHA', 'SDHC']
663	HPA	HPA:0550053	stomach 2; glandular cells[High]	0.0187499067981674	True	stomach 2; glandular cells[High]	2427	83	34	11006	0.4096385542168674	0.0140090646889163	query_1	['HPA:0550052']	['GCSH', 'MAIP1', 'CDK5RAP3', 'HSPA9', 'RAD50', 'XRCC6', 'PDHX', 'SETDB2', 'H2AX', 'MCAT', 'SDHD', 'SIL1', 'BCKDK', 'BCKDHB', 'PDHA1', 'RPA1', 'FLYWCH1', 'BLM', 'PIAS1', 'MRE11', 'AFG3L2', 'ISCU', 'FAF2', 'NDUFAB1', 'SDHA', 'MICU1', 'DLD', 'PDK2', 'NDUFV3', 'TRIM28', 'UBA5', 'OGDH', 'UFM1', 'BCKDHA']
664	HPA	HPA:0130201	colon; endothelial cells[≥Low]	0.0200369688942017	True	colon; endothelial cells[≥Low]	5667	83	60	11006	0.7228915662650602	0.0105876124933827	query_1	['HPA:0130000']	['RBBP8', 'SNX6', 'PDK4', 'GCSH', 'SNX1', 'LYRM4', 'ADSL', 'CDK5RAP3', 'NBN', 'OTC', 'ATF7IP', 'DLST', 'HSPA9', 'MCUB', 'RAD50', 'XRCC6', 'PAXIP1', 'PDHX', 'SETDB2', 'PDHB', 'H2AX', 'MDC1', 'PMPCA', 'MCAT', 'SDHD', 'DBT', 'MCU', 'BCKDK', 'BCKDHB', 'PDHA1', 'SUMO1', 'HSPD1', 'RPA1', 'ARL14EP', 'FLYWCH1', 'BLM', 'PIAS1', 'MRE11', 'AFG3L2', 'ISCU', 'PDK1', 'NSUN6', 'SDHB', 'FAF2', 'NFS1', 'NDUFAB1', 'BRCA1', 'SDHA', 'MICU1', 'STAT5A', 'DLD', 'NDUFV3', 'TRIM28', 'MICU2', 'MFN1', 'PEPD', 'OGDH', 'UFM1', 'STAT5B', 'BCKDHA']
665	GO:BP	GO:0002377	immunoglobulin production	0.0201395550415565	True	"""The appearance of immunoglobulin due to biosynthesis or secretion following a cellular stimulus, resulting in an increase in its intracellular or extracellular levels."" [GOC:add, ISBN:0781735149]"	105	96	6	21110	0.0625	0.0571428571428571	query_1	['GO:0002440']	['NBN', 'TP53BP1', 'PAXIP1', 'PHB2', 'HSPD1', 'PHB1']
666	GO:BP	GO:0035966	response to topologically incorrect protein	0.0203124473941283	True	"""Any process that results in a change in state or activity of a cell or an organism (in terms of movement, secretion, enzyme production, gene expression, etc.) as a result of a protein that is not folded in its correct three-dimensional structure."" [GOC:bf]"	160	96	7	21110	0.0729166666666666	0.04375	query_1	['GO:0006950', 'GO:0010033']	['CDK5RAP3', 'HSPA9', 'DDRGK1', 'UFL1', 'HSPD1', 'HDAC6', 'FAF2']
667	HPA	HPA:0380511	placenta; decidual cells[≥Low]	0.0205724844130695	True	placenta; decidual cells[≥Low]	4847	83	54	11006	0.6506024096385542	0.0111409119042706	query_1	['HPA:0380000']	['RBBP8', 'UBE2I', 'PDK4', 'GCSH', 'LYRM4', 'ADSL', 'NBN', 'ATF7IP', 'HSPA9', 'MCUB', 'TP53BP1', 'RAD50', 'UBAC2', 'XRCC6', 'DLAT', 'SETDB2', 'PDHB', 'UFL1', 'MDC1', 'PMPCA', 'PHB2', 'MCAT', 'DBT', 'SIL1', 'BCKDK', 'PDHA1', 'SUMO1', 'HSPD1', 'RPA1', 'ARL14EP', 'BLM', 'PIAS1', 'MRE11', 'VDAC1', 'AFG3L2', 'PDK1', 'NSUN6', 'SDHB', 'FAF2', 'NFS1', 'NDUFAB1', 'BRCA1', 'SDHA', 'DLD', 'PDK2', 'NDUFV3', 'TRIM28', 'MFN1', 'PEPD', 'UBA5', 'OGDH', 'PHB1', 'STAT5B', 'BCKDHA']
668	HPA	HPA:0090191	cerebellum; cells in molecular layer[≥Low]	0.020580016689541	True	cerebellum; cells in molecular layer[≥Low]	4454	83	51	11006	0.6144578313253012	0.0114503816793893	query_1	['HPA:0090000']	['PDK4', 'GCSH', 'PPM1K', 'SNX1', 'LYRM4', 'ADSL', 'MAIP1', 'CDK5RAP3', 'NBN', 'ATF7IP', 'DLST', 'HSPA9', 'RAD50', 'XRCC6', 'PAXIP1', 'DLAT', 'SETDB2', 'H2AX', 'MDC1', 'PMPCA', 'PHB2', 'MCU', 'BCKDK', 'BCKDHB', 'PDHA1', 'RPA1', 'ARL14EP', 'FLYWCH1', 'BLM', 'PIAS1', 'MRE11', 'HDAC6', 'ISCU', 'GPD1', 'PDK1', 'SDHB', 'FAF2', 'CBX5', 'NDUFAB1', 'BRCA1', 'SDHA', 'MICU1', 'DLD', 'PDK2', 'MBD1', 'NDUFV3', 'TRIM28', 'OGDH', 'PHB1', 'UFM1', 'BCKDHA']
669	GO:MF	GO:0016740	transferase activity	0.021217320785382	True	"""Catalysis of the transfer of a group, e.g. a methyl group, glycosyl group, acyl group, phosphorus-containing, or other groups, from one compound (generally regarded as the donor) to another compound (generally regarded as the acceptor). Transferase is the systematic name for any enzyme of EC class 2."" [ISBN:0198506732]"	2341	97	26	20195	0.268041237113402	0.0111063648013669	query_1	['GO:0003824']	['UBE2I', 'PDK4', 'GCSH', 'OTC', 'DLST', 'TALDO1', 'DLAT', 'PDHX', 'SETDB2', 'UFL1', 'MCAT', 'METTL21C', 'DBT', 'BRCA2', 'SETDB1', 'BCKDK', 'PDK3', 'PIAS1', 'MOCS3', 'PDK1', 'NSUN6', 'NFS1', 'BRCA1', 'PDK2', 'TRIM28', 'BARD1']
670	GO:BP	GO:0006754	ATP biosynthetic process	0.0212701896443952	True	"""The chemical reactions and pathways resulting in the formation of ATP, adenosine 5'-triphosphate, a universally important coenzyme and enzyme regulator."" [GOC:go_curators, ISBN:0198506732]"	106	96	6	21110	0.0625	0.0566037735849056	query_1	['GO:0009152', 'GO:0009206', 'GO:0046034']	['SDHD', 'SDHB', 'NDUFAB1', 'SDHA', 'SDHC', 'NDUFV3']
671	GO:BP	GO:0006520	amino acid metabolic process	0.0213661525837658	True	"""The chemical reactions and pathways involving amino acids, carboxylic acids containing one or more amino groups."" [ISBN:0198506732]"	299	96	9	21110	0.09375	0.0301003344481605	query_1	['GO:0019752', 'GO:0044238', 'GO:1901564']	['GCSH', 'OTC', 'DLST', 'DBT', 'BCKDK', 'BCKDHB', 'DLD', 'PEPD', 'BCKDHA']
672	HPA	HPA:0090000	cerebellum	0.0215612715165322	True	cerebellum	7193	83	70	11006	0.8433734939759037	0.0097316835812595	query_1	['HPA:0000000']	['RBBP8', 'UBE2I', 'PDK4', 'GCSH', 'PPM1K', 'SNX1', 'LYRM4', 'ADSL', 'MAIP1', 'CDK5RAP3', 'NBN', 'ATF7IP', 'DLST', 'HSPA9', 'TP53BP1', 'RAD50', 'XRCC6', 'PAXIP1', 'DLAT', 'PDHX', 'SETDB2', 'PDHB', 'H2AX', 'DDRGK1', 'MDC1', 'PMPCA', 'PHB2', 'MCAT', 'SDHD', 'DBT', 'MCU', 'BCKDK', 'BCKDHB', 'PDHA1', 'SUMO1', 'HSPD1', 'RPA1', 'ARL14EP', 'FLYWCH1', 'BLM', 'PIAS1', 'MRE11', 'VDAC1', 'AFG3L2', 'HDAC6', 'ISCU', 'GPD1', 'PDK1', 'NSUN6', 'SDHB', 'FAF2', 'NFS1', 'CBX5', 'NDUFAB1', 'BRCA1', 'SDHA', 'MICU1', 'DLD', 'PDK2', 'MBD1', 'NDUFV3', 'TRIM28', 'BARD1', 'MICU2', 'MFN1', 'OGDH', 'PHB1', 'UFM1', 'STAT5B', 'BCKDHA']
673	HPA	HPA:0160253	endometrium 1; cells in endometrial stroma[High]	0.0218311981986369	True	endometrium 1; cells in endometrial stroma[High]	434	83	12	11006	0.144578313253012	0.0276497695852534	query_1	['HPA:0160252']	['GCSH', 'ADSL', 'HSPA9', 'TP53BP1', 'SETDB2', 'FLYWCH1', 'BLM', 'PIAS1', 'MRE11', 'NDUFV3', 'TRIM28', 'PHB1']
674	GO:BP	GO:0009725	response to hormone	0.0220007531205657	True	"""Any process that results in a change in state or activity of a cell or an organism (in terms of movement, secretion, enzyme production, gene expression, etc.) as a result of a hormone stimulus."" [GOC:jl]"	875	96	15	21110	0.15625	0.0171428571428571	query_1	['GO:0009719', 'GO:0010033']	['PDK4', 'OTC', 'DDRGK1', 'UFL1', 'PHB2', 'METTL21C', 'BCKDHB', 'HDAC6', 'BRCA1', 'STAT5A', 'PDK2', 'UBA5', 'PHB1', 'UFM1', 'STAT5B']
675	GO:CC	GO:1902495	transmembrane transporter complex	0.0223548366945096	True	"""A transmembrane protein complex which enables the transfer of a substance from one side of a membrane to the other."" [GOC:bhm, GOC:TermGenie, PMID:18024586]"	409	97	9	22122	0.0927835051546391	0.0220048899755501	query_1	['GO:0098796', 'GO:1990351']	['MCUB', 'MCU', 'SUMO1', 'NDUFAB1', 'MICU1', 'SMDT1', 'NDUFV3', 'MICU2', 'ABHD6']
676	HP	HP:0500183	Abnormal CSF carboxylic acid concentration	0.022502037736578	True	Any deviation from the normal concentration of a carboxylic acid in the cerebrospinal fluid.	15	54	4	4851	0.074074074074074	0.2666666666666666	query_1	['HP:0025454']	['DLAT', 'PDHX', 'PDHA1', 'DLD']
677	HP	HP:0000022	Abnormal male internal genitalia morphology	0.0226324139892199	True	An abnormality of the male internal genitalia.	76	54	7	4851	0.1296296296296296	0.0921052631578947	query_1	['HP:0000812', 'HP:0010461']	['NBN', 'RAD50', 'BRCA2', 'MRE11', 'RAD51', 'BRCA1', 'BARD1']
678	HPA	HPA:0570813	testis; spermatogonia cells[High]	0.0227924798455704	True	testis; spermatogonia cells[High]	1338	83	23	11006	0.2771084337349397	0.0171898355754858	query_1	['HPA:0570812']	['ADSL', 'DLST', 'HSPA9', 'TP53BP1', 'RAD50', 'XRCC6', 'DLAT', 'SETDB2', 'H2AX', 'PMPCA', 'PHB2', 'BCKDK', 'SUMO1', 'HSPD1', 'RPA1', 'PIAS1', 'MRE11', 'SDHB', 'DLD', 'PDK2', 'TRIM28', 'OGDH', 'PHB1']
679	GO:BP	GO:0030522	intracellular receptor signaling pathway	0.0231436605467368	True	"""The series of molecular signals initiated by a ligand binding to a receptor located within a cell."" [GOC:bf, GOC:mah]"	302	96	9	21110	0.09375	0.0298013245033112	query_1	['GO:0007165']	['DDRGK1', 'UFL1', 'PHB2', 'PDK3', 'HDAC6', 'BRCA1', 'UBA5', 'PHB1', 'UFM1']
680	KEGG	KEGG:05208	Chemical carcinogenesis - reactive oxygen species	0.0231592016417141	True	Chemical carcinogenesis - reactive oxygen species	222	63	8	8161	0.1269841269841269	0.036036036036036	query_1	['KEGG:00000']	['PPIF', 'SDHD', 'VDAC1', 'SDHB', 'NDUFAB1', 'SDHA', 'SDHC', 'NDUFV3']
681	HP	HP:0011792	Neoplasm by histology	0.023915380358633	True	Neoplasm categorized according to type of histological abnormality.	350	54	14	4851	0.2592592592592592	0.04	query_1	['HP:0002664']	['NBN', 'DLST', 'RAD50', 'SDHD', 'BRCA2', 'BLM', 'MRE11', 'RAD51', 'SDHB', 'BRCA1', 'SDHA', 'SDHC', 'TRIM28', 'BARD1']
682	TF	TF:M11533	Factor: E2F-1; motif: NTTTTGGCGCCAWWWN	0.0241230397713294	True	Factor: E2F-1; motif: NTTTTGGCGCCAWWWN	13421	97	84	20011	0.865979381443299	0.006258848073914	query_1	['TF:M00000']	['PPIF', 'RBBP8', 'SNX6', 'UBE2I', 'PDK4', 'GCSH', 'SPG7', 'SNX1', 'LYRM4', 'MAIP1', 'CDK5RAP3', 'NBN', 'ATF7IP', 'DLST', 'HSPA9', 'MCUB', 'TP53BP1', 'UBAC2', 'ZNF350', 'XRCC6', 'PAXIP1', 'DLAT', 'PDHX', 'SETDB2', 'PDHB', 'H2AX', 'DDRGK1', 'UFL1', 'MDC1', 'PMPCA', 'MCAT', 'METTL21C', 'SDHD', 'DBT', 'BRCA2', 'MCU', 'SIL1', 'SETDB1', 'BCKDK', 'CDNF', 'BCKDHB', 'PDHA1', 'SUMO1', 'HSPD1', 'RPA1', 'PDK3', 'FLYWCH1', 'BLM', 'PIAS1', 'MRE11', 'VDAC1', 'RAD51', 'AFG3L2', 'HDAC6', 'MOCS3', 'GPD1', 'PDK1', 'NSUN6', 'SDHB', 'FAF2', 'NFS1', 'CBX5', 'BRCA1', 'SDHA', 'MICU1', 'STAT5A', 'SMDT1', 'SDHC', 'DLD', 'PDK2', 'MBD1', 'NDUFV3', 'TRIM28', 'BARD1', 'MFN1', 'ABHD6', 'PEPD', 'PMPCB', 'UBA5', 'OGDH', 'PHB1', 'UFM1', 'STAT5B', 'BCKDHA']
683	REAC	REAC:R-HSA-9663199	Defective DNA double strand break response due to BRCA1 loss of function	0.0241492173238665	True	Defective DNA double strand break response due to BRCA1 loss of function	2	84	2	10790	0.0238095238095238	1.0	query_1	['REAC:R-HSA-9675136']	['BRCA1', 'BARD1']
684	REAC	REAC:R-HSA-9699150	Defective DNA double strand break response due to BARD1 loss of function	0.0241492173238665	True	Defective DNA double strand break response due to BARD1 loss of function	2	84	2	10790	0.0238095238095238	1.0	query_1	['REAC:R-HSA-9675136']	['BRCA1', 'BARD1']
685	GO:BP	GO:0005975	carbohydrate metabolic process	0.0248311217023074	True	"""The chemical reactions and pathways involving carbohydrates, any of a group of organic compounds based of the general formula Cx(H2O)y."" [GOC:mah, ISBN:0198506732]"	569	96	12	21110	0.125	0.0210896309314587	query_1	['GO:0044238', 'GO:0071704']	['PDK4', 'TALDO1', 'DLAT', 'PDHA2', 'PDHB', 'BCKDK', 'PDHA1', 'PDK3', 'GPD1', 'PDK1', 'PDK2', 'OGDH']
686	HP	HP:0008062	Aplasia/Hypoplasia affecting the anterior segment of the eye	0.0248851426431008	True	Absence or underdevelopment of the anterior segment of the eye.	140	54	9	4851	0.1666666666666666	0.0642857142857142	query_1	['HP:0007700', 'HP:0008056']	['DLST', 'SDHD', 'BRCA2', 'RAD51', 'SDHB', 'BRCA1', 'SDHA', 'SDHC', 'TRIM28']
687	HPA	HPA:0340452	ovary; follicle cells[≥Medium]	0.0250772780515397	True	ovary; follicle cells[≥Medium]	2246	83	32	11006	0.3855421686746988	0.0142475512021371	query_1	['HPA:0340451']	['PDK4', 'GCSH', 'PPM1K', 'LYRM4', 'ADSL', 'CDK5RAP3', 'NBN', 'DLST', 'HSPA9', 'XRCC6', 'SETDB2', 'MDC1', 'PMPCA', 'PHB2', 'MCU', 'SIL1', 'BCKDHB', 'PDHA1', 'MRE11', 'RAD51', 'ISCU', 'SDHB', 'NFS1', 'BRCA1', 'DLD', 'NDUFV3', 'TRIM28', 'MFN1', 'UBA5', 'OGDH', 'PHB1', 'UFM1']
688	HPA	HPA:0610833	urinary bladder; urothelial cells[High]	0.0252418864011491	True	urinary bladder; urothelial cells[High]	2037	83	30	11006	0.3614457831325301	0.0147275405007363	query_1	['HPA:0610832']	['PDK4', 'GCSH', 'ADSL', 'HSPA9', 'TP53BP1', 'RAD50', 'XRCC6', 'SETDB2', 'MDC1', 'PMPCA', 'MCU', 'SUMO1', 'RPA1', 'FLYWCH1', 'BLM', 'PIAS1', 'MRE11', 'VDAC1', 'AFG3L2', 'ISCU', 'SDHB', 'SDHA', 'DLD', 'PDK2', 'TRIM28', 'MFN1', 'OGDH', 'PHB1', 'UFM1', 'BCKDHA']
689	GO:BP	GO:0009205	purine ribonucleoside triphosphate metabolic process	0.0258340710100022	True	"""The chemical reactions and pathways involving purine ribonucleoside triphosphate, a compound consisting of a purine base linked to a ribose sugar esterified with triphosphate on the sugar."" [GOC:go_curators, ISBN:0198506732]"	166	96	7	21110	0.0729166666666666	0.0421686746987951	query_1	['GO:0009144', 'GO:0009199']	['SDHD', 'SDHB', 'NDUFAB1', 'SDHA', 'SDHC', 'NDUFV3', 'MFN1']
690	HP	HP:0003220	Abnormality of chromosome stability	0.0259025569348052	True	A type of chromosomal aberration characterised by reduced resistance of chromosomes to change or deterioration.	52	54	6	4851	0.1111111111111111	0.1153846153846153	query_1	['HP:0011017']	['NBN', 'RAD50', 'BRCA2', 'BLM', 'RAD51', 'BRCA1']
691	HP	HP:0007378	Neoplasm of the gastrointestinal tract	0.0259632546572422	True	A tumor (abnormal growth of tissue) of the gastrointestinal tract.	305	54	13	4851	0.2407407407407407	0.0426229508196721	query_1	['HP:0011024', 'HP:0011793']	['NBN', 'RAD50', 'SDHD', 'BRCA2', 'BLM', 'MRE11', 'RAD51', 'SDHB', 'BRCA1', 'SDHA', 'SDHC', 'TRIM28', 'BARD1']
692	GO:BP	GO:0010390	histone monoubiquitination	0.027381056857332	True	"""The modification of histones by addition of a single ubiquitin group."" [PMID:17329563]"	31	96	4	21110	0.0416666666666666	0.1290322580645161	query_1	['GO:0006513', 'GO:0016574']	['BRCA2', 'RAD51', 'BRCA1', 'BARD1']
693	HPA	HPA:0290402	liver; hepatocytes[≥Medium]	0.0279790479952935	True	liver; hepatocytes[≥Medium]	3745	83	45	11006	0.5421686746987951	0.0120160213618157	query_1	['HPA:0290401']	['GCSH', 'ADSL', 'MAIP1', 'OTC', 'DLST', 'HSPA9', 'UBAC2', 'PDHX', 'SETDB2', 'H2AX', 'DDRGK1', 'UFL1', 'PMPCA', 'PHB2', 'MCAT', 'SDHD', 'SIL1', 'BCKDK', 'BCKDHB', 'PDHA1', 'HSPD1', 'PDK3', 'FLYWCH1', 'PIAS1', 'MRE11', 'VDAC1', 'ISCU', 'GPD1', 'NSUN6', 'SDHB', 'NFS1', 'NDUFAB1', 'SDHA', 'MICU1', 'DLD', 'NDUFV3', 'BARD1', 'MICU2', 'MFN1', 'PMPCB', 'OGDH', 'PHB1', 'UFM1', 'STAT5B', 'BCKDHA']
694	HPA	HPA:0340463	ovary; ovarian stroma cells[High]	0.028019322077963	True	ovary; ovarian stroma cells[High]	378	83	11	11006	0.1325301204819277	0.0291005291005291	query_1	['HPA:0340462']	['GCSH', 'HSPA9', 'XRCC6', 'PAXIP1', 'SETDB2', 'BLM', 'PIAS1', 'MRE11', 'TRIM28', 'PHB1', 'BCKDHA']
695	HPA	HPA:0100133	cerebral cortex; neuronal cells[High]	0.0281883603165724	True	cerebral cortex; neuronal cells[High]	1844	83	28	11006	0.3373493975903614	0.0151843817787418	query_1	['HPA:0100132']	['PDK4', 'GCSH', 'LYRM4', 'ADSL', 'MAIP1', 'HSPA9', 'TP53BP1', 'DLAT', 'SETDB2', 'H2AX', 'MDC1', 'PMPCA', 'MCU', 'SIL1', 'PDHA1', 'RPA1', 'FLYWCH1', 'BLM', 'PIAS1', 'MRE11', 'SDHB', 'NFS1', 'CBX5', 'NDUFAB1', 'NDUFV3', 'TRIM28', 'PMPCB', 'OGDH']
696	HPA	HPA:0461412	skin 1; cells in spinous layer[≥Medium]	0.0290094772824479	True	skin 1; cells in spinous layer[≥Medium]	592	83	14	11006	0.1686746987951807	0.0236486486486486	query_1	['HPA:0461411']	['GCSH', 'ADSL', 'RAD50', 'XRCC6', 'H2AX', 'PHB2', 'SUMO1', 'HSPD1', 'RPA1', 'VDAC1', 'RAD51', 'SDHB', 'NDUFV3', 'PHB1']
697	GO:BP	GO:0051726	regulation of cell cycle	0.0290286470956981	True	"""Any process that modulates the rate or extent of progression through the cell cycle."" [GOC:ai, GOC:dph, GOC:tb]"	1130	96	17	21110	0.1770833333333333	0.0150442477876106	query_1	['GO:0007049', 'GO:0050794']	['RBBP8', 'CDK5RAP3', 'NBN', 'TP53BP1', 'RAD50', 'PAXIP1', 'H2AX', 'DDRGK1', 'MDC1', 'PHB2', 'BRCA2', 'BLM', 'MRE11', 'RAD51', 'BRCA1', 'BARD1', 'STAT5B']
698	GO:BP	GO:0071407	cellular response to organic cyclic compound	0.0290428804194813	True	"""Any process that results in a change in state or activity of a cell (in terms of movement, secretion, enzyme production, gene expression, etc.) as a result of an organic cyclic compound stimulus."" [GOC:mah]"	578	96	12	21110	0.125	0.0207612456747404	query_1	['GO:0014070', 'GO:0071310']	['DDRGK1', 'UFL1', 'PHB2', 'METTL21C', 'BLM', 'RAD51', 'HDAC6', 'GPD1', 'BRCA1', 'UBA5', 'PHB1', 'UFM1']
699	HPA	HPA:0100000	cerebral cortex	0.0292798183637466	True	cerebral cortex	8096	83	75	11006	0.9036144578313252	0.0092638339920948	query_1	['HPA:0000000']	['RBBP8', 'UBE2I', 'PDK4', 'GCSH', 'PPM1K', 'SNX1', 'LYRM4', 'ADSL', 'MAIP1', 'CDK5RAP3', 'NBN', 'ATF7IP', 'DLST', 'HSPA9', 'TP53BP1', 'RAD50', 'UBAC2', 'XRCC6', 'PAXIP1', 'DLAT', 'PDHX', 'SETDB2', 'PDHB', 'H2AX', 'DDRGK1', 'MDC1', 'PMPCA', 'PHB2', 'MCAT', 'SDHD', 'DBT', 'MCU', 'SIL1', 'BCKDK', 'BCKDHB', 'PDHA1', 'SUMO1', 'HSPD1', 'RPA1', 'PDK3', 'ARL14EP', 'FLYWCH1', 'BLM', 'PIAS1', 'MRE11', 'VDAC1', 'AFG3L2', 'HDAC6', 'ISCU', 'GPD1', 'PDK1', 'NSUN6', 'SDHB', 'NFS1', 'CBX5', 'NDUFAB1', 'BRCA1', 'SDHA', 'MICU1', 'DLD', 'PDK2', 'MBD1', 'NDUFV3', 'TRIM28', 'BARD1', 'MICU2', 'MFN1', 'PEPD', 'PMPCB', 'UBA5', 'OGDH', 'PHB1', 'UFM1', 'STAT5B', 'BCKDHA']
700	HP	HP:0004354	Abnormal circulating carboxylic acid concentration	0.0298588142548449	True	Any deviation from the normal concentration of a carboxylic acid in the blood circulation.	309	54	13	4851	0.2407407407407407	0.0420711974110032	query_1	['HP:0032180']	['GCSH', 'PPM1K', 'OTC', 'TALDO1', 'PDHX', 'DBT', 'BCKDK', 'BCKDHB', 'PDHA1', 'NFS1', 'MICU1', 'DLD', 'BCKDHA']
701	GO:BP	GO:0009144	purine nucleoside triphosphate metabolic process	0.0313369473731331	True	"""The chemical reactions and pathways involving purine nucleoside triphosphate, a compound consisting of a purine base linked to a ribose or deoxyribose sugar esterified with triphosphate on the sugar."" [GOC:go_curators, ISBN:0198506732]"	171	96	7	21110	0.0729166666666666	0.0409356725146198	query_1	['GO:0009141']	['SDHD', 'SDHB', 'NDUFAB1', 'SDHA', 'SDHC', 'NDUFV3', 'MFN1']
702	HPA	HPA:0570811	testis; spermatogonia cells[≥Low]	0.031707132419502	True	testis; spermatogonia cells[≥Low]	2822	83	37	11006	0.4457831325301205	0.013111268603827	query_1	['HPA:0570000']	['SNX1', 'ADSL', 'MAIP1', 'ATF7IP', 'DLST', 'HSPA9', 'TP53BP1', 'RAD50', 'XRCC6', 'PAXIP1', 'DLAT', 'SETDB2', 'H2AX', 'MDC1', 'PMPCA', 'PHB2', 'DBT', 'BCKDK', 'SUMO1', 'HSPD1', 'RPA1', 'PIAS1', 'MRE11', 'RAD51', 'AFG3L2', 'HDAC6', 'SDHB', 'CBX5', 'STAT5A', 'DLD', 'PDK2', 'NDUFV3', 'TRIM28', 'BARD1', 'OGDH', 'PHB1', 'BCKDHA']
703	HPA	HPA:0340462	ovary; ovarian stroma cells[≥Medium]	0.0320265545188556	True	ovary; ovarian stroma cells[≥Medium]	2063	83	30	11006	0.3614457831325301	0.0145419292292777	query_1	['HPA:0340461']	['UBE2I', 'GCSH', 'NBN', 'HSPA9', 'TP53BP1', 'RAD50', 'XRCC6', 'PAXIP1', 'SETDB2', 'H2AX', 'MDC1', 'PHB2', 'SUMO1', 'RPA1', 'FLYWCH1', 'BLM', 'PIAS1', 'MRE11', 'ISCU', 'PDK1', 'SDHB', 'NFS1', 'CBX5', 'MICU1', 'PDK2', 'NDUFV3', 'TRIM28', 'OGDH', 'PHB1', 'BCKDHA']
704	HPA	HPA:0151343	duodenum; glands of Brunner[High]	0.0320777960473717	True	duodenum; glands of Brunner[High]	105	83	6	11006	0.072289156626506	0.0571428571428571	query_1	['HPA:0151342']	['TP53BP1', 'RAD50', 'PHB2', 'SIL1', 'HSPD1', 'TRIM28']
705	GO:CC	GO:0030905	retromer, tubulation complex	0.0322501939221235	True	"""The dimeric subcomplex of the retromer, believed to be peripherally associated with the membrane. This dimeric complex is responsible for remodelling endosomal membranes to form a tube-structure to which cargo molecules are selected for recycling. The budding yeast complex comprises Vps5p and Vps17p, and may contain multiple copies of a Vps5p/Vps17p dimer. The mammalian complex contains SNX1 or SNX2 dimerized with SNX5 or SNX6."" [GOC:bf, PMID:26220253, PMID:9700157]"	4	97	2	22122	0.0206185567010309	0.5	query_1	['GO:0030904', 'GO:0098796']	['SNX6', 'SNX1']
706	GO:CC	GO:0031436	BRCA1-BARD1 complex	0.0322501939221235	True	"""A heterodimeric complex comprising BRCA1 and BARD1, which possesses ubiquitin ligase activity and is involved in genome maintenance, possibly by functioning in surveillance for DNA damage."" [PMID:12787778]"	4	97	2	22122	0.0206185567010309	0.5	query_1	['GO:0000152']	['BRCA1', 'BARD1']
707	GO:CC	GO:0070532	BRCA1-B complex	0.0322501939221235	True	"""A protein complex that contains the BRCA1-BARD1 heterodimer, BACH1 and TopBP1, and binds to DNA during S phase at DNA damage sites."" [GOC:mah, PMID:16391231]"	4	97	2	22122	0.0206185567010309	0.5	query_1	['GO:0140513']	['BRCA1', 'BARD1']
708	HP	HP:0500231	Abnormal CSF pyruvate family amino acid concentration	0.0335233682507575	True	Any deviation from the normal concentration of pyruvate-family amino acids in the cerebrospinal fluid.	6	54	3	4851	0.0555555555555555	0.5	query_1	['HP:0500184']	['DLAT', 'PDHX', 'PDHA1']
709	HP	HP:0410066	Increased level of hippuric acid in urine	0.0335233682507575	True	An increase in the level of hippuric acid in the urine.	6	54	3	4851	0.0555555555555555	0.5	query_1	['HP:0031980']	['DBT', 'BCKDHB', 'BCKDHA']
710	HP	HP:0001686	Loss of voice	0.0335233682507575	True	Loss of voice	6	54	3	4851	0.0555555555555555	0.5	query_1	['HP:0001608']	['SDHD', 'SDHA', 'SDHC']
711	HP	HP:0031796	Recurrent	0.0335233682507575	True	Applies to a sign, symptom or manifestation that occurs multiple times separated by intervals in which the sign, symptom, or manifestation is not present.	6	54	3	4851	0.0555555555555555	0.5	query_1	['HP:0011008']	['DBT', 'BCKDHB', 'BCKDHA']
712	GO:BP	GO:0009199	ribonucleoside triphosphate metabolic process	0.0337939499682313	True	"""The chemical reactions and pathways involving a ribonucleoside triphosphate, a compound consisting of a nucleobase linked to a ribose sugar esterified with triphosphate on the sugar."" [GOC:go_curators, ISBN:0198506732]"	173	96	7	21110	0.0729166666666666	0.0404624277456647	query_1	['GO:0009141']	['SDHD', 'SDHB', 'NDUFAB1', 'SDHA', 'SDHC', 'NDUFV3', 'MFN1']
713	GO:BP	GO:0051561	positive regulation of mitochondrial calcium ion concentration	0.0348707614855911	True	"""Any process that increases the concentration of calcium ions in mitochondria."" [GOC:ai]"	11	96	3	21110	0.03125	0.2727272727272727	query_1	['GO:0051560']	['MCU', 'MICU1', 'MICU2']
714	HPA	HPA:0461411	skin 1; cells in spinous layer[≥Low]	0.0351364084148619	True	skin 1; cells in spinous layer[≥Low]	760	83	16	11006	0.1927710843373494	0.0210526315789473	query_1	['HPA:0460000']	['GCSH', 'ADSL', 'RAD50', 'XRCC6', 'H2AX', 'PHB2', 'SUMO1', 'HSPD1', 'RPA1', 'VDAC1', 'RAD51', 'SDHB', 'CBX5', 'PDK2', 'NDUFV3', 'PHB1']
715	HPA	HPA:0080123	caudate; glial cells[High]	0.0355984870256089	True	caudate; glial cells[High]	681	83	15	11006	0.180722891566265	0.0220264317180616	query_1	['HPA:0080122']	['GCSH', 'ADSL', 'HSPA9', 'TP53BP1', 'PAXIP1', 'SETDB2', 'H2AX', 'MDC1', 'RPA1', 'BLM', 'PIAS1', 'MRE11', 'ISCU', 'OGDH', 'PHB1']
716	GO:CC	GO:1990351	transporter complex	0.036272816468965	True	"""A protein complex facilitating transport of molecules (proteins, small molecules, nucleic acids) into, out of or within a cell, or between cells."" [GOC:bhm, PMID:15449578]"	436	97	9	22122	0.0927835051546391	0.0206422018348623	query_1	['GO:0032991']	['MCUB', 'MCU', 'SUMO1', 'NDUFAB1', 'MICU1', 'SMDT1', 'NDUFV3', 'MICU2', 'ABHD6']
717	GO:BP	GO:0009206	purine ribonucleoside triphosphate biosynthetic process	0.0374630726909537	True	"""The chemical reactions and pathways resulting in the formation of purine ribonucleoside triphosphate, a compound consisting of a purine base linked to a ribose sugar esterified with triphosphate on the sugar."" [GOC:go_curators, ISBN:0198506732]"	117	96	6	21110	0.0625	0.0512820512820512	query_1	['GO:0009145', 'GO:0009201', 'GO:0009205']	['SDHD', 'SDHB', 'NDUFAB1', 'SDHA', 'SDHC', 'NDUFV3']
718	GO:BP	GO:0042592	homeostatic process	0.0382393826193089	True	"""Any biological process involved in the maintenance of an internal steady state."" [GOC:jl, ISBN:0395825172]"	1673	96	21	21110	0.21875	0.0125523012552301	query_1	['GO:0008150']	['PDK4', 'MAIP1', 'CDK5RAP3', 'OTC', 'HSPA9', 'MCUB', 'UFL1', 'METTL21C', 'MCU', 'PDK3', 'AFG3L2', 'ISCU', 'MICU1', 'SMDT1', 'DLD', 'PDK2', 'BARD1', 'MICU2', 'ABHD6', 'UBA5', 'STAT5B']
719	REAC	REAC:R-HSA-71064	Lysine catabolism	0.0383840489932707	True	Lysine catabolism	12	84	3	10790	0.0357142857142857	0.25	query_1	['REAC:R-HSA-71291']	['DLST', 'DLD', 'OGDH']
720	HP	HP:0001939	Abnormality of metabolism/homeostasis	0.0385299795006049	True	Abnormality of metabolism/homeostasis	2442	54	42	4851	0.7777777777777778	0.0171990171990172	query_1	['HP:0000118']	['GCSH', 'SPG7', 'PPM1K', 'LYRM4', 'NBN', 'OTC', 'DLST', 'RAD50', 'UBAC2', 'TALDO1', 'DLAT', 'PDHX', 'PDHB', 'PMPCA', 'SDHD', 'DBT', 'BRCA2', 'SIL1', 'BCKDK', 'BCKDHB', 'PDHA1', 'RPA1', 'PDK3', 'BLM', 'MRE11', 'RAD51', 'AFG3L2', 'ISCU', 'GPD1', 'SDHB', 'NFS1', 'BRCA1', 'SDHA', 'MICU1', 'SDHC', 'DLD', 'TRIM28', 'PEPD', 'PMPCB', 'OGDH', 'STAT5B', 'BCKDHA']
721	GO:BP	GO:0022402	cell cycle process	0.039110831553328	True	"""The cellular process that ensures successive accurate and complete genome replication and chromosome segregation."" [GOC:isa_complete, GOC:mtg_cell_cycle]"	1281	96	18	21110	0.1875	0.0140515222482435	query_1	['GO:0007049', 'GO:0009987']	['RBBP8', 'UBE2I', 'CDK5RAP3', 'NBN', 'TP53BP1', 'RAD50', 'PAXIP1', 'SETDB2', 'H2AX', 'DDRGK1', 'MDC1', 'PHB2', 'BRCA2', 'BLM', 'MRE11', 'RAD51', 'BRCA1', 'BARD1']
722	HP	HP:0007400	Irregular hyperpigmentation	0.0391412107760194	True	Irregular hyperpigmentation	227	54	11	4851	0.2037037037037037	0.0484581497797356	query_1	['HP:0000953']	['RBBP8', 'NBN', 'SDHD', 'BRCA2', 'RPA1', 'BLM', 'RAD51', 'SDHB', 'BRCA1', 'SDHA', 'SDHC']
723	GO:BP	GO:0009145	purine nucleoside triphosphate biosynthetic process	0.0393263654849377	True	"""The chemical reactions and pathways resulting in the formation of purine nucleoside triphosphate, a compound consisting of a purine base linked to a ribose or deoxyribose sugar esterified with triphosphate on the sugar."" [GOC:go_curators, ISBN:0198506732]"	118	96	6	21110	0.0625	0.0508474576271186	query_1	['GO:0009142', 'GO:0009144']	['SDHD', 'SDHB', 'NDUFAB1', 'SDHA', 'SDHC', 'NDUFV3']
724	HPA	HPA:0620222	vagina; squamous epithelial cells[≥Medium]	0.0395723010576843	True	vagina; squamous epithelial cells[≥Medium]	4042	83	47	11006	0.5662650602409639	0.0116279069767441	query_1	['HPA:0620221']	['PDK4', 'GCSH', 'PPM1K', 'SNX1', 'LYRM4', 'ADSL', 'ATF7IP', 'DLST', 'HSPA9', 'TP53BP1', 'RAD50', 'XRCC6', 'PAXIP1', 'PDHX', 'SETDB2', 'H2AX', 'MDC1', 'PMPCA', 'PHB2', 'MCU', 'SIL1', 'PDHA1', 'SUMO1', 'RPA1', 'ARL14EP', 'FLYWCH1', 'BLM', 'PIAS1', 'MRE11', 'AFG3L2', 'HDAC6', 'ISCU', 'NSUN6', 'SDHB', 'NFS1', 'NDUFAB1', 'BRCA1', 'SDHA', 'MICU1', 'DLD', 'NDUFV3', 'TRIM28', 'PMPCB', 'OGDH', 'PHB1', 'UFM1', 'BCKDHA']
725	KEGG	KEGG:00280	Valine, leucine and isoleucine degradation	0.0399453119693396	True	Valine, leucine and isoleucine degradation	48	63	4	8161	0.0634920634920634	0.0833333333333333	query_1	['KEGG:00000']	['DBT', 'BCKDHB', 'DLD', 'BCKDHA']
726	GO:BP	GO:0080135	regulation of cellular response to stress	0.0400838941950279	True	"""Any process that modulates the frequency, rate or extent of a cellular response to stress. Cellular response to stress is a change in state or activity of a cell (in terms of movement, secretion, enzyme production, gene expression, etc.) as a result of a stimulus indicating the organism is under stress. The stress is usually, but not necessarily, exogenous (e.g. temperature, humidity, ionizing radiation)."" [GOC:dhl]"	700	96	13	21110	0.1354166666666666	0.0185714285714285	query_1	['GO:0033554', 'GO:0050794', 'GO:0080134']	['RBBP8', 'TP53BP1', 'H2AX', 'DDRGK1', 'UFL1', 'BRCA2', 'VDAC1', 'RAD51', 'HDAC6', 'BRCA1', 'MICU1', 'TRIM28', 'BARD1']
727	HPA	HPA:0271122	kidney; collecting ducts[≥Medium]	0.0401551954011972	True	kidney; collecting ducts[≥Medium]	463	83	12	11006	0.144578313253012	0.0259179265658747	query_1	['HPA:0271121']	['DLST', 'DLAT', 'PDHB', 'H2AX', 'DBT', 'HSPD1', 'VDAC1', 'GPD1', 'SDHB', 'SDHA', 'NDUFV3', 'PHB1']
728	HP	HP:0002894	Neoplasm of the pancreas	0.040485743411872	True	A tumor (abnormal growth of tissue) of the pancreas.	83	54	7	4851	0.1296296296296296	0.0843373493975903	query_1	['HP:0001732', 'HP:0011793']	['NBN', 'RAD50', 'BRCA2', 'MRE11', 'RAD51', 'BRCA1', 'BARD1']
729	HP	HP:0001824	Weight loss	0.0405590974228907	True	Reduction of total body weight.	318	54	13	4851	0.2407407407407407	0.040880503144654	query_1	['HP:0004325']	['RBBP8', 'NBN', 'DLST', 'UBAC2', 'SDHD', 'BRCA2', 'RAD51', 'SDHB', 'BRCA1', 'SDHA', 'SDHC', 'TRIM28', 'STAT5B']
730	HP	HP:0001924	Sideroblastic anemia	0.0405617460834511	True	Sideroblastic anemia results from a defect in the incorporation of iron into the heme molecule. A sideroblast is an erythroblast that has stainable deposits of iron in cytoplasm (this can be demonstrated by Prussian blue staining).	34	54	5	4851	0.0925925925925925	0.1470588235294117	query_1	['HP:0010972']	['HSPA9', 'BRCA2', 'RAD51', 'ISCU', 'BRCA1']
731	HP	HP:0006895	Lower limb hypertonia	0.0405617460834511	True	Lower limb hypertonia	34	54	5	4851	0.0925925925925925	0.1470588235294117	query_1	['HP:0002509']	['SPG7', 'SDHD', 'AFG3L2', 'SDHB', 'SDHA']
732	GO:BP	GO:0000278	mitotic cell cycle	0.040791559065647	True	"""Progression through the phases of the mitotic cell cycle, the most common eukaryotic cell cycle, which canonically comprises four successive phases called G1, S, G2, and M and includes replication of the genome and the subsequent segregation of chromosomes into daughter cells. In some variant cell cycles nuclear replication or nuclear division may not be followed by cell division, or G1 and G2 phases may be absent."" [GOC:mah, ISBN:0815316194, Reactome:69278]"	922	96	15	21110	0.15625	0.0162689804772234	query_1	['GO:0007049']	['RBBP8', 'UBE2I', 'CDK5RAP3', 'NBN', 'RAD50', 'SETDB2', 'MDC1', 'PHB2', 'BRCA2', 'BLM', 'MRE11', 'RAD51', 'BRCA1', 'BARD1', 'STAT5B']
733	GO:BP	GO:0035967	cellular response to topologically incorrect protein	0.0412637628017504	True	"""Any process that results in a change in state or activity of a cell (in terms of movement, secretion, enzyme production, gene expression, etc.) as a result of a protein that is not folded in its correct three-dimensional structure."" [GOC:bf]"	119	96	6	21110	0.0625	0.0504201680672268	query_1	['GO:0033554', 'GO:0035966', 'GO:0071310']	['CDK5RAP3', 'HSPA9', 'DDRGK1', 'UFL1', 'HSPD1', 'HDAC6']
734	GO:BP	GO:0012501	programmed cell death	0.041438096334994	True	"""A process which begins when a cell receives an internal or external signal and activates a series of biochemical events (signaling pathway). The process ends with the death of the cell."" [GOC:lr, GOC:mtg_apoptosis]"	1961	96	23	21110	0.2395833333333333	0.0117287098419173	query_1	['GO:0008219']	['PPIF', 'SNX6', 'PDK4', 'SPG7', 'CDK5RAP3', 'NBN', 'HSPA9', 'DDRGK1', 'UFL1', 'PHB2', 'METTL21C', 'BRCA2', 'HSPD1', 'MRE11', 'VDAC1', 'HDAC6', 'PDK1', 'BRCA1', 'PDK2', 'BARD1', 'PHB1', 'UFM1', 'STAT5B']
735	GO:BP	GO:0050801	monoatomic ion homeostasis	0.0434799119689609	True	"""Any process involved in the maintenance of an internal steady state of monoatomic ions within an organism or cell. Monatomic ions (also called simple ions) are ions consisting of exactly one atom."" [GOC:ai]"	602	96	12	21110	0.125	0.0199335548172757	query_1	['GO:0048878']	['PDK4', 'MAIP1', 'OTC', 'MCUB', 'METTL21C', 'MCU', 'AFG3L2', 'ISCU', 'MICU1', 'SMDT1', 'PDK2', 'MICU2']
736	HPA	HPA:0080122	caudate; glial cells[≥Medium]	0.0439215788372775	True	caudate; glial cells[≥Medium]	2311	83	32	11006	0.3855421686746988	0.0138468195586326	query_1	['HPA:0080121']	['GCSH', 'ADSL', 'MAIP1', 'NBN', 'ATF7IP', 'DLST', 'HSPA9', 'TP53BP1', 'PAXIP1', 'SETDB2', 'H2AX', 'MDC1', 'PMPCA', 'PHB2', 'MCAT', 'MCU', 'RPA1', 'BLM', 'PIAS1', 'MRE11', 'AFG3L2', 'ISCU', 'GPD1', 'PDK1', 'SDHB', 'CBX5', 'DLD', 'TRIM28', 'BARD1', 'OGDH', 'PHB1', 'BCKDHA']
737	HPA	HPA:0310433	lymph node; germinal center cells[High]	0.0451239724750768	True	lymph node; germinal center cells[High]	945	83	18	11006	0.216867469879518	0.019047619047619	query_1	['HPA:0310432']	['ADSL', 'DLST', 'HSPA9', 'XRCC6', 'PAXIP1', 'SETDB2', 'MDC1', 'PMPCA', 'FLYWCH1', 'PIAS1', 'MRE11', 'VDAC1', 'AFG3L2', 'BRCA1', 'STAT5A', 'DLD', 'PDK2', 'OGDH']
738	KEGG	KEGG:00190	Oxidative phosphorylation	0.0453640779525007	True	Oxidative phosphorylation	134	63	6	8161	0.0952380952380952	0.044776119402985	query_1	['KEGG:00000']	['SDHD', 'SDHB', 'NDUFAB1', 'SDHA', 'SDHC', 'NDUFV3']
739	GO:MF	GO:0046983	protein dimerization activity	0.0467137600911761	True	"""The formation of a protein dimer, a macromolecular structure consists of two noncovalently associated identical or nonidentical subunits."" [ISBN:0198506732]"	1099	97	16	20195	0.1649484536082474	0.0145586897179253	query_1	['GO:0005515']	['SNX6', 'SNX1', 'LYRM4', 'H2AX', 'PHB2', 'BLM', 'ISCU', 'GPD1', 'NFS1', 'MICU1', 'PDK2', 'BARD1', 'MICU2', 'UBA5', 'PHB1', 'STAT5B']
740	HP	HP:0002928	Decreased activity of the pyruvate dehydrogenase complex	0.0469241528959095	True	Decreased activity of the pyruvate dehydrogenase complex	35	54	5	4851	0.0925925925925925	0.1428571428571428	query_1	['HP:0003287']	['DLAT', 'PDHX', 'PDHB', 'PDHA1', 'SDHA']
741	GO:BP	GO:0070647	protein modification by small protein conjugation or removal	0.0480311497357411	True	"""A protein modification process in which one or more groups of a small protein, such as ubiquitin or a ubiquitin-like protein, are covalently attached to or removed from a target protein."" [GOC:mah]"	1053	96	16	21110	0.1666666666666666	0.0151946818613485	query_1	['GO:0036211']	['UBE2I', 'CDK5RAP3', 'PAXIP1', 'DDRGK1', 'UFL1', 'BRCA2', 'SUMO1', 'PIAS1', 'RAD51', 'HDAC6', 'MOCS3', 'BRCA1', 'TRIM28', 'BARD1', 'UBA5', 'UFM1']
742	GO:BP	GO:0014070	response to organic cyclic compound	0.0480404636623057	True	"""Any process that results in a change in state or activity of a cell or an organism (in terms of movement, secretion, enzyme production, gene expression, etc.) as a result of an organic cyclic compound stimulus."" [GOC:ef]"	935	96	15	21110	0.15625	0.0160427807486631	query_1	['GO:0010033']	['OTC', 'DDRGK1', 'UFL1', 'PHB2', 'METTL21C', 'BCKDHB', 'BLM', 'RAD51', 'HDAC6', 'GPD1', 'BRCA1', 'UBA5', 'PHB1', 'UFM1', 'STAT5B']
743	GO:BP	GO:1902298	cell cycle DNA replication maintenance of fidelity	0.0487292418759369	True	"""Any maintenance of fidelity that is involved in cell cycle DNA replication."" [GOC:mtg_cell_cycle, GOC:TermGenie]"	2	96	2	21110	0.0208333333333333	1.0	query_1	['GO:0022402', 'GO:0044786', 'GO:0045005']	['BRCA2', 'RAD51']
744	GO:BP	GO:1990505	mitotic DNA replication maintenance of fidelity	0.0487292418759369	True	"""Any maintenance of fidelity that is involved in mitotic cell cycle DNA replication."" [PMID:19185548]"	2	96	2	21110	0.0208333333333333	1.0	query_1	['GO:1902298', 'GO:1902969', 'GO:1903047']	['BRCA2', 'RAD51']
745	GO:BP	GO:1990426	mitotic recombination-dependent replication fork processing	0.0487292418759369	True	"""Replication fork processing that includes recombination between DNA near the arrested fork and homologous sequences. Proteins involved in homologous recombination are required for replication restart."" [GOC:mah, PMID:23093942]"	2	96	2	21110	0.0208333333333333	1.0	query_1	['GO:0031297', 'GO:1990505']	['BRCA2', 'RAD51']
746	GO:MF	GO:0003863	3-methyl-2-oxobutanoate dehydrogenase (2-methylpropanoyl-transferring) activity	0.0487759475463204	True	"""Catalysis of the reaction: 3-methyl-2-oxobutanoate + lipoamide = S-(2-methylpropanoyl)dihydrolipoamide + CO2."" [EC:1.2.4.4]"	3	97	2	20195	0.0206185567010309	0.6666666666666666	query_1	['GO:0016624']	['BCKDHB', 'BCKDHA']
747	HP	HP:0100833	Neoplasm of the small intestine	0.0492081840214551	True	The presence of a neoplasm of the small intestine.	18	54	4	4851	0.074074074074074	0.2222222222222222	query_1	['HP:0007378']	['SDHD', 'SDHB', 'SDHA', 'SDHC']
748	GO:BP	GO:0009201	ribonucleoside triphosphate biosynthetic process	0.0497989886269939	True	"""The chemical reactions and pathways resulting in the formation of a ribonucleoside triphosphate, a compound consisting of a nucleobase linked to a ribose sugar esterified with triphosphate on the sugar."" [GOC:go_curators, ISBN:0198506732]"	123	96	6	21110	0.0625	0.048780487804878	query_1	['GO:0009142', 'GO:0009199']	['SDHD', 'SDHB', 'NDUFAB1', 'SDHA', 'SDHC', 'NDUFV3']
749	HPA	HPA:0570763	testis; pachytene spermatocytes[High]	0.0498896610772588	True	testis; pachytene spermatocytes[High]	867	83	17	11006	0.2048192771084337	0.0196078431372549	query_1	['HPA:0570762']	['ADSL', 'CDK5RAP3', 'ATF7IP', 'UBAC2', 'XRCC6', 'H2AX', 'MDC1', 'SIL1', 'MRE11', 'RAD51', 'AFG3L2', 'HDAC6', 'SDHB', 'NFS1', 'SDHA', 'TRIM28', 'MFN1']
750	CORUM	CORUM:1058	SNX complex (SNX1, SNX6)	0.0499905930282497	True	SNX complex (SNX1, SNX6)	2	47	2	3383	0.0425531914893617	1.0	query_1	['CORUM:0000000']	['SNX6', 'SNX1']
751	CORUM	CORUM:201	HUIC complex	0.0499905930282497	True	HUIC complex	2	47	2	3383	0.0425531914893617	1.0	query_1	['CORUM:0000000']	['BRCA1', 'BARD1']
752	CORUM	CORUM:263	R/M complex (RAD50-MRE11 complex)	0.0499905930282497	True	R/M complex (RAD50-MRE11 complex)	2	47	2	3383	0.0425531914893617	1.0	query_1	['CORUM:0000000']	['RAD50', 'MRE11']
753	CORUM	CORUM:264	R/M complex (RAD50-MRE11 complex)	0.0499905930282497	True	R/M complex (RAD50-MRE11 complex)	2	47	2	3383	0.0425531914893617	1.0	query_1	['CORUM:0000000']	['RAD50', 'MRE11']
754	CORUM	CORUM:2213	BRCA1-BARD1-POLR2A complex	0.0499905930282497	True	BRCA1-BARD1-POLR2A complex	2	47	2	3383	0.0425531914893617	1.0	query_1	['CORUM:0000000']	['BRCA1', 'BARD1']
755	CORUM	CORUM:2749	SETDB1-containing HMTase complex	0.0499905930282497	True	SETDB1-containing HMTase complex	2	47	2	3383	0.0425531914893617	1.0	query_1	['CORUM:0000000']	['ATF7IP', 'SETDB1']
756	CORUM	CORUM:2759	MBD1-MCAF complex	0.0499905930282497	True	MBD1-MCAF complex	2	47	2	3383	0.0425531914893617	1.0	query_1	['CORUM:0000000']	['ATF7IP', 'MBD1']
757	CORUM	CORUM:2776	RAD50-BRCA1 complex	0.0499905930282497	True	RAD50-BRCA1 complex	2	47	2	3383	0.0425531914893617	1.0	query_1	['CORUM:0000000']	['RAD50', 'BRCA1']
758	CORUM	CORUM:2824	BRCA1-RAD51 complex	0.0499905930282497	True	BRCA1-RAD51 complex	2	47	2	3383	0.0425531914893617	1.0	query_1	['CORUM:0000000']	['RAD51', 'BRCA1']
759	CORUM	CORUM:5231	53BP1-containing complex	0.0499905930282497	True	53BP1-containing complex	2	47	2	3383	0.0425531914893617	1.0	query_1	['CORUM:0000000']	['TP53BP1', 'RPA1']
760	CORUM	CORUM:6782	mitochondrial permeability  transition pore (PTP) complex (PPIF-SPG7-VDAC1)	0.0499905930282497	True	mitochondrial permeability  transition pore (PTP) complex (PPIF-SPG7-VDAC1)	2	47	2	3383	0.0425531914893617	1.0	query_1	['CORUM:0000000']	['PPIF', 'SPG7']
761	CORUM	CORUM:72	R/M complex (RAD50-MRE11 complex)	0.0499905930282497	True	R/M complex (RAD50-MRE11 complex)	2	47	2	3383	0.0425531914893617	1.0	query_1	['CORUM:0000000']	['RAD50', 'MRE11']
762	CORUM	CORUM:2774	MDC1-H2AFX-TP53BP1 complex	0.0499905930282497	True	MDC1-H2AFX-TP53BP1 complex	2	47	2	3383	0.0425531914893617	1.0	query_1	['CORUM:0000000']	['TP53BP1', 'MDC1']
